,questionID_id,response,questionID,questionTextID_id,surveyID_id,questionTextID,factorID_id,positive_p,factorID,factorName,studyID_id,surveyID,userID_id,creationDate,completionDate
0,16,2,16,17,143,17,6,0,6,Life - School Balance,2,143,6,2021-03-16 17:05:02,2021-03-16 17:07:04.532236
1,17,4,17,19,143,19,7,0,7,Discrimination,2,143,6,2021-03-16 17:05:02,2021-03-16 17:07:04.532236
2,18,3,18,23,143,23,8,1,8,Financial Pressure,2,143,6,2021-03-16 17:05:02,2021-03-16 17:07:04.532236
3,19,1,19,28,143,28,9,1,9,Faculty & Staff Support,2,143,6,2021-03-16 17:05:02,2021-03-16 17:07:04.532236
4,20,5,20,31,143,31,10,1,10,Friendships,2,143,6,2021-03-16 17:05:02,2021-03-16 17:07:04.532236
5,161,2,161,17,172,17,6,0,6,Life - School Balance,2,172,48,2021-03-16 17:05:08,2021-03-17 04:19:03.114655
6,162,6,162,21,172,21,7,1,7,Discrimination,2,172,48,2021-03-16 17:05:08,2021-03-17 04:19:03.114655
7,163,4,163,22,172,22,8,1,8,Financial Pressure,2,172,48,2021-03-16 17:05:08,2021-03-17 04:19:03.114655
8,164,6,164,26,172,26,9,1,9,Faculty & Staff Support,2,172,48,2021-03-16 17:05:08,2021-03-17 04:19:03.114655
9,165,2,165,33,172,33,10,0,10,Friendships,2,172,48,2021-03-16 17:05:08,2021-03-17 04:19:03.114655
10,291,3,291,17,198,17,6,0,6,Life - School Balance,2,198,79,2021-03-16 17:05:12,2021-03-16 22:17:12.444431
11,292,6,292,19,198,19,7,0,7,Discrimination,2,198,79,2021-03-16 17:05:12,2021-03-16 22:17:12.444431
12,293,3,293,25,198,25,8,0,8,Financial Pressure,2,198,79,2021-03-16 17:05:12,2021-03-16 22:17:12.444431
13,294,6,294,26,198,26,9,1,9,Faculty & Staff Support,2,198,79,2021-03-16 17:05:12,2021-03-16 22:17:12.444431
14,295,6,295,31,198,31,10,1,10,Friendships,2,198,79,2021-03-16 17:05:12,2021-03-16 22:17:12.444431
15,361,3,361,17,212,17,6,0,6,Life - School Balance,2,212,20,2021-03-16 19:05:03,2021-03-16 20:21:53.069914
16,362,5,362,20,212,20,7,1,7,Discrimination,2,212,20,2021-03-16 19:05:03,2021-03-16 20:21:53.069914
17,363,6,363,22,212,22,8,1,8,Financial Pressure,2,212,20,2021-03-16 19:05:03,2021-03-16 20:21:53.069914
18,364,5,364,29,212,29,9,0,9,Faculty & Staff Support,2,212,20,2021-03-16 19:05:03,2021-03-16 20:21:53.069914
19,365,5,365,32,212,32,10,1,10,Friendships,2,212,20,2021-03-16 19:05:03,2021-03-16 20:21:53.069914
20,476,3,476,17,235,17,6,0,6,Life - School Balance,2,235,54,2021-03-16 19:05:07,2021-03-17 14:53:27.548379
21,477,6,477,19,235,19,7,0,7,Discrimination,2,235,54,2021-03-16 19:05:07,2021-03-17 14:53:27.548379
22,478,5,478,25,235,25,8,0,8,Financial Pressure,2,235,54,2021-03-16 19:05:07,2021-03-17 14:53:27.548379
23,479,6,479,28,235,28,9,1,9,Faculty & Staff Support,2,235,54,2021-03-16 19:05:07,2021-03-17 14:53:27.548379
24,480,6,480,33,235,33,10,0,10,Friendships,2,235,54,2021-03-16 19:05:07,2021-03-17 14:53:27.548379
25,566,4,566,17,253,17,6,0,6,Life - School Balance,2,253,75,2021-03-16 19:05:10,2021-03-17 13:02:04.279903
26,567,5,567,20,253,20,7,1,7,Discrimination,2,253,75,2021-03-16 19:05:10,2021-03-17 13:02:04.279903
27,568,3,568,24,253,24,8,1,8,Financial Pressure,2,253,75,2021-03-16 19:05:10,2021-03-17 13:02:04.279903
28,569,5,569,28,253,28,9,1,9,Faculty & Staff Support,2,253,75,2021-03-16 19:05:10,2021-03-17 13:02:04.279903
29,570,6,570,33,253,33,10,0,10,Friendships,2,253,75,2021-03-16 19:05:10,2021-03-17 13:02:04.279903
30,581,1,581,17,256,17,6,0,6,Life - School Balance,2,256,78,2021-03-16 19:05:11,2021-03-16 20:15:12.760101
31,582,6,582,21,256,21,7,1,7,Discrimination,2,256,78,2021-03-16 19:05:11,2021-03-16 20:15:12.760101
32,583,4,583,22,256,22,8,1,8,Financial Pressure,2,256,78,2021-03-16 19:05:11,2021-03-16 20:15:12.760101
33,584,2,584,28,256,28,9,1,9,Faculty & Staff Support,2,256,78,2021-03-16 19:05:11,2021-03-16 20:15:12.760101
34,585,6,585,33,256,33,10,0,10,Friendships,2,256,78,2021-03-16 19:05:11,2021-03-16 20:15:12.760101
35,601,3,601,17,260,17,6,0,6,Life - School Balance,2,260,5,2021-03-18 14:05:01,2021-03-18 15:41:10.349821
36,602,6,602,19,260,19,7,0,7,Discrimination,2,260,5,2021-03-18 14:05:01,2021-03-18 15:41:10.349821
37,603,4,603,22,260,22,8,1,8,Financial Pressure,2,260,5,2021-03-18 14:05:01,2021-03-18 15:41:10.349821
38,604,4,604,28,260,28,9,1,9,Faculty & Staff Support,2,260,5,2021-03-18 14:05:01,2021-03-18 15:41:10.349821
39,605,5,605,31,260,31,10,1,10,Friendships,2,260,5,2021-03-18 14:05:01,2021-03-18 15:41:10.349821
40,606,6,606,17,261,17,6,0,6,Life - School Balance,2,261,6,2021-03-18 14:05:02,2021-03-18 14:15:26.430112
41,607,6,607,21,261,21,7,1,7,Discrimination,2,261,6,2021-03-18 14:05:02,2021-03-18 14:15:26.430112
42,608,6,608,22,261,22,8,1,8,Financial Pressure,2,261,6,2021-03-18 14:05:02,2021-03-18 14:15:26.430112
43,609,5,609,27,261,27,9,1,9,Faculty & Staff Support,2,261,6,2021-03-18 14:05:02,2021-03-18 14:15:26.430112
44,610,5,610,30,261,30,10,1,10,Friendships,2,261,6,2021-03-18 14:05:02,2021-03-18 14:15:26.430112
45,701,6,701,17,280,17,6,0,6,Life - School Balance,2,280,34,2021-03-18 14:05:05,2021-03-18 17:55:37.629455
46,702,6,702,21,280,21,7,1,7,Discrimination,2,280,34,2021-03-18 14:05:05,2021-03-18 17:55:37.629455
47,703,1,703,23,280,23,8,1,8,Financial Pressure,2,280,34,2021-03-18 14:05:05,2021-03-18 17:55:37.629455
48,704,6,704,26,280,26,9,1,9,Faculty & Staff Support,2,280,34,2021-03-18 14:05:05,2021-03-18 17:55:37.629455
49,705,6,705,30,280,30,10,1,10,Friendships,2,280,34,2021-03-18 14:05:05,2021-03-18 17:55:37.629455
50,726,3,726,17,285,17,6,0,6,Life - School Balance,2,285,42,2021-03-18 14:05:06,2021-03-18 14:05:59.603453
51,727,6,727,19,285,19,7,0,7,Discrimination,2,285,42,2021-03-18 14:05:06,2021-03-18 14:05:59.603453
52,728,4,728,24,285,24,8,1,8,Financial Pressure,2,285,42,2021-03-18 14:05:06,2021-03-18 14:05:59.603453
53,729,5,729,27,285,27,9,1,9,Faculty & Staff Support,2,285,42,2021-03-18 14:05:06,2021-03-18 14:05:59.603453
54,730,6,730,30,285,30,10,1,10,Friendships,2,285,42,2021-03-18 14:05:06,2021-03-18 14:05:59.603453
55,736,6,736,17,287,17,6,0,6,Life - School Balance,2,287,45,2021-03-18 14:05:06,2021-03-18 14:45:10.830405
56,737,5,737,20,287,20,7,1,7,Discrimination,2,287,45,2021-03-18 14:05:06,2021-03-18 14:45:10.830405
57,738,2,738,25,287,25,8,0,8,Financial Pressure,2,287,45,2021-03-18 14:05:06,2021-03-18 14:45:10.830405
58,739,6,739,26,287,26,9,1,9,Faculty & Staff Support,2,287,45,2021-03-18 14:05:06,2021-03-18 14:45:10.830405
59,740,4,740,32,287,32,10,1,10,Friendships,2,287,45,2021-03-18 14:05:06,2021-03-18 14:45:10.830405
60,746,3,746,17,289,17,6,0,6,Life - School Balance,2,289,47,2021-03-18 14:05:06,2021-03-18 17:36:00.001524
61,747,5,747,20,289,20,7,1,7,Discrimination,2,289,47,2021-03-18 14:05:06,2021-03-18 17:36:00.001524
62,748,4,748,25,289,25,8,0,8,Financial Pressure,2,289,47,2021-03-18 14:05:06,2021-03-18 17:36:00.001524
63,749,4,749,28,289,28,9,1,9,Faculty & Staff Support,2,289,47,2021-03-18 14:05:06,2021-03-18 17:36:00.001524
64,750,6,750,31,289,31,10,1,10,Friendships,2,289,47,2021-03-18 14:05:06,2021-03-18 17:36:00.001524
65,761,2,761,17,292,17,6,0,6,Life - School Balance,2,292,50,2021-03-18 14:05:07,2021-03-18 14:35:04.309872
66,762,4,762,21,292,21,7,1,7,Discrimination,2,292,50,2021-03-18 14:05:07,2021-03-18 14:35:04.309872
67,763,6,763,23,292,23,8,1,8,Financial Pressure,2,292,50,2021-03-18 14:05:07,2021-03-18 14:35:04.309872
68,764,5,764,26,292,26,9,1,9,Faculty & Staff Support,2,292,50,2021-03-18 14:05:07,2021-03-18 14:35:04.309872
69,765,4,765,32,292,32,10,1,10,Friendships,2,292,50,2021-03-18 14:05:07,2021-03-18 14:35:04.309872
70,766,3,766,17,293,17,6,0,6,Life - School Balance,2,293,52,2021-03-18 14:05:07,2021-03-18 15:34:31.559777
71,767,4,767,20,293,20,7,1,7,Discrimination,2,293,52,2021-03-18 14:05:07,2021-03-18 15:34:31.559777
72,768,6,768,23,293,23,8,1,8,Financial Pressure,2,293,52,2021-03-18 14:05:07,2021-03-18 15:34:31.559777
73,769,6,769,27,293,27,9,1,9,Faculty & Staff Support,2,293,52,2021-03-18 14:05:07,2021-03-18 15:34:31.559777
74,770,6,770,30,293,30,10,1,10,Friendships,2,293,52,2021-03-18 14:05:07,2021-03-18 15:34:31.559777
75,771,4,771,17,294,17,6,0,6,Life - School Balance,2,294,54,2021-03-18 14:05:07,2021-03-18 14:26:43.782419
76,772,4,772,20,294,20,7,1,7,Discrimination,2,294,54,2021-03-18 14:05:07,2021-03-18 14:26:43.782419
77,773,5,773,22,294,22,8,1,8,Financial Pressure,2,294,54,2021-03-18 14:05:07,2021-03-18 14:26:43.782419
78,774,6,774,27,294,27,9,1,9,Faculty & Staff Support,2,294,54,2021-03-18 14:05:07,2021-03-18 14:26:43.782419
79,775,6,775,31,294,31,10,1,10,Friendships,2,294,54,2021-03-18 14:05:07,2021-03-18 14:26:43.782419
80,776,4,776,17,295,17,6,0,6,Life - School Balance,2,295,55,2021-03-18 14:05:07,2021-03-19 12:14:35.576539
81,777,4,777,21,295,21,7,1,7,Discrimination,2,295,55,2021-03-18 14:05:07,2021-03-19 12:14:35.576539
82,778,2,778,24,295,24,8,1,8,Financial Pressure,2,295,55,2021-03-18 14:05:07,2021-03-19 12:14:35.576539
83,779,5,779,27,295,27,9,1,9,Faculty & Staff Support,2,295,55,2021-03-18 14:05:07,2021-03-19 12:14:35.576539
84,780,5,780,30,295,30,10,1,10,Friendships,2,295,55,2021-03-18 14:05:07,2021-03-19 12:14:35.576539
85,846,3,846,17,309,17,6,0,6,Life - School Balance,2,309,72,2021-03-18 14:05:10,2021-03-18 23:29:10.830489
86,847,4,847,20,309,20,7,1,7,Discrimination,2,309,72,2021-03-18 14:05:10,2021-03-18 23:29:10.830489
87,848,4,848,24,309,24,8,1,8,Financial Pressure,2,309,72,2021-03-18 14:05:10,2021-03-18 23:29:10.830489
88,849,5,849,26,309,26,9,1,9,Faculty & Staff Support,2,309,72,2021-03-18 14:05:10,2021-03-18 23:29:10.830489
89,850,6,850,33,309,33,10,0,10,Friendships,2,309,72,2021-03-18 14:05:10,2021-03-18 23:29:10.830489
90,851,6,851,17,310,17,6,0,6,Life - School Balance,2,310,73,2021-03-18 14:05:10,2021-03-18 14:25:22.442266
91,852,6,852,19,310,19,7,0,7,Discrimination,2,310,73,2021-03-18 14:05:10,2021-03-18 14:25:22.442266
92,853,2,853,24,310,24,8,1,8,Financial Pressure,2,310,73,2021-03-18 14:05:10,2021-03-18 14:25:22.442266
93,854,6,854,26,310,26,9,1,9,Faculty & Staff Support,2,310,73,2021-03-18 14:05:10,2021-03-18 14:25:22.442266
94,855,6,855,32,310,32,10,1,10,Friendships,2,310,73,2021-03-18 14:05:10,2021-03-18 14:25:22.442266
95,856,3,856,17,311,17,6,0,6,Life - School Balance,2,311,74,2021-03-18 14:05:10,2021-03-18 14:48:31.876741
96,857,6,857,20,311,20,7,1,7,Discrimination,2,311,74,2021-03-18 14:05:10,2021-03-18 14:48:31.876741
97,858,3,858,25,311,25,8,0,8,Financial Pressure,2,311,74,2021-03-18 14:05:10,2021-03-18 14:48:31.876741
98,859,6,859,29,311,29,9,0,9,Faculty & Staff Support,2,311,74,2021-03-18 14:05:10,2021-03-18 14:48:31.876741
99,860,6,860,33,311,33,10,0,10,Friendships,2,311,74,2021-03-18 14:05:10,2021-03-18 14:48:31.876741
100,896,3,896,17,345,17,6,0,6,Life - School Balance,2,345,5,2021-03-23 19:05:01,2021-03-23 19:37:25.966048
101,897,6,897,21,345,21,7,1,7,Discrimination,2,345,5,2021-03-23 19:05:01,2021-03-23 19:37:25.966048
102,898,4,898,23,345,23,8,1,8,Financial Pressure,2,345,5,2021-03-23 19:05:01,2021-03-23 19:37:25.966048
103,899,5,899,26,345,26,9,1,9,Faculty & Staff Support,2,345,5,2021-03-23 19:05:01,2021-03-23 19:37:25.966048
104,900,5,900,32,345,32,10,1,10,Friendships,2,345,5,2021-03-23 19:05:01,2021-03-23 19:37:25.966048
105,901,5,901,17,346,17,6,0,6,Life - School Balance,2,346,6,2021-03-23 19:05:01,2021-03-24 01:13:05.758333
106,902,6,902,21,346,21,7,1,7,Discrimination,2,346,6,2021-03-23 19:05:01,2021-03-24 01:13:05.758333
107,903,5,903,25,346,25,8,0,8,Financial Pressure,2,346,6,2021-03-23 19:05:01,2021-03-24 01:13:05.758333
108,904,1,904,29,346,29,9,0,9,Faculty & Staff Support,2,346,6,2021-03-23 19:05:01,2021-03-24 01:13:05.758333
109,905,6,905,30,346,30,10,1,10,Friendships,2,346,6,2021-03-23 19:05:01,2021-03-24 01:13:05.758333
110,911,4,911,17,348,17,6,0,6,Life - School Balance,2,348,9,2021-03-23 19:05:02,2021-03-23 19:10:09.239655
111,912,5,912,21,348,21,7,1,7,Discrimination,2,348,9,2021-03-23 19:05:02,2021-03-23 19:10:09.239655
112,913,4,913,22,348,22,8,1,8,Financial Pressure,2,348,9,2021-03-23 19:05:02,2021-03-23 19:10:09.239655
113,914,6,914,27,348,27,9,1,9,Faculty & Staff Support,2,348,9,2021-03-23 19:05:02,2021-03-23 19:10:09.239655
114,915,6,915,31,348,31,10,1,10,Friendships,2,348,9,2021-03-23 19:05:02,2021-03-23 19:10:09.239655
115,916,6,916,17,349,17,6,0,6,Life - School Balance,2,349,10,2021-03-23 19:05:02,2021-03-24 00:11:34.574149
116,917,5,917,20,349,20,7,1,7,Discrimination,2,349,10,2021-03-23 19:05:02,2021-03-24 00:11:34.574149
117,918,5,918,25,349,25,8,0,8,Financial Pressure,2,349,10,2021-03-23 19:05:02,2021-03-24 00:11:34.574149
118,919,4,919,27,349,27,9,1,9,Faculty & Staff Support,2,349,10,2021-03-23 19:05:02,2021-03-24 00:11:34.574149
119,920,6,920,31,349,31,10,1,10,Friendships,2,349,10,2021-03-23 19:05:02,2021-03-24 00:11:34.574149
120,936,2,936,17,353,17,6,0,6,Life - School Balance,2,353,17,2021-03-23 19:05:03,2021-03-23 20:23:46.643301
121,937,5,937,21,353,21,7,1,7,Discrimination,2,353,17,2021-03-23 19:05:03,2021-03-23 20:23:46.643301
122,938,6,938,24,353,24,8,1,8,Financial Pressure,2,353,17,2021-03-23 19:05:03,2021-03-23 20:23:46.643301
123,939,4,939,26,353,26,9,1,9,Faculty & Staff Support,2,353,17,2021-03-23 19:05:03,2021-03-23 20:23:46.643301
124,940,4,940,33,353,33,10,0,10,Friendships,2,353,17,2021-03-23 19:05:03,2021-03-23 20:23:46.643301
125,941,3,941,17,354,17,6,0,6,Life - School Balance,2,354,18,2021-03-23 19:05:03,2021-03-23 20:37:35.294154
126,942,5,942,20,354,20,7,1,7,Discrimination,2,354,18,2021-03-23 19:05:03,2021-03-23 20:37:35.294154
127,943,6,943,25,354,25,8,0,8,Financial Pressure,2,354,18,2021-03-23 19:05:03,2021-03-23 20:37:35.294154
128,944,5,944,26,354,26,9,1,9,Faculty & Staff Support,2,354,18,2021-03-23 19:05:03,2021-03-23 20:37:35.294154
129,945,4,945,30,354,30,10,1,10,Friendships,2,354,18,2021-03-23 19:05:03,2021-03-23 20:37:35.294154
130,946,3,946,17,355,17,6,0,6,Life - School Balance,2,355,19,2021-03-23 19:05:03,2021-03-23 21:00:21.510391
131,947,4,947,20,355,20,7,1,7,Discrimination,2,355,19,2021-03-23 19:05:03,2021-03-23 21:00:21.510391
132,948,3,948,25,355,25,8,0,8,Financial Pressure,2,355,19,2021-03-23 19:05:03,2021-03-23 21:00:21.510391
133,949,3,949,29,355,29,9,0,9,Faculty & Staff Support,2,355,19,2021-03-23 19:05:03,2021-03-23 21:00:21.510391
134,950,4,950,33,355,33,10,0,10,Friendships,2,355,19,2021-03-23 19:05:03,2021-03-23 21:00:21.510391
135,986,4,986,17,363,17,6,0,6,Life - School Balance,2,363,31,2021-03-23 19:05:04,2021-03-23 19:32:26.297284
136,987,1,987,21,363,21,7,1,7,Discrimination,2,363,31,2021-03-23 19:05:04,2021-03-23 19:32:26.297284
137,988,5,988,24,363,24,8,1,8,Financial Pressure,2,363,31,2021-03-23 19:05:04,2021-03-23 19:32:26.297284
138,989,3,989,26,363,26,9,1,9,Faculty & Staff Support,2,363,31,2021-03-23 19:05:04,2021-03-23 19:32:26.297284
139,990,4,990,33,363,33,10,0,10,Friendships,2,363,31,2021-03-23 19:05:04,2021-03-23 19:32:26.297284
140,1011,2,1011,17,368,17,6,0,6,Life - School Balance,2,368,40,2021-03-23 19:05:05,2021-03-23 19:08:42.822936
141,1012,3,1012,21,368,21,7,1,7,Discrimination,2,368,40,2021-03-23 19:05:05,2021-03-23 19:08:42.822936
142,1013,4,1013,22,368,22,8,1,8,Financial Pressure,2,368,40,2021-03-23 19:05:05,2021-03-23 19:08:42.822936
143,1014,3,1014,26,368,26,9,1,9,Faculty & Staff Support,2,368,40,2021-03-23 19:05:05,2021-03-23 19:08:42.822936
144,1015,1,1015,31,368,31,10,1,10,Friendships,2,368,40,2021-03-23 19:05:05,2021-03-23 19:08:42.822936
145,1021,3,1021,17,370,17,6,0,6,Life - School Balance,2,370,42,2021-03-23 19:05:05,2021-03-23 23:21:20.939030
146,1022,5,1022,19,370,19,7,0,7,Discrimination,2,370,42,2021-03-23 19:05:05,2021-03-23 23:21:20.939030
147,1023,4,1023,23,370,23,8,1,8,Financial Pressure,2,370,42,2021-03-23 19:05:05,2021-03-23 23:21:20.939030
148,1024,5,1024,27,370,27,9,1,9,Faculty & Staff Support,2,370,42,2021-03-23 19:05:05,2021-03-23 23:21:20.939030
149,1025,5,1025,33,370,33,10,0,10,Friendships,2,370,42,2021-03-23 19:05:05,2021-03-23 23:21:20.939030
150,1026,4,1026,17,371,17,6,0,6,Life - School Balance,2,371,44,2021-03-23 19:05:06,2021-03-23 19:07:29.005385
151,1027,5,1027,19,371,19,7,0,7,Discrimination,2,371,44,2021-03-23 19:05:06,2021-03-23 19:07:29.005385
152,1028,4,1028,22,371,22,8,1,8,Financial Pressure,2,371,44,2021-03-23 19:05:06,2021-03-23 19:07:29.005385
153,1029,5,1029,29,371,29,9,0,9,Faculty & Staff Support,2,371,44,2021-03-23 19:05:06,2021-03-23 19:07:29.005385
154,1030,4,1030,30,371,30,10,1,10,Friendships,2,371,44,2021-03-23 19:05:06,2021-03-23 19:07:29.005385
155,1041,5,1041,17,374,17,6,0,6,Life - School Balance,2,374,47,2021-03-23 19:05:06,2021-03-23 19:40:51.317397
156,1042,6,1042,19,374,19,7,0,7,Discrimination,2,374,47,2021-03-23 19:05:06,2021-03-23 19:40:51.317397
157,1043,4,1043,22,374,22,8,1,8,Financial Pressure,2,374,47,2021-03-23 19:05:06,2021-03-23 19:40:51.317397
158,1044,5,1044,26,374,26,9,1,9,Faculty & Staff Support,2,374,47,2021-03-23 19:05:06,2021-03-23 19:40:51.317397
159,1045,5,1045,33,374,33,10,0,10,Friendships,2,374,47,2021-03-23 19:05:06,2021-03-23 19:40:51.317397
160,1046,3,1046,17,375,17,6,0,6,Life - School Balance,2,375,48,2021-03-23 19:05:06,2021-03-23 20:30:40.610390
161,1047,6,1047,19,375,19,7,0,7,Discrimination,2,375,48,2021-03-23 19:05:06,2021-03-23 20:30:40.610390
162,1048,5,1048,24,375,24,8,1,8,Financial Pressure,2,375,48,2021-03-23 19:05:06,2021-03-23 20:30:40.610390
163,1049,6,1049,26,375,26,9,1,9,Faculty & Staff Support,2,375,48,2021-03-23 19:05:06,2021-03-23 20:30:40.610390
164,1050,4,1050,33,375,33,10,0,10,Friendships,2,375,48,2021-03-23 19:05:06,2021-03-23 20:30:40.610390
165,1051,4,1051,17,376,17,6,0,6,Life - School Balance,2,376,49,2021-03-23 19:05:06,2021-03-24 11:39:21.196323
166,1052,4,1052,19,376,19,7,0,7,Discrimination,2,376,49,2021-03-23 19:05:06,2021-03-24 11:39:21.196323
167,1053,4,1053,25,376,25,8,0,8,Financial Pressure,2,376,49,2021-03-23 19:05:06,2021-03-24 11:39:21.196323
168,1054,4,1054,26,376,26,9,1,9,Faculty & Staff Support,2,376,49,2021-03-23 19:05:06,2021-03-24 11:39:21.196323
169,1055,4,1055,32,376,32,10,1,10,Friendships,2,376,49,2021-03-23 19:05:06,2021-03-24 11:39:21.196323
170,1071,5,1071,17,380,17,6,0,6,Life - School Balance,2,380,55,2021-03-23 19:05:07,2021-03-23 19:15:27.032480
171,1072,6,1072,19,380,19,7,0,7,Discrimination,2,380,55,2021-03-23 19:05:07,2021-03-23 19:15:27.032480
172,1073,1,1073,24,380,24,8,1,8,Financial Pressure,2,380,55,2021-03-23 19:05:07,2021-03-23 19:15:27.032480
173,1074,4,1074,26,380,26,9,1,9,Faculty & Staff Support,2,380,55,2021-03-23 19:05:07,2021-03-23 19:15:27.032480
174,1075,5,1075,32,380,32,10,1,10,Friendships,2,380,55,2021-03-23 19:05:07,2021-03-23 19:15:27.032480
175,1076,5,1076,17,381,17,6,0,6,Life - School Balance,2,381,57,2021-03-23 19:05:07,2021-03-23 19:06:48.304517
176,1077,6,1077,19,381,19,7,0,7,Discrimination,2,381,57,2021-03-23 19:05:07,2021-03-23 19:06:48.304517
177,1078,1,1078,23,381,23,8,1,8,Financial Pressure,2,381,57,2021-03-23 19:05:07,2021-03-23 19:06:48.304517
178,1079,4,1079,28,381,28,9,1,9,Faculty & Staff Support,2,381,57,2021-03-23 19:05:07,2021-03-23 19:06:48.304517
179,1080,6,1080,33,381,33,10,0,10,Friendships,2,381,57,2021-03-23 19:05:07,2021-03-23 19:06:48.304517
180,1116,5,1116,17,389,17,6,0,6,Life - School Balance,2,389,67,2021-03-23 19:05:08,2021-03-23 19:46:45.311329
181,1117,4,1117,21,389,21,7,1,7,Discrimination,2,389,67,2021-03-23 19:05:08,2021-03-23 19:46:45.311329
182,1118,6,1118,24,389,24,8,1,8,Financial Pressure,2,389,67,2021-03-23 19:05:08,2021-03-23 19:46:45.311329
183,1119,4,1119,28,389,28,9,1,9,Faculty & Staff Support,2,389,67,2021-03-23 19:05:08,2021-03-23 19:46:45.311329
184,1120,3,1120,32,389,32,10,1,10,Friendships,2,389,67,2021-03-23 19:05:08,2021-03-23 19:46:45.311329
185,1136,5,1136,17,393,17,6,0,6,Life - School Balance,2,393,71,2021-03-23 19:05:09,2021-03-23 19:12:26.246287
186,1137,5,1137,21,393,21,7,1,7,Discrimination,2,393,71,2021-03-23 19:05:09,2021-03-23 19:12:26.246287
187,1138,2,1138,22,393,22,8,1,8,Financial Pressure,2,393,71,2021-03-23 19:05:09,2021-03-23 19:12:26.246287
188,1139,5,1139,29,393,29,9,0,9,Faculty & Staff Support,2,393,71,2021-03-23 19:05:09,2021-03-23 19:12:26.246287
189,1140,5,1140,31,393,31,10,1,10,Friendships,2,393,71,2021-03-23 19:05:09,2021-03-23 19:12:26.246287
190,1171,2,1171,17,400,17,6,0,6,Life - School Balance,2,400,78,2021-03-23 19:05:10,2021-03-23 19:14:12.471228
191,1172,5,1172,21,400,21,7,1,7,Discrimination,2,400,78,2021-03-23 19:05:10,2021-03-23 19:14:12.471228
192,1173,2,1173,22,400,22,8,1,8,Financial Pressure,2,400,78,2021-03-23 19:05:10,2021-03-23 19:14:12.471228
193,1174,2,1174,28,400,28,9,1,9,Faculty & Staff Support,2,400,78,2021-03-23 19:05:10,2021-03-23 19:14:12.471228
194,1175,6,1175,31,400,31,10,1,10,Friendships,2,400,78,2021-03-23 19:05:10,2021-03-23 19:14:12.471228
195,1186,3,1186,17,403,17,6,0,6,Life - School Balance,2,403,86,2021-03-23 19:05:10,2021-03-23 19:40:06.215721
196,1187,6,1187,21,403,21,7,1,7,Discrimination,2,403,86,2021-03-23 19:05:10,2021-03-23 19:40:06.215721
197,1188,3,1188,22,403,22,8,1,8,Financial Pressure,2,403,86,2021-03-23 19:05:10,2021-03-23 19:40:06.215721
198,1189,5,1189,27,403,27,9,1,9,Faculty & Staff Support,2,403,86,2021-03-23 19:05:10,2021-03-23 19:40:06.215721
199,1190,4,1190,33,403,33,10,0,10,Friendships,2,403,86,2021-03-23 19:05:10,2021-03-23 19:40:06.215721
200,1196,3,1196,17,405,17,6,0,6,Life - School Balance,2,405,88,2021-03-23 19:05:11,2021-03-23 19:16:56.706796
201,1197,6,1197,19,405,19,7,0,7,Discrimination,2,405,88,2021-03-23 19:05:11,2021-03-23 19:16:56.706796
202,1198,4,1198,23,405,23,8,1,8,Financial Pressure,2,405,88,2021-03-23 19:05:11,2021-03-23 19:16:56.706796
203,1199,4,1199,28,405,28,9,1,9,Faculty & Staff Support,2,405,88,2021-03-23 19:05:11,2021-03-23 19:16:56.706796
204,1200,6,1200,33,405,33,10,0,10,Friendships,2,405,88,2021-03-23 19:05:11,2021-03-23 19:16:56.706796
205,1231,4,1231,17,412,17,6,0,6,Life - School Balance,2,412,96,2021-03-23 19:05:12,2021-03-24 00:36:08.225042
206,1232,5,1232,21,412,21,7,1,7,Discrimination,2,412,96,2021-03-23 19:05:12,2021-03-24 00:36:08.225042
207,1233,6,1233,24,412,24,8,1,8,Financial Pressure,2,412,96,2021-03-23 19:05:12,2021-03-24 00:36:08.225042
208,1234,4,1234,28,412,28,9,1,9,Faculty & Staff Support,2,412,96,2021-03-23 19:05:12,2021-03-24 00:36:08.225042
209,1235,4,1235,33,412,33,10,0,10,Friendships,2,412,96,2021-03-23 19:05:12,2021-03-24 00:36:08.225042
210,1241,5,1241,17,414,17,6,0,6,Life - School Balance,2,414,100,2021-03-23 19:05:12,2021-03-23 19:09:28.206975
211,1242,6,1242,20,414,20,7,1,7,Discrimination,2,414,100,2021-03-23 19:05:12,2021-03-23 19:09:28.206975
212,1243,2,1243,23,414,23,8,1,8,Financial Pressure,2,414,100,2021-03-23 19:05:12,2021-03-23 19:09:28.206975
213,1244,5,1244,27,414,27,9,1,9,Faculty & Staff Support,2,414,100,2021-03-23 19:05:12,2021-03-23 19:09:28.206975
214,1245,5,1245,32,414,32,10,1,10,Friendships,2,414,100,2021-03-23 19:05:12,2021-03-23 19:09:28.206975
215,1271,3,1271,17,420,17,6,0,6,Life - School Balance,2,420,5,2021-03-25 14:05:01,2021-03-25 14:28:29.302522
216,1272,6,1272,19,420,19,7,0,7,Discrimination,2,420,5,2021-03-25 14:05:01,2021-03-25 14:28:29.302522
217,1273,4,1273,24,420,24,8,1,8,Financial Pressure,2,420,5,2021-03-25 14:05:01,2021-03-25 14:28:29.302522
218,1274,5,1274,28,420,28,9,1,9,Faculty & Staff Support,2,420,5,2021-03-25 14:05:01,2021-03-25 14:28:29.302522
219,1275,5,1275,33,420,33,10,0,10,Friendships,2,420,5,2021-03-25 14:05:01,2021-03-25 14:28:29.302522
220,1276,5,1276,17,421,17,6,0,6,Life - School Balance,2,421,6,2021-03-25 14:05:01,2021-03-25 14:10:31.706347
221,1277,1,1277,21,421,21,7,1,7,Discrimination,2,421,6,2021-03-25 14:05:01,2021-03-25 14:10:31.706347
222,1278,6,1278,22,421,22,8,1,8,Financial Pressure,2,421,6,2021-03-25 14:05:01,2021-03-25 14:10:31.706347
223,1279,5,1279,26,421,26,9,1,9,Faculty & Staff Support,2,421,6,2021-03-25 14:05:01,2021-03-25 14:10:31.706347
224,1280,5,1280,33,421,33,10,0,10,Friendships,2,421,6,2021-03-25 14:05:01,2021-03-25 14:10:31.706347
225,1286,4,1286,17,423,17,6,0,6,Life - School Balance,2,423,9,2021-03-25 14:05:02,2021-03-25 14:13:25.827655
226,1287,6,1287,21,423,21,7,1,7,Discrimination,2,423,9,2021-03-25 14:05:02,2021-03-25 14:13:25.827655
227,1288,4,1288,23,423,23,8,1,8,Financial Pressure,2,423,9,2021-03-25 14:05:02,2021-03-25 14:13:25.827655
228,1289,6,1289,27,423,27,9,1,9,Faculty & Staff Support,2,423,9,2021-03-25 14:05:02,2021-03-25 14:13:25.827655
229,1290,6,1290,30,423,30,10,1,10,Friendships,2,423,9,2021-03-25 14:05:02,2021-03-25 14:13:25.827655
230,1311,2,1311,17,428,17,6,0,6,Life - School Balance,2,428,17,2021-03-25 14:05:02,2021-03-25 14:14:28.795528
231,1312,6,1312,19,428,19,7,0,7,Discrimination,2,428,17,2021-03-25 14:05:02,2021-03-25 14:14:28.795528
232,1313,5,1313,22,428,22,8,1,8,Financial Pressure,2,428,17,2021-03-25 14:05:02,2021-03-25 14:14:28.795528
233,1314,4,1314,26,428,26,9,1,9,Faculty & Staff Support,2,428,17,2021-03-25 14:05:02,2021-03-25 14:14:28.795528
234,1315,5,1315,30,428,30,10,1,10,Friendships,2,428,17,2021-03-25 14:05:02,2021-03-25 14:14:28.795528
235,1316,3,1316,17,429,17,6,0,6,Life - School Balance,2,429,18,2021-03-25 14:05:03,2021-03-25 14:23:22.914340
236,1317,4,1317,19,429,19,7,0,7,Discrimination,2,429,18,2021-03-25 14:05:03,2021-03-25 14:23:22.914340
237,1318,6,1318,25,429,25,8,0,8,Financial Pressure,2,429,18,2021-03-25 14:05:03,2021-03-25 14:23:22.914340
238,1319,5,1319,27,429,27,9,1,9,Faculty & Staff Support,2,429,18,2021-03-25 14:05:03,2021-03-25 14:23:22.914340
239,1320,5,1320,30,429,30,10,1,10,Friendships,2,429,18,2021-03-25 14:05:03,2021-03-25 14:23:22.914340
240,1331,4,1331,17,432,17,6,0,6,Life - School Balance,2,432,22,2021-03-25 14:05:03,2021-03-25 16:34:32.011793
241,1332,6,1332,19,432,19,7,0,7,Discrimination,2,432,22,2021-03-25 14:05:03,2021-03-25 16:34:32.011793
242,1333,6,1333,23,432,23,8,1,8,Financial Pressure,2,432,22,2021-03-25 14:05:03,2021-03-25 16:34:32.011793
243,1334,6,1334,29,432,29,9,0,9,Faculty & Staff Support,2,432,22,2021-03-25 14:05:03,2021-03-25 16:34:32.011793
244,1335,4,1335,30,432,30,10,1,10,Friendships,2,432,22,2021-03-25 14:05:03,2021-03-25 16:34:32.011793
245,1336,3,1336,17,433,17,6,0,6,Life - School Balance,2,433,23,2021-03-25 14:05:03,2021-03-25 14:32:09.690796
246,1337,5,1337,20,433,20,7,1,7,Discrimination,2,433,23,2021-03-25 14:05:03,2021-03-25 14:32:09.690796
247,1338,6,1338,25,433,25,8,0,8,Financial Pressure,2,433,23,2021-03-25 14:05:03,2021-03-25 14:32:09.690796
248,1339,6,1339,26,433,26,9,1,9,Faculty & Staff Support,2,433,23,2021-03-25 14:05:03,2021-03-25 14:32:09.690796
249,1340,3,1340,33,433,33,10,0,10,Friendships,2,433,23,2021-03-25 14:05:03,2021-03-25 14:32:09.690796
250,1356,1,1356,17,437,17,6,0,6,Life - School Balance,2,437,30,2021-03-25 14:05:04,2021-03-25 14:07:32.781474
251,1357,6,1357,21,437,21,7,1,7,Discrimination,2,437,30,2021-03-25 14:05:04,2021-03-25 14:07:32.781474
252,1358,4,1358,24,437,24,8,1,8,Financial Pressure,2,437,30,2021-03-25 14:05:04,2021-03-25 14:07:32.781474
253,1359,6,1359,26,437,26,9,1,9,Faculty & Staff Support,2,437,30,2021-03-25 14:05:04,2021-03-25 14:07:32.781474
254,1360,6,1360,33,437,33,10,0,10,Friendships,2,437,30,2021-03-25 14:05:04,2021-03-25 14:07:32.781474
255,1396,3,1396,17,445,17,6,0,6,Life - School Balance,2,445,42,2021-03-25 14:05:05,2021-03-25 15:11:15.198543
256,1397,6,1397,19,445,19,7,0,7,Discrimination,2,445,42,2021-03-25 14:05:05,2021-03-25 15:11:15.198543
257,1398,4,1398,23,445,23,8,1,8,Financial Pressure,2,445,42,2021-03-25 14:05:05,2021-03-25 15:11:15.198543
258,1399,5,1399,26,445,26,9,1,9,Faculty & Staff Support,2,445,42,2021-03-25 14:05:05,2021-03-25 15:11:15.198543
259,1400,5,1400,32,445,32,10,1,10,Friendships,2,445,42,2021-03-25 14:05:05,2021-03-25 15:11:15.198543
260,1411,3,1411,17,448,17,6,0,6,Life - School Balance,2,448,46,2021-03-25 14:05:06,2021-03-25 14:09:06.149642
261,1412,6,1412,19,448,19,7,0,7,Discrimination,2,448,46,2021-03-25 14:05:06,2021-03-25 14:09:06.149642
262,1413,4,1413,22,448,22,8,1,8,Financial Pressure,2,448,46,2021-03-25 14:05:06,2021-03-25 14:09:06.149642
263,1414,4,1414,27,448,27,9,1,9,Faculty & Staff Support,2,448,46,2021-03-25 14:05:06,2021-03-25 14:09:06.149642
264,1415,6,1415,31,448,31,10,1,10,Friendships,2,448,46,2021-03-25 14:05:06,2021-03-25 14:09:06.149642
265,1431,3,1431,17,452,17,6,0,6,Life - School Balance,2,452,50,2021-03-25 14:05:06,2021-03-25 16:37:05.241011
266,1432,4,1432,21,452,21,7,1,7,Discrimination,2,452,50,2021-03-25 14:05:06,2021-03-25 16:37:05.241011
267,1433,5,1433,23,452,23,8,1,8,Financial Pressure,2,452,50,2021-03-25 14:05:06,2021-03-25 16:37:05.241011
268,1434,5,1434,26,452,26,9,1,9,Faculty & Staff Support,2,452,50,2021-03-25 14:05:06,2021-03-25 16:37:05.241011
269,1435,4,1435,32,452,32,10,1,10,Friendships,2,452,50,2021-03-25 14:05:06,2021-03-25 16:37:05.241011
270,1446,5,1446,17,455,17,6,0,6,Life - School Balance,2,455,55,2021-03-25 14:05:07,2021-03-25 15:11:34.969916
271,1447,5,1447,19,455,19,7,0,7,Discrimination,2,455,55,2021-03-25 14:05:07,2021-03-25 15:11:34.969916
272,1448,4,1448,25,455,25,8,0,8,Financial Pressure,2,455,55,2021-03-25 14:05:07,2021-03-25 15:11:34.969916
273,1449,4,1449,27,455,27,9,1,9,Faculty & Staff Support,2,455,55,2021-03-25 14:05:07,2021-03-25 15:11:34.969916
274,1450,4,1450,32,455,32,10,1,10,Friendships,2,455,55,2021-03-25 14:05:07,2021-03-25 15:11:34.969916
275,1451,5,1451,17,456,17,6,0,6,Life - School Balance,2,456,57,2021-03-25 14:05:07,2021-03-25 14:38:11.846923
276,1452,6,1452,21,456,21,7,1,7,Discrimination,2,456,57,2021-03-25 14:05:07,2021-03-25 14:38:11.846923
277,1453,2,1453,23,456,23,8,1,8,Financial Pressure,2,456,57,2021-03-25 14:05:07,2021-03-25 14:38:11.846923
278,1454,5,1454,28,456,28,9,1,9,Faculty & Staff Support,2,456,57,2021-03-25 14:05:07,2021-03-25 14:38:11.846923
279,1455,6,1455,32,456,32,10,1,10,Friendships,2,456,57,2021-03-25 14:05:07,2021-03-25 14:38:11.846923
280,1456,3,1456,17,457,17,6,0,6,Life - School Balance,2,457,58,2021-03-25 14:05:07,2021-03-25 17:24:13.812917
281,1457,3,1457,20,457,20,7,1,7,Discrimination,2,457,58,2021-03-25 14:05:07,2021-03-25 17:24:13.812917
282,1458,2,1458,22,457,22,8,1,8,Financial Pressure,2,457,58,2021-03-25 14:05:07,2021-03-25 17:24:13.812917
283,1459,5,1459,29,457,29,9,0,9,Faculty & Staff Support,2,457,58,2021-03-25 14:05:07,2021-03-25 17:24:13.812917
284,1460,3,1460,33,457,33,10,0,10,Friendships,2,457,58,2021-03-25 14:05:07,2021-03-25 17:24:13.812917
285,1491,5,1491,17,464,17,6,0,6,Life - School Balance,2,464,67,2021-03-25 14:05:08,2021-03-25 15:15:42.606382
286,1492,3,1492,20,464,20,7,1,7,Discrimination,2,464,67,2021-03-25 14:05:08,2021-03-25 15:15:42.606382
287,1493,6,1493,22,464,22,8,1,8,Financial Pressure,2,464,67,2021-03-25 14:05:08,2021-03-25 15:15:42.606382
288,1494,5,1494,29,464,29,9,0,9,Faculty & Staff Support,2,464,67,2021-03-25 14:05:08,2021-03-25 15:15:42.606382
289,1495,4,1495,32,464,32,10,1,10,Friendships,2,464,67,2021-03-25 14:05:08,2021-03-25 15:15:42.606382
290,1501,5,1501,17,466,17,6,0,6,Life - School Balance,2,466,69,2021-03-25 14:05:09,2021-03-25 14:07:36.110317
291,1502,5,1502,21,466,21,7,1,7,Discrimination,2,466,69,2021-03-25 14:05:09,2021-03-25 14:07:36.110317
292,1503,4,1503,23,466,23,8,1,8,Financial Pressure,2,466,69,2021-03-25 14:05:09,2021-03-25 14:07:36.110317
293,1504,4,1504,28,466,28,9,1,9,Faculty & Staff Support,2,466,69,2021-03-25 14:05:09,2021-03-25 14:07:36.110317
294,1505,4,1505,30,466,30,10,1,10,Friendships,2,466,69,2021-03-25 14:05:09,2021-03-25 14:07:36.110317
295,1511,5,1511,17,468,17,6,0,6,Life - School Balance,2,468,71,2021-03-25 14:05:09,2021-03-25 14:28:18.727830
296,1512,5,1512,20,468,20,7,1,7,Discrimination,2,468,71,2021-03-25 14:05:09,2021-03-25 14:28:18.727830
297,1513,2,1513,23,468,23,8,1,8,Financial Pressure,2,468,71,2021-03-25 14:05:09,2021-03-25 14:28:18.727830
298,1514,4,1514,28,468,28,9,1,9,Faculty & Staff Support,2,468,71,2021-03-25 14:05:09,2021-03-25 14:28:18.727830
299,1515,5,1515,33,468,33,10,0,10,Friendships,2,468,71,2021-03-25 14:05:09,2021-03-25 14:28:18.727830
300,1526,3,1526,17,471,17,6,0,6,Life - School Balance,2,471,74,2021-03-25 14:05:09,2021-03-25 14:47:04.540215
301,1527,6,1527,19,471,19,7,0,7,Discrimination,2,471,74,2021-03-25 14:05:09,2021-03-25 14:47:04.540215
302,1528,4,1528,22,471,22,8,1,8,Financial Pressure,2,471,74,2021-03-25 14:05:09,2021-03-25 14:47:04.540215
303,1529,6,1529,29,471,29,9,0,9,Faculty & Staff Support,2,471,74,2021-03-25 14:05:09,2021-03-25 14:47:04.540215
304,1530,6,1530,32,471,32,10,1,10,Friendships,2,471,74,2021-03-25 14:05:09,2021-03-25 14:47:04.540215
305,1541,4,1541,17,474,17,6,0,6,Life - School Balance,2,474,77,2021-03-25 14:05:10,2021-03-25 16:16:51.910319
306,1542,5,1542,21,474,21,7,1,7,Discrimination,2,474,77,2021-03-25 14:05:10,2021-03-25 16:16:51.910319
307,1543,2,1543,22,474,22,8,1,8,Financial Pressure,2,474,77,2021-03-25 14:05:10,2021-03-25 16:16:51.910319
308,1544,5,1544,27,474,27,9,1,9,Faculty & Staff Support,2,474,77,2021-03-25 14:05:10,2021-03-25 16:16:51.910319
309,1545,5,1545,33,474,33,10,0,10,Friendships,2,474,77,2021-03-25 14:05:10,2021-03-25 16:16:51.910319
310,1546,1,1546,17,475,17,6,0,6,Life - School Balance,2,475,78,2021-03-25 14:05:10,2021-03-25 17:07:19.348828
311,1547,6,1547,20,475,20,7,1,7,Discrimination,2,475,78,2021-03-25 14:05:10,2021-03-25 17:07:19.348828
312,1548,3,1548,23,475,23,8,1,8,Financial Pressure,2,475,78,2021-03-25 14:05:10,2021-03-25 17:07:19.348828
313,1549,4,1549,27,475,27,9,1,9,Faculty & Staff Support,2,475,78,2021-03-25 14:05:10,2021-03-25 17:07:19.348828
314,1550,5,1550,30,475,30,10,1,10,Friendships,2,475,78,2021-03-25 14:05:10,2021-03-25 17:07:19.348828
315,1566,3,1566,17,479,17,6,0,6,Life - School Balance,2,479,87,2021-03-25 14:05:11,2021-03-25 16:43:38.457804
316,1567,6,1567,20,479,20,7,1,7,Discrimination,2,479,87,2021-03-25 14:05:11,2021-03-25 16:43:38.457804
317,1568,2,1568,22,479,22,8,1,8,Financial Pressure,2,479,87,2021-03-25 14:05:11,2021-03-25 16:43:38.457804
318,1569,6,1569,26,479,26,9,1,9,Faculty & Staff Support,2,479,87,2021-03-25 14:05:11,2021-03-25 16:43:38.457804
319,1570,3,1570,32,479,32,10,1,10,Friendships,2,479,87,2021-03-25 14:05:11,2021-03-25 16:43:38.457804
320,1576,6,1576,17,481,17,6,0,6,Life - School Balance,2,481,89,2021-03-25 14:05:11,2021-03-25 16:47:37.488809
321,1577,6,1577,19,481,19,7,0,7,Discrimination,2,481,89,2021-03-25 14:05:11,2021-03-25 16:47:37.488809
322,1578,2,1578,22,481,22,8,1,8,Financial Pressure,2,481,89,2021-03-25 14:05:11,2021-03-25 16:47:37.488809
323,1579,6,1579,27,481,27,9,1,9,Faculty & Staff Support,2,481,89,2021-03-25 14:05:11,2021-03-25 16:47:37.488809
324,1580,6,1580,30,481,30,10,1,10,Friendships,2,481,89,2021-03-25 14:05:11,2021-03-25 16:47:37.488809
325,1586,5,1586,17,483,17,6,0,6,Life - School Balance,2,483,91,2021-03-25 14:05:11,2021-03-25 14:23:25.997661
326,1587,6,1587,21,483,21,7,1,7,Discrimination,2,483,91,2021-03-25 14:05:11,2021-03-25 14:23:25.997661
327,1588,2,1588,22,483,22,8,1,8,Financial Pressure,2,483,91,2021-03-25 14:05:11,2021-03-25 14:23:25.997661
328,1589,5,1589,27,483,27,9,1,9,Faculty & Staff Support,2,483,91,2021-03-25 14:05:11,2021-03-25 14:23:25.997661
329,1590,5,1590,33,483,33,10,0,10,Friendships,2,483,91,2021-03-25 14:05:11,2021-03-25 14:23:25.997661
330,1631,4,1631,17,492,17,6,0,6,Life - School Balance,2,492,105,2021-03-25 14:05:13,2021-03-25 14:38:37.576802
331,1632,3,1632,20,492,20,7,1,7,Discrimination,2,492,105,2021-03-25 14:05:13,2021-03-25 14:38:37.576802
332,1633,5,1633,25,492,25,8,0,8,Financial Pressure,2,492,105,2021-03-25 14:05:13,2021-03-25 14:38:37.576802
333,1634,5,1634,29,492,29,9,0,9,Faculty & Staff Support,2,492,105,2021-03-25 14:05:13,2021-03-25 14:38:37.576802
334,1635,4,1635,33,492,33,10,0,10,Friendships,2,492,105,2021-03-25 14:05:13,2021-03-25 14:38:37.576802
335,1651,3,1651,17,516,17,6,0,6,Life - School Balance,2,516,5,2021-03-30 19:05:01,2021-03-30 23:02:29.113598
336,1652,6,1652,21,516,21,7,1,7,Discrimination,2,516,5,2021-03-30 19:05:01,2021-03-30 23:02:29.113598
337,1653,3,1653,24,516,24,8,1,8,Financial Pressure,2,516,5,2021-03-30 19:05:01,2021-03-30 23:02:29.113598
338,1654,5,1654,29,516,29,9,0,9,Faculty & Staff Support,2,516,5,2021-03-30 19:05:01,2021-03-30 23:02:29.113598
339,1655,5,1655,31,516,31,10,1,10,Friendships,2,516,5,2021-03-30 19:05:01,2021-03-30 23:02:29.113598
340,1736,4,1736,17,533,17,6,0,6,Life - School Balance,2,533,31,2021-03-30 19:05:04,2021-03-30 19:05:59.340351
341,1737,6,1737,21,533,21,7,1,7,Discrimination,2,533,31,2021-03-30 19:05:04,2021-03-30 19:05:59.340351
342,1738,6,1738,25,533,25,8,0,8,Financial Pressure,2,533,31,2021-03-30 19:05:04,2021-03-30 19:05:59.340351
343,1739,3,1739,28,533,28,9,1,9,Faculty & Staff Support,2,533,31,2021-03-30 19:05:04,2021-03-30 19:05:59.340351
344,1740,2,1740,30,533,30,10,1,10,Friendships,2,533,31,2021-03-30 19:05:04,2021-03-30 19:05:59.340351
345,1781,5,1781,17,542,17,6,0,6,Life - School Balance,2,542,45,2021-03-30 19:05:05,2021-03-30 19:06:37.082401
346,1782,6,1782,20,542,20,7,1,7,Discrimination,2,542,45,2021-03-30 19:05:05,2021-03-30 19:06:37.082401
347,1783,1,1783,24,542,24,8,1,8,Financial Pressure,2,542,45,2021-03-30 19:05:05,2021-03-30 19:06:37.082401
348,1784,6,1784,29,542,29,9,0,9,Faculty & Staff Support,2,542,45,2021-03-30 19:05:05,2021-03-30 19:06:37.082401
349,1785,5,1785,32,542,32,10,1,10,Friendships,2,542,45,2021-03-30 19:05:05,2021-03-30 19:06:37.082401
350,1786,4,1786,17,543,17,6,0,6,Life - School Balance,2,543,46,2021-03-30 19:05:06,2021-03-30 19:25:52.243595
351,1787,5,1787,21,543,21,7,1,7,Discrimination,2,543,46,2021-03-30 19:05:06,2021-03-30 19:25:52.243595
352,1788,4,1788,22,543,22,8,1,8,Financial Pressure,2,543,46,2021-03-30 19:05:06,2021-03-30 19:25:52.243595
353,1789,5,1789,27,543,27,9,1,9,Faculty & Staff Support,2,543,46,2021-03-30 19:05:06,2021-03-30 19:25:52.243595
354,1790,5,1790,30,543,30,10,1,10,Friendships,2,543,46,2021-03-30 19:05:06,2021-03-30 19:25:52.243595
355,1796,2,1796,17,545,17,6,0,6,Life - School Balance,2,545,48,2021-03-30 19:05:06,2021-03-30 20:25:37.204361
356,1797,6,1797,20,545,20,7,1,7,Discrimination,2,545,48,2021-03-30 19:05:06,2021-03-30 20:25:37.204361
357,1798,4,1798,25,545,25,8,0,8,Financial Pressure,2,545,48,2021-03-30 19:05:06,2021-03-30 20:25:37.204361
358,1799,5,1799,28,545,28,9,1,9,Faculty & Staff Support,2,545,48,2021-03-30 19:05:06,2021-03-30 20:25:37.204361
359,1800,4,1800,32,545,32,10,1,10,Friendships,2,545,48,2021-03-30 19:05:06,2021-03-30 20:25:37.204361
360,1836,3,1836,17,553,17,6,0,6,Life - School Balance,2,553,60,2021-03-30 19:05:07,2021-03-30 19:06:27.173153
361,1837,4,1837,21,553,21,7,1,7,Discrimination,2,553,60,2021-03-30 19:05:07,2021-03-30 19:06:27.173153
362,1838,4,1838,23,553,23,8,1,8,Financial Pressure,2,553,60,2021-03-30 19:05:07,2021-03-30 19:06:27.173153
363,1839,6,1839,29,553,29,9,0,9,Faculty & Staff Support,2,553,60,2021-03-30 19:05:07,2021-03-30 19:06:27.173153
364,1840,5,1840,33,553,33,10,0,10,Friendships,2,553,60,2021-03-30 19:05:07,2021-03-30 19:06:27.173153
365,1856,6,1856,17,557,17,6,0,6,Life - School Balance,2,557,65,2021-03-30 19:05:08,2021-03-31 01:53:38.960482
366,1857,5,1857,20,557,20,7,1,7,Discrimination,2,557,65,2021-03-30 19:05:08,2021-03-31 01:53:38.960482
367,1858,4,1858,23,557,23,8,1,8,Financial Pressure,2,557,65,2021-03-30 19:05:08,2021-03-31 01:53:38.960482
368,1859,5,1859,26,557,26,9,1,9,Faculty & Staff Support,2,557,65,2021-03-30 19:05:08,2021-03-31 01:53:38.960482
369,1860,4,1860,31,557,31,10,1,10,Friendships,2,557,65,2021-03-30 19:05:08,2021-03-31 01:53:38.960482
370,1876,3,1876,17,561,17,6,0,6,Life - School Balance,2,561,69,2021-03-30 19:05:08,2021-03-30 19:18:34.635940
371,1877,4,1877,19,561,19,7,0,7,Discrimination,2,561,69,2021-03-30 19:05:08,2021-03-30 19:18:34.635940
372,1878,4,1878,24,561,24,8,1,8,Financial Pressure,2,561,69,2021-03-30 19:05:08,2021-03-30 19:18:34.635940
373,1879,5,1879,27,561,27,9,1,9,Faculty & Staff Support,2,561,69,2021-03-30 19:05:08,2021-03-30 19:18:34.635940
374,1880,4,1880,32,561,32,10,1,10,Friendships,2,561,69,2021-03-30 19:05:08,2021-03-30 19:18:34.635940
375,1906,5,1906,17,567,17,6,0,6,Life - School Balance,2,567,75,2021-03-30 19:05:09,2021-03-30 19:06:23.145228
376,1907,6,1907,20,567,20,7,1,7,Discrimination,2,567,75,2021-03-30 19:05:09,2021-03-30 19:06:23.145228
377,1908,2,1908,23,567,23,8,1,8,Financial Pressure,2,567,75,2021-03-30 19:05:09,2021-03-30 19:06:23.145228
378,1909,6,1909,29,567,29,9,0,9,Faculty & Staff Support,2,567,75,2021-03-30 19:05:09,2021-03-30 19:06:23.145228
379,1910,6,1910,30,567,30,10,1,10,Friendships,2,567,75,2021-03-30 19:05:09,2021-03-30 19:06:23.145228
380,1931,4,1931,17,572,17,6,0,6,Life - School Balance,2,572,84,2021-03-30 19:05:10,2021-03-30 19:06:40.417971
381,1932,6,1932,20,572,20,7,1,7,Discrimination,2,572,84,2021-03-30 19:05:10,2021-03-30 19:06:40.417971
382,1933,4,1933,24,572,24,8,1,8,Financial Pressure,2,572,84,2021-03-30 19:05:10,2021-03-30 19:06:40.417971
383,1934,4,1934,27,572,27,9,1,9,Faculty & Staff Support,2,572,84,2021-03-30 19:05:10,2021-03-30 19:06:40.417971
384,1935,5,1935,32,572,32,10,1,10,Friendships,2,572,84,2021-03-30 19:05:10,2021-03-30 19:06:40.417971
385,1941,4,1941,17,574,17,6,0,6,Life - School Balance,2,574,86,2021-03-30 19:05:10,2021-03-30 20:32:04.477509
386,1942,5,1942,20,574,20,7,1,7,Discrimination,2,574,86,2021-03-30 19:05:10,2021-03-30 20:32:04.477509
387,1943,4,1943,25,574,25,8,0,8,Financial Pressure,2,574,86,2021-03-30 19:05:10,2021-03-30 20:32:04.477509
388,1944,4,1944,26,574,26,9,1,9,Faculty & Staff Support,2,574,86,2021-03-30 19:05:10,2021-03-30 20:32:04.477509
389,1945,5,1945,31,574,31,10,1,10,Friendships,2,574,86,2021-03-30 19:05:10,2021-03-30 20:32:04.477509
390,1946,4,1946,17,575,17,6,0,6,Life - School Balance,2,575,87,2021-03-30 19:05:11,2021-03-30 19:20:17.751587
391,1947,6,1947,20,575,20,7,1,7,Discrimination,2,575,87,2021-03-30 19:05:11,2021-03-30 19:20:17.751587
392,1948,2,1948,23,575,23,8,1,8,Financial Pressure,2,575,87,2021-03-30 19:05:11,2021-03-30 19:20:17.751587
393,1949,4,1949,28,575,28,9,1,9,Faculty & Staff Support,2,575,87,2021-03-30 19:05:11,2021-03-30 19:20:17.751587
394,1950,4,1950,30,575,30,10,1,10,Friendships,2,575,87,2021-03-30 19:05:11,2021-03-30 19:20:17.751587
395,1961,4,1961,17,578,17,6,0,6,Life - School Balance,2,578,90,2021-03-30 19:05:11,2021-03-30 19:13:31.144473
396,1962,5,1962,21,578,21,7,1,7,Discrimination,2,578,90,2021-03-30 19:05:11,2021-03-30 19:13:31.144473
397,1963,5,1963,24,578,24,8,1,8,Financial Pressure,2,578,90,2021-03-30 19:05:11,2021-03-30 19:13:31.144473
398,1964,6,1964,28,578,28,9,1,9,Faculty & Staff Support,2,578,90,2021-03-30 19:05:11,2021-03-30 19:13:31.144473
399,1965,6,1965,30,578,30,10,1,10,Friendships,2,578,90,2021-03-30 19:05:11,2021-03-30 19:13:31.144473
400,1966,5,1966,17,579,17,6,0,6,Life - School Balance,2,579,91,2021-03-30 19:05:11,2021-03-30 19:37:14.875764
401,1967,6,1967,19,579,19,7,0,7,Discrimination,2,579,91,2021-03-30 19:05:11,2021-03-30 19:37:14.875764
402,1968,2,1968,22,579,22,8,1,8,Financial Pressure,2,579,91,2021-03-30 19:05:11,2021-03-30 19:37:14.875764
403,1969,6,1969,28,579,28,9,1,9,Faculty & Staff Support,2,579,91,2021-03-30 19:05:11,2021-03-30 19:37:14.875764
404,1970,5,1970,32,579,32,10,1,10,Friendships,2,579,91,2021-03-30 19:05:11,2021-03-30 19:37:14.875764
405,2006,2,2006,17,587,17,6,0,6,Life - School Balance,2,587,101,2021-03-30 19:05:12,2021-03-30 19:07:07.270854
406,2007,6,2007,19,587,19,7,0,7,Discrimination,2,587,101,2021-03-30 19:05:12,2021-03-30 19:07:07.270854
407,2008,4,2008,22,587,22,8,1,8,Financial Pressure,2,587,101,2021-03-30 19:05:12,2021-03-30 19:07:07.270854
408,2009,5,2009,28,587,28,9,1,9,Faculty & Staff Support,2,587,101,2021-03-30 19:05:12,2021-03-30 19:07:07.270854
409,2010,6,2010,33,587,33,10,0,10,Friendships,2,587,101,2021-03-30 19:05:12,2021-03-30 19:07:07.270854
410,2011,5,2011,17,588,17,6,0,6,Life - School Balance,2,588,103,2021-03-30 19:05:13,2021-03-30 19:07:02.042321
411,2012,2,2012,21,588,21,7,1,7,Discrimination,2,588,103,2021-03-30 19:05:13,2021-03-30 19:07:02.042321
412,2013,5,2013,24,588,24,8,1,8,Financial Pressure,2,588,103,2021-03-30 19:05:13,2021-03-30 19:07:02.042321
413,2014,6,2014,28,588,28,9,1,9,Faculty & Staff Support,2,588,103,2021-03-30 19:05:13,2021-03-30 19:07:02.042321
414,2015,2,2015,31,588,31,10,1,10,Friendships,2,588,103,2021-03-30 19:05:13,2021-03-30 19:07:02.042321
415,2046,3,2046,17,595,17,6,0,6,Life - School Balance,2,595,5,2021-04-01 14:05:01,2021-04-01 15:25:16.705917
416,2047,5,2047,20,595,20,7,1,7,Discrimination,2,595,5,2021-04-01 14:05:01,2021-04-01 15:25:16.705917
417,2048,4,2048,22,595,22,8,1,8,Financial Pressure,2,595,5,2021-04-01 14:05:01,2021-04-01 15:25:16.705917
418,2049,5,2049,26,595,26,9,1,9,Faculty & Staff Support,2,595,5,2021-04-01 14:05:01,2021-04-01 15:25:16.705917
419,2050,5,2050,32,595,32,10,1,10,Friendships,2,595,5,2021-04-01 14:05:01,2021-04-01 15:25:16.705917
420,2111,4,2111,17,608,17,6,0,6,Life - School Balance,2,608,26,2021-04-01 14:05:04,2021-04-01 14:31:12.734705
421,2112,6,2112,20,608,20,7,1,7,Discrimination,2,608,26,2021-04-01 14:05:04,2021-04-01 14:31:12.734705
422,2113,3,2113,23,608,23,8,1,8,Financial Pressure,2,608,26,2021-04-01 14:05:04,2021-04-01 14:31:12.734705
423,2114,6,2114,27,608,27,9,1,9,Faculty & Staff Support,2,608,26,2021-04-01 14:05:04,2021-04-01 14:31:12.734705
424,2115,3,2115,33,608,33,10,0,10,Friendships,2,608,26,2021-04-01 14:05:04,2021-04-01 14:31:12.734705
425,2116,5,2116,17,609,17,6,0,6,Life - School Balance,2,609,27,2021-04-01 14:05:04,2021-04-01 14:30:48.174673
426,2117,6,2117,20,609,20,7,1,7,Discrimination,2,609,27,2021-04-01 14:05:04,2021-04-01 14:30:48.174673
427,2118,3,2118,24,609,24,8,1,8,Financial Pressure,2,609,27,2021-04-01 14:05:04,2021-04-01 14:30:48.174673
428,2119,5,2119,26,609,26,9,1,9,Faculty & Staff Support,2,609,27,2021-04-01 14:05:04,2021-04-01 14:30:48.174673
429,2120,5,2120,30,609,30,10,1,10,Friendships,2,609,27,2021-04-01 14:05:04,2021-04-01 14:30:48.174673
430,2161,5,2161,17,618,17,6,0,6,Life - School Balance,2,618,41,2021-04-01 14:05:06,2021-04-01 16:33:07.186270
431,2162,4,2162,21,618,21,7,1,7,Discrimination,2,618,41,2021-04-01 14:05:06,2021-04-01 16:33:07.186270
432,2163,3,2163,24,618,24,8,1,8,Financial Pressure,2,618,41,2021-04-01 14:05:06,2021-04-01 16:33:07.186270
433,2164,5,2164,28,618,28,9,1,9,Faculty & Staff Support,2,618,41,2021-04-01 14:05:06,2021-04-01 16:33:07.186270
434,2165,5,2165,33,618,33,10,0,10,Friendships,2,618,41,2021-04-01 14:05:06,2021-04-01 16:33:07.186270
435,2246,1,2246,17,635,17,6,0,6,Life - School Balance,2,635,64,2021-04-01 14:05:09,2021-04-01 20:15:35.424825
436,2247,6,2247,21,635,21,7,1,7,Discrimination,2,635,64,2021-04-01 14:05:09,2021-04-01 20:15:35.424825
437,2248,4,2248,22,635,22,8,1,8,Financial Pressure,2,635,64,2021-04-01 14:05:09,2021-04-01 20:15:35.424825
438,2249,4,2249,26,635,26,9,1,9,Faculty & Staff Support,2,635,64,2021-04-01 14:05:09,2021-04-01 20:15:35.424825
439,2250,3,2250,30,635,30,10,1,10,Friendships,2,635,64,2021-04-01 14:05:09,2021-04-01 20:15:35.424825
440,2256,5,2256,17,637,17,6,0,6,Life - School Balance,2,637,66,2021-04-01 14:05:09,2021-04-01 14:20:27.442033
441,2257,5,2257,20,637,20,7,1,7,Discrimination,2,637,66,2021-04-01 14:05:09,2021-04-01 14:20:27.442033
442,2258,5,2258,24,637,24,8,1,8,Financial Pressure,2,637,66,2021-04-01 14:05:09,2021-04-01 14:20:27.442033
443,2259,4,2259,28,637,28,9,1,9,Faculty & Staff Support,2,637,66,2021-04-01 14:05:09,2021-04-01 14:20:27.442033
444,2260,5,2260,33,637,33,10,0,10,Friendships,2,637,66,2021-04-01 14:05:09,2021-04-01 14:20:27.442033
445,2261,5,2261,17,638,17,6,0,6,Life - School Balance,2,638,67,2021-04-01 14:05:09,2021-04-02 00:11:47.892290
446,2262,3,2262,19,638,19,7,0,7,Discrimination,2,638,67,2021-04-01 14:05:09,2021-04-02 00:11:47.892290
447,2263,6,2263,23,638,23,8,1,8,Financial Pressure,2,638,67,2021-04-01 14:05:09,2021-04-02 00:11:47.892290
448,2264,4,2264,27,638,27,9,1,9,Faculty & Staff Support,2,638,67,2021-04-01 14:05:09,2021-04-02 00:11:47.892290
449,2265,3,2265,33,638,33,10,0,10,Friendships,2,638,67,2021-04-01 14:05:09,2021-04-02 00:11:47.892290
450,2276,4,2276,17,641,17,6,0,6,Life - School Balance,2,641,70,2021-04-01 14:05:10,2021-04-01 14:16:27.937941
451,2277,5,2277,20,641,20,7,1,7,Discrimination,2,641,70,2021-04-01 14:05:10,2021-04-01 14:16:27.937941
452,2278,3,2278,22,641,22,8,1,8,Financial Pressure,2,641,70,2021-04-01 14:05:10,2021-04-01 14:16:27.937941
453,2279,4,2279,27,641,27,9,1,9,Faculty & Staff Support,2,641,70,2021-04-01 14:05:10,2021-04-01 14:16:27.937941
454,2280,5,2280,31,641,31,10,1,10,Friendships,2,641,70,2021-04-01 14:05:10,2021-04-01 14:16:27.937941
455,2291,6,2291,17,644,17,6,0,6,Life - School Balance,2,644,73,2021-04-01 14:05:10,2021-04-01 14:43:29.422134
456,2292,6,2292,21,644,21,7,1,7,Discrimination,2,644,73,2021-04-01 14:05:10,2021-04-01 14:43:29.422134
457,2293,2,2293,22,644,22,8,1,8,Financial Pressure,2,644,73,2021-04-01 14:05:10,2021-04-01 14:43:29.422134
458,2294,6,2294,29,644,29,9,0,9,Faculty & Staff Support,2,644,73,2021-04-01 14:05:10,2021-04-01 14:43:29.422134
459,2295,6,2295,31,644,31,10,1,10,Friendships,2,644,73,2021-04-01 14:05:10,2021-04-01 14:43:29.422134
460,2311,4,2311,17,648,17,6,0,6,Life - School Balance,2,648,77,2021-04-01 14:05:11,2021-04-01 14:40:35.942751
461,2312,5,2312,20,648,20,7,1,7,Discrimination,2,648,77,2021-04-01 14:05:11,2021-04-01 14:40:35.942751
462,2313,4,2313,25,648,25,8,0,8,Financial Pressure,2,648,77,2021-04-01 14:05:11,2021-04-01 14:40:35.942751
463,2314,4,2314,26,648,26,9,1,9,Faculty & Staff Support,2,648,77,2021-04-01 14:05:11,2021-04-01 14:40:35.942751
464,2315,4,2315,30,648,30,10,1,10,Friendships,2,648,77,2021-04-01 14:05:11,2021-04-01 14:40:35.942751
465,2316,3,2316,17,649,17,6,0,6,Life - School Balance,2,649,78,2021-04-01 14:05:11,2021-04-01 17:48:28.679558
466,2317,5,2317,20,649,20,7,1,7,Discrimination,2,649,78,2021-04-01 14:05:11,2021-04-01 17:48:28.679558
467,2318,2,2318,24,649,24,8,1,8,Financial Pressure,2,649,78,2021-04-01 14:05:11,2021-04-01 17:48:28.679558
468,2319,6,2319,27,649,27,9,1,9,Faculty & Staff Support,2,649,78,2021-04-01 14:05:11,2021-04-01 17:48:28.679558
469,2320,6,2320,30,649,30,10,1,10,Friendships,2,649,78,2021-04-01 14:05:11,2021-04-01 17:48:28.679558
470,2326,4,2326,17,651,17,6,0,6,Life - School Balance,2,651,84,2021-04-01 14:05:11,2021-04-01 16:01:17.184303
471,2327,5,2327,20,651,20,7,1,7,Discrimination,2,651,84,2021-04-01 14:05:11,2021-04-01 16:01:17.184303
472,2328,5,2328,24,651,24,8,1,8,Financial Pressure,2,651,84,2021-04-01 14:05:11,2021-04-01 16:01:17.184303
473,2329,5,2329,26,651,26,9,1,9,Faculty & Staff Support,2,651,84,2021-04-01 14:05:11,2021-04-01 16:01:17.184303
474,2330,5,2330,33,651,33,10,0,10,Friendships,2,651,84,2021-04-01 14:05:11,2021-04-01 16:01:17.184303
475,2336,4,2336,17,653,17,6,0,6,Life - School Balance,2,653,86,2021-04-01 14:05:12,2021-04-01 14:24:30.014452
476,2337,5,2337,20,653,20,7,1,7,Discrimination,2,653,86,2021-04-01 14:05:12,2021-04-01 14:24:30.014452
477,2338,3,2338,22,653,22,8,1,8,Financial Pressure,2,653,86,2021-04-01 14:05:12,2021-04-01 14:24:30.014452
478,2339,4,2339,28,653,28,9,1,9,Faculty & Staff Support,2,653,86,2021-04-01 14:05:12,2021-04-01 14:24:30.014452
479,2340,5,2340,31,653,31,10,1,10,Friendships,2,653,86,2021-04-01 14:05:12,2021-04-01 14:24:30.014452
480,2341,5,2341,17,654,17,6,0,6,Life - School Balance,2,654,87,2021-04-01 14:05:12,2021-04-01 14:08:07.224579
481,2342,4,2342,20,654,20,7,1,7,Discrimination,2,654,87,2021-04-01 14:05:12,2021-04-01 14:08:07.224579
482,2343,2,2343,24,654,24,8,1,8,Financial Pressure,2,654,87,2021-04-01 14:05:12,2021-04-01 14:08:07.224579
483,2344,5,2344,27,654,27,9,1,9,Faculty & Staff Support,2,654,87,2021-04-01 14:05:12,2021-04-01 14:08:07.224579
484,2345,3,2345,32,654,32,10,1,10,Friendships,2,654,87,2021-04-01 14:05:12,2021-04-01 14:08:07.224579
485,2346,2,2346,17,655,17,6,0,6,Life - School Balance,2,655,88,2021-04-01 14:05:12,2021-04-01 14:13:58.856787
486,2347,6,2347,19,655,19,7,0,7,Discrimination,2,655,88,2021-04-01 14:05:12,2021-04-01 14:13:58.856787
487,2348,4,2348,25,655,25,8,0,8,Financial Pressure,2,655,88,2021-04-01 14:05:12,2021-04-01 14:13:58.856787
488,2349,5,2349,29,655,29,9,0,9,Faculty & Staff Support,2,655,88,2021-04-01 14:05:12,2021-04-01 14:13:58.856787
489,2350,5,2350,32,655,32,10,1,10,Friendships,2,655,88,2021-04-01 14:05:12,2021-04-01 14:13:58.856787
490,2406,3,2406,17,667,17,6,0,6,Life - School Balance,2,667,103,2021-04-01 14:05:14,2021-04-01 14:07:07.684201
491,2407,3,2407,20,667,20,7,1,7,Discrimination,2,667,103,2021-04-01 14:05:14,2021-04-01 14:07:07.684201
492,2408,2,2408,23,667,23,8,1,8,Financial Pressure,2,667,103,2021-04-01 14:05:14,2021-04-01 14:07:07.684201
493,2409,6,2409,28,667,28,9,1,9,Faculty & Staff Support,2,667,103,2021-04-01 14:05:14,2021-04-01 14:07:07.684201
494,2410,1,2410,32,667,32,10,1,10,Friendships,2,667,103,2021-04-01 14:05:14,2021-04-01 14:07:07.684201
495,2461,3,2461,17,678,17,6,0,6,Life - School Balance,2,678,13,2021-04-06 19:05:02,2021-04-06 23:53:19.048722
496,2462,4,2462,21,678,21,7,1,7,Discrimination,2,678,13,2021-04-06 19:05:02,2021-04-06 23:53:19.048722
497,2463,4,2463,23,678,23,8,1,8,Financial Pressure,2,678,13,2021-04-06 19:05:02,2021-04-06 23:53:19.048722
498,2464,4,2464,27,678,27,9,1,9,Faculty & Staff Support,2,678,13,2021-04-06 19:05:02,2021-04-06 23:53:19.048722
499,2465,4,2465,33,678,33,10,0,10,Friendships,2,678,13,2021-04-06 19:05:02,2021-04-06 23:53:19.048722
500,2481,2,2481,17,682,17,6,0,6,Life - School Balance,2,682,18,2021-04-06 19:05:02,2021-04-06 19:05:40.377105
501,2482,3,2482,21,682,21,7,1,7,Discrimination,2,682,18,2021-04-06 19:05:02,2021-04-06 19:05:40.377105
502,2483,6,2483,23,682,23,8,1,8,Financial Pressure,2,682,18,2021-04-06 19:05:02,2021-04-06 19:05:40.377105
503,2484,5,2484,27,682,27,9,1,9,Faculty & Staff Support,2,682,18,2021-04-06 19:05:02,2021-04-06 19:05:40.377105
504,2485,4,2485,32,682,32,10,1,10,Friendships,2,682,18,2021-04-06 19:05:02,2021-04-06 19:05:40.377105
505,2496,3,2496,17,685,17,6,0,6,Life - School Balance,2,685,22,2021-04-06 19:05:03,2021-04-06 19:17:45.205704
506,2497,6,2497,19,685,19,7,0,7,Discrimination,2,685,22,2021-04-06 19:05:03,2021-04-06 19:17:45.205704
507,2498,6,2498,22,685,22,8,1,8,Financial Pressure,2,685,22,2021-04-06 19:05:03,2021-04-06 19:17:45.205704
508,2499,3,2499,27,685,27,9,1,9,Faculty & Staff Support,2,685,22,2021-04-06 19:05:03,2021-04-06 19:17:45.205704
509,2500,2,2500,30,685,30,10,1,10,Friendships,2,685,22,2021-04-06 19:05:03,2021-04-06 19:17:45.205704
510,2501,2,2501,17,686,17,6,0,6,Life - School Balance,2,686,23,2021-04-06 19:05:03,2021-04-06 19:21:12.403182
511,2502,2,2502,21,686,21,7,1,7,Discrimination,2,686,23,2021-04-06 19:05:03,2021-04-06 19:21:12.403182
512,2503,6,2503,22,686,22,8,1,8,Financial Pressure,2,686,23,2021-04-06 19:05:03,2021-04-06 19:21:12.403182
513,2504,2,2504,28,686,28,9,1,9,Faculty & Staff Support,2,686,23,2021-04-06 19:05:03,2021-04-06 19:21:12.403182
514,2505,5,2505,30,686,30,10,1,10,Friendships,2,686,23,2021-04-06 19:05:03,2021-04-06 19:21:12.403182
515,2511,4,2511,17,688,17,6,0,6,Life - School Balance,2,688,27,2021-04-06 19:05:03,2021-04-06 19:40:52.041436
516,2512,6,2512,19,688,19,7,0,7,Discrimination,2,688,27,2021-04-06 19:05:03,2021-04-06 19:40:52.041436
517,2513,4,2513,25,688,25,8,0,8,Financial Pressure,2,688,27,2021-04-06 19:05:03,2021-04-06 19:40:52.041436
518,2514,6,2514,28,688,28,9,1,9,Faculty & Staff Support,2,688,27,2021-04-06 19:05:03,2021-04-06 19:40:52.041436
519,2515,5,2515,33,688,33,10,0,10,Friendships,2,688,27,2021-04-06 19:05:03,2021-04-06 19:40:52.041436
520,2526,3,2526,17,691,17,6,0,6,Life - School Balance,2,691,31,2021-04-06 19:05:04,2021-04-06 19:10:07.247593
521,2527,4,2527,20,691,20,7,1,7,Discrimination,2,691,31,2021-04-06 19:05:04,2021-04-06 19:10:07.247593
522,2528,6,2528,24,691,24,8,1,8,Financial Pressure,2,691,31,2021-04-06 19:05:04,2021-04-06 19:10:07.247593
523,2529,3,2529,28,691,28,9,1,9,Faculty & Staff Support,2,691,31,2021-04-06 19:05:04,2021-04-06 19:10:07.247593
524,2530,3,2530,33,691,33,10,0,10,Friendships,2,691,31,2021-04-06 19:05:04,2021-04-06 19:10:07.247593
525,2581,4,2581,17,702,17,6,0,6,Life - School Balance,2,702,47,2021-04-06 19:05:07,2021-04-06 19:07:51.357456
526,2582,6,2582,19,702,19,7,0,7,Discrimination,2,702,47,2021-04-06 19:05:07,2021-04-06 19:07:51.357456
527,2583,4,2583,25,702,25,8,0,8,Financial Pressure,2,702,47,2021-04-06 19:05:07,2021-04-06 19:07:51.357456
528,2584,4,2584,28,702,28,9,1,9,Faculty & Staff Support,2,702,47,2021-04-06 19:05:07,2021-04-06 19:07:51.357456
529,2585,4,2585,30,702,30,10,1,10,Friendships,2,702,47,2021-04-06 19:05:07,2021-04-06 19:07:51.357456
530,2606,4,2606,17,707,17,6,0,6,Life - School Balance,2,707,54,2021-04-06 19:05:08,2021-04-07 04:03:37.591043
531,2607,4,2607,21,707,21,7,1,7,Discrimination,2,707,54,2021-04-06 19:05:08,2021-04-07 04:03:37.591043
532,2608,5,2608,23,707,23,8,1,8,Financial Pressure,2,707,54,2021-04-06 19:05:08,2021-04-07 04:03:37.591043
533,2609,6,2609,27,707,27,9,1,9,Faculty & Staff Support,2,707,54,2021-04-06 19:05:08,2021-04-07 04:03:37.591043
534,2610,4,2610,30,707,30,10,1,10,Friendships,2,707,54,2021-04-06 19:05:08,2021-04-07 04:03:37.591043
535,2616,4,2616,17,709,17,6,0,6,Life - School Balance,2,709,57,2021-04-06 19:05:08,2021-04-06 19:06:26.424378
536,2617,6,2617,21,709,21,7,1,7,Discrimination,2,709,57,2021-04-06 19:05:08,2021-04-06 19:06:26.424378
537,2618,2,2618,22,709,22,8,1,8,Financial Pressure,2,709,57,2021-04-06 19:05:08,2021-04-06 19:06:26.424378
538,2619,5,2619,26,709,26,9,1,9,Faculty & Staff Support,2,709,57,2021-04-06 19:05:08,2021-04-06 19:06:26.424378
539,2620,6,2620,33,709,33,10,0,10,Friendships,2,709,57,2021-04-06 19:05:08,2021-04-06 19:06:26.424378
540,2621,4,2621,17,710,17,6,0,6,Life - School Balance,2,710,58,2021-04-06 19:05:08,2021-04-06 19:06:31.270960
541,2622,3,2622,21,710,21,7,1,7,Discrimination,2,710,58,2021-04-06 19:05:08,2021-04-06 19:06:31.270960
542,2623,2,2623,22,710,22,8,1,8,Financial Pressure,2,710,58,2021-04-06 19:05:08,2021-04-06 19:06:31.270960
543,2624,5,2624,29,710,29,9,0,9,Faculty & Staff Support,2,710,58,2021-04-06 19:05:08,2021-04-06 19:06:31.270960
544,2625,2,2625,33,710,33,10,0,10,Friendships,2,710,58,2021-04-06 19:05:08,2021-04-06 19:06:31.270960
545,2656,5,2656,17,717,17,6,0,6,Life - School Balance,2,717,67,2021-04-06 19:05:09,2021-04-06 20:07:24.942227
546,2657,3,2657,20,717,20,7,1,7,Discrimination,2,717,67,2021-04-06 19:05:09,2021-04-06 20:07:24.942227
547,2658,6,2658,22,717,22,8,1,8,Financial Pressure,2,717,67,2021-04-06 19:05:09,2021-04-06 20:07:24.942227
548,2659,5,2659,28,717,28,9,1,9,Faculty & Staff Support,2,717,67,2021-04-06 19:05:09,2021-04-06 20:07:24.942227
549,2660,4,2660,30,717,30,10,1,10,Friendships,2,717,67,2021-04-06 19:05:09,2021-04-06 20:07:24.942227
550,2671,3,2671,17,720,17,6,0,6,Life - School Balance,2,720,70,2021-04-06 19:05:10,2021-04-06 19:31:50.530747
551,2672,5,2672,19,720,19,7,0,7,Discrimination,2,720,70,2021-04-06 19:05:10,2021-04-06 19:31:50.530747
552,2673,5,2673,23,720,23,8,1,8,Financial Pressure,2,720,70,2021-04-06 19:05:10,2021-04-06 19:31:50.530747
553,2674,3,2674,28,720,28,9,1,9,Faculty & Staff Support,2,720,70,2021-04-06 19:05:10,2021-04-06 19:31:50.530747
554,2675,5,2675,31,720,31,10,1,10,Friendships,2,720,70,2021-04-06 19:05:10,2021-04-06 19:31:50.530747
555,2691,3,2691,17,724,17,6,0,6,Life - School Balance,2,724,74,2021-04-06 19:05:10,2021-04-06 19:51:59.101881
556,2692,6,2692,19,724,19,7,0,7,Discrimination,2,724,74,2021-04-06 19:05:10,2021-04-06 19:51:59.101881
557,2693,5,2693,24,724,24,8,1,8,Financial Pressure,2,724,74,2021-04-06 19:05:10,2021-04-06 19:51:59.101881
558,2694,6,2694,29,724,29,9,0,9,Faculty & Staff Support,2,724,74,2021-04-06 19:05:10,2021-04-06 19:51:59.101881
559,2695,6,2695,30,724,30,10,1,10,Friendships,2,724,74,2021-04-06 19:05:10,2021-04-06 19:51:59.101881
560,2721,5,2721,17,730,17,6,0,6,Life - School Balance,2,730,84,2021-04-06 19:05:11,2021-04-06 19:11:56.066579
561,2722,5,2722,21,730,21,7,1,7,Discrimination,2,730,84,2021-04-06 19:05:11,2021-04-06 19:11:56.066579
562,2723,4,2723,22,730,22,8,1,8,Financial Pressure,2,730,84,2021-04-06 19:05:11,2021-04-06 19:11:56.066579
563,2724,4,2724,26,730,26,9,1,9,Faculty & Staff Support,2,730,84,2021-04-06 19:05:11,2021-04-06 19:11:56.066579
564,2725,4,2725,32,730,32,10,1,10,Friendships,2,730,84,2021-04-06 19:05:11,2021-04-06 19:11:56.066579
565,2741,3,2741,17,734,17,6,0,6,Life - School Balance,2,734,88,2021-04-06 19:05:12,2021-04-06 19:27:47.866451
566,2742,5,2742,20,734,20,7,1,7,Discrimination,2,734,88,2021-04-06 19:05:12,2021-04-06 19:27:47.866451
567,2743,4,2743,25,734,25,8,0,8,Financial Pressure,2,734,88,2021-04-06 19:05:12,2021-04-06 19:27:47.866451
568,2744,5,2744,26,734,26,9,1,9,Faculty & Staff Support,2,734,88,2021-04-06 19:05:12,2021-04-06 19:27:47.866451
569,2745,6,2745,31,734,31,10,1,10,Friendships,2,734,88,2021-04-06 19:05:12,2021-04-06 19:27:47.866451
570,2751,3,2751,17,736,17,6,0,6,Life - School Balance,2,736,90,2021-04-06 19:05:12,2021-04-06 19:18:04.841864
571,2752,5,2752,19,736,19,7,0,7,Discrimination,2,736,90,2021-04-06 19:05:12,2021-04-06 19:18:04.841864
572,2753,6,2753,24,736,24,8,1,8,Financial Pressure,2,736,90,2021-04-06 19:05:12,2021-04-06 19:18:04.841864
573,2754,4,2754,29,736,29,9,0,9,Faculty & Staff Support,2,736,90,2021-04-06 19:05:12,2021-04-06 19:18:04.841864
574,2755,4,2755,33,736,33,10,0,10,Friendships,2,736,90,2021-04-06 19:05:12,2021-04-06 19:18:04.841864
575,2756,5,2756,17,737,17,6,0,6,Life - School Balance,2,737,91,2021-04-06 19:05:12,2021-04-06 20:34:22.974520
576,2757,6,2757,21,737,21,7,1,7,Discrimination,2,737,91,2021-04-06 19:05:12,2021-04-06 20:34:22.974520
577,2758,6,2758,25,737,25,8,0,8,Financial Pressure,2,737,91,2021-04-06 19:05:12,2021-04-06 20:34:22.974520
578,2759,6,2759,27,737,27,9,1,9,Faculty & Staff Support,2,737,91,2021-04-06 19:05:12,2021-04-06 20:34:22.974520
579,2760,5,2760,33,737,33,10,0,10,Friendships,2,737,91,2021-04-06 19:05:12,2021-04-06 20:34:22.974520
580,2791,3,2791,17,744,17,6,0,6,Life - School Balance,2,744,100,2021-04-06 19:05:14,2021-04-06 19:18:06.495034
581,2792,6,2792,19,744,19,7,0,7,Discrimination,2,744,100,2021-04-06 19:05:14,2021-04-06 19:18:06.495034
582,2793,6,2793,25,744,25,8,0,8,Financial Pressure,2,744,100,2021-04-06 19:05:14,2021-04-06 19:18:06.495034
583,2794,5,2794,27,744,27,9,1,9,Faculty & Staff Support,2,744,100,2021-04-06 19:05:14,2021-04-06 19:18:06.495034
584,2795,5,2795,32,744,32,10,1,10,Friendships,2,744,100,2021-04-06 19:05:14,2021-04-06 19:18:06.495034
585,2811,3,2811,17,748,17,6,0,6,Life - School Balance,2,748,105,2021-04-06 19:05:14,2021-04-07 00:42:55.160125
586,2812,3,2812,20,748,20,7,1,7,Discrimination,2,748,105,2021-04-06 19:05:14,2021-04-07 00:42:55.160125
587,2813,6,2813,24,748,24,8,1,8,Financial Pressure,2,748,105,2021-04-06 19:05:14,2021-04-07 00:42:55.160125
588,2814,2,2814,28,748,28,9,1,9,Faculty & Staff Support,2,748,105,2021-04-06 19:05:14,2021-04-07 00:42:55.160125
589,2815,3,2815,30,748,30,10,1,10,Friendships,2,748,105,2021-04-06 19:05:14,2021-04-07 00:42:55.160125
590,2846,2,2846,17,755,17,6,0,6,Life - School Balance,2,755,9,2021-04-08 14:05:02,2021-04-08 14:46:00.953793
591,2847,5,2847,19,755,19,7,0,7,Discrimination,2,755,9,2021-04-08 14:05:02,2021-04-08 14:46:00.953793
592,2848,3,2848,25,755,25,8,0,8,Financial Pressure,2,755,9,2021-04-08 14:05:02,2021-04-08 14:46:00.953793
593,2849,6,2849,27,755,27,9,1,9,Faculty & Staff Support,2,755,9,2021-04-08 14:05:02,2021-04-08 14:46:00.953793
594,2850,6,2850,32,755,32,10,1,10,Friendships,2,755,9,2021-04-08 14:05:02,2021-04-08 14:46:00.953793
595,2851,3,2851,17,756,17,6,0,6,Life - School Balance,2,756,10,2021-04-08 14:05:03,2021-04-08 14:56:42.757108
596,2852,6,2852,19,756,19,7,0,7,Discrimination,2,756,10,2021-04-08 14:05:03,2021-04-08 14:56:42.757108
597,2853,2,2853,25,756,25,8,0,8,Financial Pressure,2,756,10,2021-04-08 14:05:03,2021-04-08 14:56:42.757108
598,2854,5,2854,26,756,26,9,1,9,Faculty & Staff Support,2,756,10,2021-04-08 14:05:03,2021-04-08 14:56:42.757108
599,2855,5,2855,32,756,32,10,1,10,Friendships,2,756,10,2021-04-08 14:05:03,2021-04-08 14:56:42.757108
600,2881,4,2881,17,762,17,6,0,6,Life - School Balance,2,762,19,2021-04-08 14:05:04,2021-04-08 14:08:22.820932
601,2882,5,2882,20,762,20,7,1,7,Discrimination,2,762,19,2021-04-08 14:05:04,2021-04-08 14:08:22.820932
602,2883,5,2883,23,762,23,8,1,8,Financial Pressure,2,762,19,2021-04-08 14:05:04,2021-04-08 14:08:22.820932
603,2884,5,2884,26,762,26,9,1,9,Faculty & Staff Support,2,762,19,2021-04-08 14:05:04,2021-04-08 14:08:22.820932
604,2885,6,2885,31,762,31,10,1,10,Friendships,2,762,19,2021-04-08 14:05:04,2021-04-08 14:08:22.820932
605,2886,2,2886,17,763,17,6,0,6,Life - School Balance,2,763,20,2021-04-08 14:05:04,2021-04-08 23:21:38.335116
606,2887,3,2887,19,763,19,7,0,7,Discrimination,2,763,20,2021-04-08 14:05:04,2021-04-08 23:21:38.335116
607,2888,6,2888,22,763,22,8,1,8,Financial Pressure,2,763,20,2021-04-08 14:05:04,2021-04-08 23:21:38.335116
608,2889,4,2889,26,763,26,9,1,9,Faculty & Staff Support,2,763,20,2021-04-08 14:05:04,2021-04-08 23:21:38.335116
609,2890,4,2890,31,763,31,10,1,10,Friendships,2,763,20,2021-04-08 14:05:04,2021-04-08 23:21:38.335116
610,2921,3,2921,17,770,17,6,0,6,Life - School Balance,2,770,31,2021-04-08 14:05:05,2021-04-08 14:16:06.245909
611,2922,3,2922,20,770,20,7,1,7,Discrimination,2,770,31,2021-04-08 14:05:05,2021-04-08 14:16:06.245909
612,2923,6,2923,24,770,24,8,1,8,Financial Pressure,2,770,31,2021-04-08 14:05:05,2021-04-08 14:16:06.245909
613,2924,2,2924,27,770,27,9,1,9,Faculty & Staff Support,2,770,31,2021-04-08 14:05:05,2021-04-08 14:16:06.245909
614,2925,3,2925,33,770,33,10,0,10,Friendships,2,770,31,2021-04-08 14:05:05,2021-04-08 14:16:06.245909
615,2941,4,2941,17,774,17,6,0,6,Life - School Balance,2,774,36,2021-04-08 14:05:06,2021-04-08 14:55:58.533410
616,2942,2,2942,21,774,21,7,1,7,Discrimination,2,774,36,2021-04-08 14:05:06,2021-04-08 14:55:58.533410
617,2943,6,2943,24,774,24,8,1,8,Financial Pressure,2,774,36,2021-04-08 14:05:06,2021-04-08 14:55:58.533410
618,2944,4,2944,26,774,26,9,1,9,Faculty & Staff Support,2,774,36,2021-04-08 14:05:06,2021-04-08 14:55:58.533410
619,2945,4,2945,32,774,32,10,1,10,Friendships,2,774,36,2021-04-08 14:05:06,2021-04-08 14:55:58.533410
620,2951,5,2951,17,776,17,6,0,6,Life - School Balance,2,776,41,2021-04-08 14:05:06,2021-04-08 14:06:09.767831
621,2952,5,2952,19,776,19,7,0,7,Discrimination,2,776,41,2021-04-08 14:05:06,2021-04-08 14:06:09.767831
622,2953,4,2953,23,776,23,8,1,8,Financial Pressure,2,776,41,2021-04-08 14:05:06,2021-04-08 14:06:09.767831
623,2954,5,2954,28,776,28,9,1,9,Faculty & Staff Support,2,776,41,2021-04-08 14:05:06,2021-04-08 14:06:09.767831
624,2955,5,2955,31,776,31,10,1,10,Friendships,2,776,41,2021-04-08 14:05:06,2021-04-08 14:06:09.767831
625,2996,2,2996,17,785,17,6,0,6,Life - School Balance,2,785,52,2021-04-08 14:05:08,2021-04-08 15:44:21.393200
626,2997,3,2997,20,785,20,7,1,7,Discrimination,2,785,52,2021-04-08 14:05:08,2021-04-08 15:44:21.393200
627,2998,6,2998,23,785,23,8,1,8,Financial Pressure,2,785,52,2021-04-08 14:05:08,2021-04-08 15:44:21.393200
628,2999,6,2999,26,785,26,9,1,9,Faculty & Staff Support,2,785,52,2021-04-08 14:05:08,2021-04-08 15:44:21.393200
629,3000,1,3000,33,785,33,10,0,10,Friendships,2,785,52,2021-04-08 14:05:08,2021-04-08 15:44:21.393200
630,3016,4,3016,17,789,17,6,0,6,Life - School Balance,2,789,58,2021-04-08 14:05:08,2021-04-08 22:10:17.230915
631,3017,3,3017,19,789,19,7,0,7,Discrimination,2,789,58,2021-04-08 14:05:08,2021-04-08 22:10:17.230915
632,3018,2,3018,23,789,23,8,1,8,Financial Pressure,2,789,58,2021-04-08 14:05:08,2021-04-08 22:10:17.230915
633,3019,4,3019,28,789,28,9,1,9,Faculty & Staff Support,2,789,58,2021-04-08 14:05:08,2021-04-08 22:10:17.230915
634,3020,4,3020,32,789,32,10,1,10,Friendships,2,789,58,2021-04-08 14:05:08,2021-04-08 22:10:17.230915
635,3041,5,3041,17,794,17,6,0,6,Life - School Balance,2,794,65,2021-04-08 14:05:09,2021-04-08 23:24:47.501823
636,3042,5,3042,21,794,21,7,1,7,Discrimination,2,794,65,2021-04-08 14:05:09,2021-04-08 23:24:47.501823
637,3043,3,3043,23,794,23,8,1,8,Financial Pressure,2,794,65,2021-04-08 14:05:09,2021-04-08 23:24:47.501823
638,3044,4,3044,28,794,28,9,1,9,Faculty & Staff Support,2,794,65,2021-04-08 14:05:09,2021-04-08 23:24:47.501823
639,3045,4,3045,32,794,32,10,1,10,Friendships,2,794,65,2021-04-08 14:05:09,2021-04-08 23:24:47.501823
640,3056,2,3056,17,797,17,6,0,6,Life - School Balance,2,797,68,2021-04-08 14:05:09,2021-04-08 15:52:19.870875
641,3057,5,3057,19,797,19,7,0,7,Discrimination,2,797,68,2021-04-08 14:05:09,2021-04-08 15:52:19.870875
642,3058,3,3058,24,797,24,8,1,8,Financial Pressure,2,797,68,2021-04-08 14:05:09,2021-04-08 15:52:19.870875
643,3059,2,3059,28,797,28,9,1,9,Faculty & Staff Support,2,797,68,2021-04-08 14:05:09,2021-04-08 15:52:19.870875
644,3060,3,3060,32,797,32,10,1,10,Friendships,2,797,68,2021-04-08 14:05:09,2021-04-08 15:52:19.870875
645,3071,3,3071,17,800,17,6,0,6,Life - School Balance,2,800,71,2021-04-08 14:05:10,2021-04-08 14:35:25.817933
646,3072,5,3072,20,800,20,7,1,7,Discrimination,2,800,71,2021-04-08 14:05:10,2021-04-08 14:35:25.817933
647,3073,3,3073,25,800,25,8,0,8,Financial Pressure,2,800,71,2021-04-08 14:05:10,2021-04-08 14:35:25.817933
648,3074,5,3074,29,800,29,9,0,9,Faculty & Staff Support,2,800,71,2021-04-08 14:05:10,2021-04-08 14:35:25.817933
649,3075,4,3075,31,800,31,10,1,10,Friendships,2,800,71,2021-04-08 14:05:10,2021-04-08 14:35:25.817933
650,3081,6,3081,17,802,17,6,0,6,Life - School Balance,2,802,73,2021-04-08 14:05:10,2021-04-08 14:48:53.000399
651,3082,6,3082,19,802,19,7,0,7,Discrimination,2,802,73,2021-04-08 14:05:10,2021-04-08 14:48:53.000399
652,3083,2,3083,22,802,22,8,1,8,Financial Pressure,2,802,73,2021-04-08 14:05:10,2021-04-08 14:48:53.000399
653,3084,6,3084,29,802,29,9,0,9,Faculty & Staff Support,2,802,73,2021-04-08 14:05:10,2021-04-08 14:48:53.000399
654,3085,6,3085,31,802,31,10,1,10,Friendships,2,802,73,2021-04-08 14:05:10,2021-04-08 14:48:53.000399
655,3096,4,3096,17,805,17,6,0,6,Life - School Balance,2,805,76,2021-04-08 14:05:12,2021-04-08 14:51:42.280828
656,3097,5,3097,20,805,20,7,1,7,Discrimination,2,805,76,2021-04-08 14:05:12,2021-04-08 14:51:42.280828
657,3098,2,3098,22,805,22,8,1,8,Financial Pressure,2,805,76,2021-04-08 14:05:12,2021-04-08 14:51:42.280828
658,3099,5,3099,27,805,27,9,1,9,Faculty & Staff Support,2,805,76,2021-04-08 14:05:12,2021-04-08 14:51:42.280828
659,3100,4,3100,31,805,31,10,1,10,Friendships,2,805,76,2021-04-08 14:05:12,2021-04-08 14:51:42.280828
660,3101,3,3101,17,806,17,6,0,6,Life - School Balance,2,806,77,2021-04-08 14:05:12,2021-04-08 14:58:03.972060
661,3102,5,3102,21,806,21,7,1,7,Discrimination,2,806,77,2021-04-08 14:05:12,2021-04-08 14:58:03.972060
662,3103,5,3103,24,806,24,8,1,8,Financial Pressure,2,806,77,2021-04-08 14:05:12,2021-04-08 14:58:03.972060
663,3104,4,3104,28,806,28,9,1,9,Faculty & Staff Support,2,806,77,2021-04-08 14:05:12,2021-04-08 14:58:03.972060
664,3105,3,3105,31,806,31,10,1,10,Friendships,2,806,77,2021-04-08 14:05:12,2021-04-08 14:58:03.972060
665,3121,3,3121,17,810,17,6,0,6,Life - School Balance,2,810,85,2021-04-08 14:05:13,2021-04-08 19:51:21.237063
666,3122,6,3122,21,810,21,7,1,7,Discrimination,2,810,85,2021-04-08 14:05:13,2021-04-08 19:51:21.237063
667,3123,1,3123,25,810,25,8,0,8,Financial Pressure,2,810,85,2021-04-08 14:05:13,2021-04-08 19:51:21.237063
668,3124,4,3124,27,810,27,9,1,9,Faculty & Staff Support,2,810,85,2021-04-08 14:05:13,2021-04-08 19:51:21.237063
669,3125,4,3125,32,810,32,10,1,10,Friendships,2,810,85,2021-04-08 14:05:13,2021-04-08 19:51:21.237063
670,3161,6,3161,17,818,17,6,0,6,Life - School Balance,2,818,94,2021-04-08 14:05:14,2021-04-08 14:07:09.339478
671,3162,6,3162,19,818,19,7,0,7,Discrimination,2,818,94,2021-04-08 14:05:14,2021-04-08 14:07:09.339478
672,3163,4,3163,25,818,25,8,0,8,Financial Pressure,2,818,94,2021-04-08 14:05:14,2021-04-08 14:07:09.339478
673,3164,5,3164,27,818,27,9,1,9,Faculty & Staff Support,2,818,94,2021-04-08 14:05:14,2021-04-08 14:07:09.339478
674,3165,6,3165,30,818,30,10,1,10,Friendships,2,818,94,2021-04-08 14:05:14,2021-04-08 14:07:09.339478
675,3166,4,3166,17,819,17,6,0,6,Life - School Balance,2,819,95,2021-04-08 14:05:14,2021-04-08 14:06:48.450273
676,3167,6,3167,21,819,21,7,1,7,Discrimination,2,819,95,2021-04-08 14:05:14,2021-04-08 14:06:48.450273
677,3168,4,3168,23,819,23,8,1,8,Financial Pressure,2,819,95,2021-04-08 14:05:14,2021-04-08 14:06:48.450273
678,3169,6,3169,29,819,29,9,0,9,Faculty & Staff Support,2,819,95,2021-04-08 14:05:14,2021-04-08 14:06:48.450273
679,3170,6,3170,30,819,30,10,1,10,Friendships,2,819,95,2021-04-08 14:05:14,2021-04-08 14:06:48.450273
680,3171,4,3171,17,820,17,6,0,6,Life - School Balance,2,820,96,2021-04-08 14:05:14,2021-04-08 17:38:44.323074
681,3172,6,3172,19,820,19,7,0,7,Discrimination,2,820,96,2021-04-08 14:05:14,2021-04-08 17:38:44.323074
682,3173,6,3173,22,820,22,8,1,8,Financial Pressure,2,820,96,2021-04-08 14:05:14,2021-04-08 17:38:44.323074
683,3174,4,3174,26,820,26,9,1,9,Faculty & Staff Support,2,820,96,2021-04-08 14:05:14,2021-04-08 17:38:44.323074
684,3175,4,3175,32,820,32,10,1,10,Friendships,2,820,96,2021-04-08 14:05:14,2021-04-08 17:38:44.323074
685,3181,6,3181,17,822,17,6,0,6,Life - School Balance,2,822,99,2021-04-08 14:05:15,2021-04-08 14:07:08.751141
686,3182,6,3182,21,822,21,7,1,7,Discrimination,2,822,99,2021-04-08 14:05:15,2021-04-08 14:07:08.751141
687,3183,1,3183,25,822,25,8,0,8,Financial Pressure,2,822,99,2021-04-08 14:05:15,2021-04-08 14:07:08.751141
688,3184,6,3184,27,822,27,9,1,9,Faculty & Staff Support,2,822,99,2021-04-08 14:05:15,2021-04-08 14:07:08.751141
689,3185,6,3185,30,822,30,10,1,10,Friendships,2,822,99,2021-04-08 14:05:15,2021-04-08 14:07:08.751141
690,3186,3,3186,17,823,17,6,0,6,Life - School Balance,2,823,100,2021-04-08 14:05:15,2021-04-08 14:07:48.731397
691,3187,6,3187,19,823,19,7,0,7,Discrimination,2,823,100,2021-04-08 14:05:15,2021-04-08 14:07:48.731397
692,3188,4,3188,23,823,23,8,1,8,Financial Pressure,2,823,100,2021-04-08 14:05:15,2021-04-08 14:07:48.731397
693,3189,6,3189,29,823,29,9,0,9,Faculty & Staff Support,2,823,100,2021-04-08 14:05:15,2021-04-08 14:07:48.731397
694,3190,5,3190,32,823,32,10,1,10,Friendships,2,823,100,2021-04-08 14:05:15,2021-04-08 14:07:48.731397
695,3191,3,3191,17,824,17,6,0,6,Life - School Balance,2,824,101,2021-04-08 14:05:15,2021-04-08 14:07:36.879448
696,3192,5,3192,20,824,20,7,1,7,Discrimination,2,824,101,2021-04-08 14:05:15,2021-04-08 14:07:36.879448
697,3193,5,3193,25,824,25,8,0,8,Financial Pressure,2,824,101,2021-04-08 14:05:15,2021-04-08 14:07:36.879448
698,3194,5,3194,29,824,29,9,0,9,Faculty & Staff Support,2,824,101,2021-04-08 14:05:15,2021-04-08 14:07:36.879448
699,3195,6,3195,30,824,30,10,1,10,Friendships,2,824,101,2021-04-08 14:05:15,2021-04-08 14:07:36.879448
700,3196,6,3196,17,825,17,6,0,6,Life - School Balance,2,825,103,2021-04-08 14:05:15,2021-04-08 14:43:19.796924
701,3197,1,3197,19,825,19,7,0,7,Discrimination,2,825,103,2021-04-08 14:05:15,2021-04-08 14:43:19.796924
702,3198,6,3198,22,825,22,8,1,8,Financial Pressure,2,825,103,2021-04-08 14:05:15,2021-04-08 14:43:19.796924
703,3199,5,3199,29,825,29,9,0,9,Faculty & Staff Support,2,825,103,2021-04-08 14:05:15,2021-04-08 14:43:19.796924
704,3200,3,3200,30,825,30,10,1,10,Friendships,2,825,103,2021-04-08 14:05:15,2021-04-08 14:43:19.796924
705,3236,4,3236,17,833,17,6,0,6,Life - School Balance,2,833,6,2021-04-13 19:05:01,2021-04-13 19:55:56.554278
706,3237,5,3237,19,833,19,7,0,7,Discrimination,2,833,6,2021-04-13 19:05:01,2021-04-13 19:55:56.554278
707,3238,6,3238,24,833,24,8,1,8,Financial Pressure,2,833,6,2021-04-13 19:05:01,2021-04-13 19:55:56.554278
708,3239,5,3239,26,833,26,9,1,9,Faculty & Staff Support,2,833,6,2021-04-13 19:05:01,2021-04-13 19:55:56.554278
709,3240,5,3240,31,833,31,10,1,10,Friendships,2,833,6,2021-04-13 19:05:01,2021-04-13 19:55:56.554278
710,3246,2,3246,17,835,17,6,0,6,Life - School Balance,2,835,10,2021-04-13 19:05:01,2021-04-13 19:55:57.336883
711,3247,5,3247,20,835,20,7,1,7,Discrimination,2,835,10,2021-04-13 19:05:01,2021-04-13 19:55:57.336883
712,3248,1,3248,25,835,25,8,0,8,Financial Pressure,2,835,10,2021-04-13 19:05:01,2021-04-13 19:55:57.336883
713,3249,5,3249,27,835,27,9,1,9,Faculty & Staff Support,2,835,10,2021-04-13 19:05:01,2021-04-13 19:55:57.336883
714,3250,2,3250,30,835,30,10,1,10,Friendships,2,835,10,2021-04-13 19:05:01,2021-04-13 19:55:57.336883
715,3266,2,3266,17,839,17,6,0,6,Life - School Balance,2,839,17,2021-04-13 19:05:02,2021-04-13 20:01:38.034160
716,3267,5,3267,21,839,21,7,1,7,Discrimination,2,839,17,2021-04-13 19:05:02,2021-04-13 20:01:38.034160
717,3268,5,3268,23,839,23,8,1,8,Financial Pressure,2,839,17,2021-04-13 19:05:02,2021-04-13 20:01:38.034160
718,3269,4,3269,28,839,28,9,1,9,Faculty & Staff Support,2,839,17,2021-04-13 19:05:02,2021-04-13 20:01:38.034160
719,3270,4,3270,32,839,32,10,1,10,Friendships,2,839,17,2021-04-13 19:05:02,2021-04-13 20:01:38.034160
720,3291,3,3291,17,844,17,6,0,6,Life - School Balance,2,844,23,2021-04-13 19:05:03,2021-04-13 21:33:00.445536
721,3292,4,3292,20,844,20,7,1,7,Discrimination,2,844,23,2021-04-13 19:05:03,2021-04-13 21:33:00.445536
722,3293,6,3293,24,844,24,8,1,8,Financial Pressure,2,844,23,2021-04-13 19:05:03,2021-04-13 21:33:00.445536
723,3294,6,3294,29,844,29,9,0,9,Faculty & Staff Support,2,844,23,2021-04-13 19:05:03,2021-04-13 21:33:00.445536
724,3295,3,3295,31,844,31,10,1,10,Friendships,2,844,23,2021-04-13 19:05:03,2021-04-13 21:33:00.445536
725,3296,4,3296,17,845,17,6,0,6,Life - School Balance,2,845,26,2021-04-13 19:05:03,2021-04-13 19:06:41.762125
726,3297,5,3297,20,845,20,7,1,7,Discrimination,2,845,26,2021-04-13 19:05:03,2021-04-13 19:06:41.762125
727,3298,4,3298,22,845,22,8,1,8,Financial Pressure,2,845,26,2021-04-13 19:05:03,2021-04-13 19:06:41.762125
728,3299,5,3299,28,845,28,9,1,9,Faculty & Staff Support,2,845,26,2021-04-13 19:05:03,2021-04-13 19:06:41.762125
729,3300,4,3300,33,845,33,10,0,10,Friendships,2,845,26,2021-04-13 19:05:03,2021-04-13 19:06:41.762125
730,3326,4,3326,17,851,17,6,0,6,Life - School Balance,2,851,34,2021-04-13 19:05:04,2021-04-13 19:44:59.289075
731,3327,6,3327,19,851,19,7,0,7,Discrimination,2,851,34,2021-04-13 19:05:04,2021-04-13 19:44:59.289075
732,3328,5,3328,25,851,25,8,0,8,Financial Pressure,2,851,34,2021-04-13 19:05:04,2021-04-13 19:44:59.289075
733,3329,4,3329,27,851,27,9,1,9,Faculty & Staff Support,2,851,34,2021-04-13 19:05:04,2021-04-13 19:44:59.289075
734,3330,4,3330,32,851,32,10,1,10,Friendships,2,851,34,2021-04-13 19:05:04,2021-04-13 19:44:59.289075
735,3346,5,3346,17,855,17,6,0,6,Life - School Balance,2,855,41,2021-04-13 19:05:05,2021-04-13 19:25:02.200979
736,3347,4,3347,21,855,21,7,1,7,Discrimination,2,855,41,2021-04-13 19:05:05,2021-04-13 19:25:02.200979
737,3348,5,3348,23,855,23,8,1,8,Financial Pressure,2,855,41,2021-04-13 19:05:05,2021-04-13 19:25:02.200979
738,3349,5,3349,29,855,29,9,0,9,Faculty & Staff Support,2,855,41,2021-04-13 19:05:05,2021-04-13 19:25:02.200979
739,3350,5,3350,32,855,32,10,1,10,Friendships,2,855,41,2021-04-13 19:05:05,2021-04-13 19:25:02.200979
740,3361,5,3361,17,858,17,6,0,6,Life - School Balance,2,858,45,2021-04-13 19:05:05,2021-04-13 19:06:36.025372
741,3362,5,3362,20,858,20,7,1,7,Discrimination,2,858,45,2021-04-13 19:05:05,2021-04-13 19:06:36.025372
742,3363,2,3363,24,858,24,8,1,8,Financial Pressure,2,858,45,2021-04-13 19:05:05,2021-04-13 19:06:36.025372
743,3364,5,3364,27,858,27,9,1,9,Faculty & Staff Support,2,858,45,2021-04-13 19:05:05,2021-04-13 19:06:36.025372
744,3365,5,3365,32,858,32,10,1,10,Friendships,2,858,45,2021-04-13 19:05:05,2021-04-13 19:06:36.025372
745,3376,2,3376,17,861,17,6,0,6,Life - School Balance,2,861,48,2021-04-13 19:05:06,2021-04-13 19:20:38.344446
746,3377,5,3377,20,861,20,7,1,7,Discrimination,2,861,48,2021-04-13 19:05:06,2021-04-13 19:20:38.344446
747,3378,4,3378,22,861,22,8,1,8,Financial Pressure,2,861,48,2021-04-13 19:05:06,2021-04-13 19:20:38.344446
748,3379,4,3379,28,861,28,9,1,9,Faculty & Staff Support,2,861,48,2021-04-13 19:05:06,2021-04-13 19:20:38.344446
749,3380,5,3380,32,861,32,10,1,10,Friendships,2,861,48,2021-04-13 19:05:06,2021-04-13 19:20:38.344446
750,3381,4,3381,17,862,17,6,0,6,Life - School Balance,2,862,49,2021-04-13 19:05:06,2021-04-14 00:23:18.176198
751,3382,5,3382,19,862,19,7,0,7,Discrimination,2,862,49,2021-04-13 19:05:06,2021-04-14 00:23:18.176198
752,3383,4,3383,23,862,23,8,1,8,Financial Pressure,2,862,49,2021-04-13 19:05:06,2021-04-14 00:23:18.176198
753,3384,5,3384,28,862,28,9,1,9,Faculty & Staff Support,2,862,49,2021-04-13 19:05:06,2021-04-14 00:23:18.176198
754,3385,4,3385,30,862,30,10,1,10,Friendships,2,862,49,2021-04-13 19:05:06,2021-04-14 00:23:18.176198
755,3391,1,3391,17,864,17,6,0,6,Life - School Balance,2,864,52,2021-04-13 19:05:06,2021-04-13 19:06:12.024284
756,3392,2,3392,21,864,21,7,1,7,Discrimination,2,864,52,2021-04-13 19:05:06,2021-04-13 19:06:12.024284
757,3393,6,3393,25,864,25,8,0,8,Financial Pressure,2,864,52,2021-04-13 19:05:06,2021-04-13 19:06:12.024284
758,3394,6,3394,29,864,29,9,0,9,Faculty & Staff Support,2,864,52,2021-04-13 19:05:06,2021-04-13 19:06:12.024284
759,3395,2,3395,30,864,30,10,1,10,Friendships,2,864,52,2021-04-13 19:05:06,2021-04-13 19:06:12.024284
760,3396,3,3396,17,865,17,6,0,6,Life - School Balance,2,865,54,2021-04-13 19:05:06,2021-04-13 19:46:33.672631
761,3397,5,3397,19,865,19,7,0,7,Discrimination,2,865,54,2021-04-13 19:05:06,2021-04-13 19:46:33.672631
762,3398,3,3398,22,865,22,8,1,8,Financial Pressure,2,865,54,2021-04-13 19:05:06,2021-04-13 19:46:33.672631
763,3399,6,3399,28,865,28,9,1,9,Faculty & Staff Support,2,865,54,2021-04-13 19:05:06,2021-04-13 19:46:33.672631
764,3400,5,3400,31,865,31,10,1,10,Friendships,2,865,54,2021-04-13 19:05:06,2021-04-13 19:46:33.672631
765,3401,4,3401,17,866,17,6,0,6,Life - School Balance,2,866,55,2021-04-13 19:05:06,2021-04-13 19:06:11.503006
766,3402,4,3402,20,866,20,7,1,7,Discrimination,2,866,55,2021-04-13 19:05:06,2021-04-13 19:06:11.503006
767,3403,2,3403,23,866,23,8,1,8,Financial Pressure,2,866,55,2021-04-13 19:05:06,2021-04-13 19:06:11.503006
768,3404,4,3404,28,866,28,9,1,9,Faculty & Staff Support,2,866,55,2021-04-13 19:05:06,2021-04-13 19:06:11.503006
769,3405,4,3405,31,866,31,10,1,10,Friendships,2,866,55,2021-04-13 19:05:06,2021-04-13 19:06:11.503006
770,3406,4,3406,17,867,17,6,0,6,Life - School Balance,2,867,57,2021-04-13 19:05:07,2021-04-13 19:06:11.143521
771,3407,6,3407,19,867,19,7,0,7,Discrimination,2,867,57,2021-04-13 19:05:07,2021-04-13 19:06:11.143521
772,3408,4,3408,22,867,22,8,1,8,Financial Pressure,2,867,57,2021-04-13 19:05:07,2021-04-13 19:06:11.143521
773,3409,5,3409,29,867,29,9,0,9,Faculty & Staff Support,2,867,57,2021-04-13 19:05:07,2021-04-13 19:06:11.143521
774,3410,6,3410,33,867,33,10,0,10,Friendships,2,867,57,2021-04-13 19:05:07,2021-04-13 19:06:11.143521
775,3411,5,3411,17,868,17,6,0,6,Life - School Balance,2,868,58,2021-04-13 19:05:07,2021-04-13 19:06:08.190582
776,3412,4,3412,19,868,19,7,0,7,Discrimination,2,868,58,2021-04-13 19:05:07,2021-04-13 19:06:08.190582
777,3413,2,3413,24,868,24,8,1,8,Financial Pressure,2,868,58,2021-04-13 19:05:07,2021-04-13 19:06:08.190582
778,3414,5,3414,29,868,29,9,0,9,Faculty & Staff Support,2,868,58,2021-04-13 19:05:07,2021-04-13 19:06:08.190582
779,3415,4,3415,30,868,30,10,1,10,Friendships,2,868,58,2021-04-13 19:05:07,2021-04-13 19:06:08.190582
780,3436,2,3436,17,873,17,6,0,6,Life - School Balance,2,873,65,2021-04-13 19:05:07,2021-04-13 21:08:27.193843
781,3437,4,3437,19,873,19,7,0,7,Discrimination,2,873,65,2021-04-13 19:05:07,2021-04-13 21:08:27.193843
782,3438,3,3438,23,873,23,8,1,8,Financial Pressure,2,873,65,2021-04-13 19:05:07,2021-04-13 21:08:27.193843
783,3439,6,3439,26,873,26,9,1,9,Faculty & Staff Support,2,873,65,2021-04-13 19:05:07,2021-04-13 21:08:27.193843
784,3440,5,3440,32,873,32,10,1,10,Friendships,2,873,65,2021-04-13 19:05:07,2021-04-13 21:08:27.193843
785,3451,3,3451,17,876,17,6,0,6,Life - School Balance,2,876,68,2021-04-13 19:05:08,2021-04-13 19:30:49.665482
786,3452,3,3452,20,876,20,7,1,7,Discrimination,2,876,68,2021-04-13 19:05:08,2021-04-13 19:30:49.665482
787,3453,3,3453,22,876,22,8,1,8,Financial Pressure,2,876,68,2021-04-13 19:05:08,2021-04-13 19:30:49.665482
788,3454,5,3454,29,876,29,9,0,9,Faculty & Staff Support,2,876,68,2021-04-13 19:05:08,2021-04-13 19:30:49.665482
789,3455,3,3455,31,876,31,10,1,10,Friendships,2,876,68,2021-04-13 19:05:08,2021-04-13 19:30:49.665482
790,3456,3,3456,17,877,17,6,0,6,Life - School Balance,2,877,69,2021-04-13 19:05:08,2021-04-13 19:06:11.315845
791,3457,4,3457,19,877,19,7,0,7,Discrimination,2,877,69,2021-04-13 19:05:08,2021-04-13 19:06:11.315845
792,3458,4,3458,24,877,24,8,1,8,Financial Pressure,2,877,69,2021-04-13 19:05:08,2021-04-13 19:06:11.315845
793,3459,4,3459,27,877,27,9,1,9,Faculty & Staff Support,2,877,69,2021-04-13 19:05:08,2021-04-13 19:06:11.315845
794,3460,4,3460,33,877,33,10,0,10,Friendships,2,877,69,2021-04-13 19:05:08,2021-04-13 19:06:11.315845
795,3466,3,3466,17,879,17,6,0,6,Life - School Balance,2,879,71,2021-04-13 19:05:08,2021-04-13 19:21:31.948941
796,3467,5,3467,19,879,19,7,0,7,Discrimination,2,879,71,2021-04-13 19:05:08,2021-04-13 19:21:31.948941
797,3468,4,3468,25,879,25,8,0,8,Financial Pressure,2,879,71,2021-04-13 19:05:08,2021-04-13 19:21:31.948941
798,3469,5,3469,28,879,28,9,1,9,Faculty & Staff Support,2,879,71,2021-04-13 19:05:08,2021-04-13 19:21:31.948941
799,3470,5,3470,32,879,32,10,1,10,Friendships,2,879,71,2021-04-13 19:05:08,2021-04-13 19:21:31.948941
800,3481,3,3481,17,882,17,6,0,6,Life - School Balance,2,882,74,2021-04-13 19:05:09,2021-04-13 19:15:03.254833
801,3482,6,3482,21,882,21,7,1,7,Discrimination,2,882,74,2021-04-13 19:05:09,2021-04-13 19:15:03.254833
802,3483,5,3483,23,882,23,8,1,8,Financial Pressure,2,882,74,2021-04-13 19:05:09,2021-04-13 19:15:03.254833
803,3484,6,3484,29,882,29,9,0,9,Faculty & Staff Support,2,882,74,2021-04-13 19:05:09,2021-04-13 19:15:03.254833
804,3485,6,3485,31,882,31,10,1,10,Friendships,2,882,74,2021-04-13 19:05:09,2021-04-13 19:15:03.254833
805,3501,2,3501,17,886,17,6,0,6,Life - School Balance,2,886,78,2021-04-13 19:05:09,2021-04-13 21:02:23.781825
806,3502,5,3502,20,886,20,7,1,7,Discrimination,2,886,78,2021-04-13 19:05:09,2021-04-13 21:02:23.781825
807,3503,3,3503,25,886,25,8,0,8,Financial Pressure,2,886,78,2021-04-13 19:05:09,2021-04-13 21:02:23.781825
808,3504,5,3504,29,886,29,9,0,9,Faculty & Staff Support,2,886,78,2021-04-13 19:05:09,2021-04-13 21:02:23.781825
809,3505,6,3505,32,886,32,10,1,10,Friendships,2,886,78,2021-04-13 19:05:09,2021-04-13 21:02:23.781825
810,3516,5,3516,17,889,17,6,0,6,Life - School Balance,2,889,85,2021-04-13 19:05:10,2021-04-13 19:18:18.925877
811,3517,6,3517,20,889,20,7,1,7,Discrimination,2,889,85,2021-04-13 19:05:10,2021-04-13 19:18:18.925877
812,3518,5,3518,22,889,22,8,1,8,Financial Pressure,2,889,85,2021-04-13 19:05:10,2021-04-13 19:18:18.925877
813,3519,4,3519,29,889,29,9,0,9,Faculty & Staff Support,2,889,85,2021-04-13 19:05:10,2021-04-13 19:18:18.925877
814,3520,4,3520,32,889,32,10,1,10,Friendships,2,889,85,2021-04-13 19:05:10,2021-04-13 19:18:18.925877
815,3526,4,3526,17,891,17,6,0,6,Life - School Balance,2,891,87,2021-04-13 19:05:10,2021-04-13 19:07:51.009072
816,3527,5,3527,21,891,21,7,1,7,Discrimination,2,891,87,2021-04-13 19:05:10,2021-04-13 19:07:51.009072
817,3528,2,3528,24,891,24,8,1,8,Financial Pressure,2,891,87,2021-04-13 19:05:10,2021-04-13 19:07:51.009072
818,3529,5,3529,26,891,26,9,1,9,Faculty & Staff Support,2,891,87,2021-04-13 19:05:10,2021-04-13 19:07:51.009072
819,3530,6,3530,31,891,31,10,1,10,Friendships,2,891,87,2021-04-13 19:05:10,2021-04-13 19:07:51.009072
820,3556,6,3556,17,897,17,6,0,6,Life - School Balance,2,897,94,2021-04-13 19:05:11,2021-04-13 20:26:24.592016
821,3557,6,3557,19,897,19,7,0,7,Discrimination,2,897,94,2021-04-13 19:05:11,2021-04-13 20:26:24.592016
822,3558,4,3558,25,897,25,8,0,8,Financial Pressure,2,897,94,2021-04-13 19:05:11,2021-04-13 20:26:24.592016
823,3559,6,3559,28,897,28,9,1,9,Faculty & Staff Support,2,897,94,2021-04-13 19:05:11,2021-04-13 20:26:24.592016
824,3560,6,3560,32,897,32,10,1,10,Friendships,2,897,94,2021-04-13 19:05:11,2021-04-13 20:26:24.592016
825,3566,4,3566,17,899,17,6,0,6,Life - School Balance,2,899,96,2021-04-13 19:05:12,2021-04-13 19:10:41.280922
826,3567,4,3567,20,899,20,7,1,7,Discrimination,2,899,96,2021-04-13 19:05:12,2021-04-13 19:10:41.280922
827,3568,6,3568,24,899,24,8,1,8,Financial Pressure,2,899,96,2021-04-13 19:05:12,2021-04-13 19:10:41.280922
828,3569,4,3569,28,899,28,9,1,9,Faculty & Staff Support,2,899,96,2021-04-13 19:05:12,2021-04-13 19:10:41.280922
829,3570,4,3570,30,899,30,10,1,10,Friendships,2,899,96,2021-04-13 19:05:12,2021-04-13 19:10:41.280922
830,3601,3,3601,17,906,17,6,0,6,Life - School Balance,2,906,105,2021-04-13 19:05:13,2021-04-13 19:08:52.641081
831,3602,3,3602,19,906,19,7,0,7,Discrimination,2,906,105,2021-04-13 19:05:13,2021-04-13 19:08:52.641081
832,3603,4,3603,23,906,23,8,1,8,Financial Pressure,2,906,105,2021-04-13 19:05:13,2021-04-13 19:08:52.641081
833,3604,3,3604,28,906,28,9,1,9,Faculty & Staff Support,2,906,105,2021-04-13 19:05:13,2021-04-13 19:08:52.641081
834,3605,5,3605,31,906,31,10,1,10,Friendships,2,906,105,2021-04-13 19:05:13,2021-04-13 19:08:52.641081
835,3676,3,3676,17,921,17,6,0,6,Life - School Balance,2,921,20,2021-04-15 14:05:03,2021-04-15 22:45:24.638551
836,3677,5,3677,20,921,20,7,1,7,Discrimination,2,921,20,2021-04-15 14:05:03,2021-04-15 22:45:24.638551
837,3678,5,3678,25,921,25,8,0,8,Financial Pressure,2,921,20,2021-04-15 14:05:03,2021-04-15 22:45:24.638551
838,3679,4,3679,27,921,27,9,1,9,Faculty & Staff Support,2,921,20,2021-04-15 14:05:03,2021-04-15 22:45:24.638551
839,3680,4,3680,30,921,30,10,1,10,Friendships,2,921,20,2021-04-15 14:05:03,2021-04-15 22:45:24.638551
840,3691,3,3691,17,924,17,6,0,6,Life - School Balance,2,924,26,2021-04-15 14:05:04,2021-04-15 14:35:12.109120
841,3692,6,3692,20,924,20,7,1,7,Discrimination,2,924,26,2021-04-15 14:05:04,2021-04-15 14:35:12.109120
842,3693,3,3693,25,924,25,8,0,8,Financial Pressure,2,924,26,2021-04-15 14:05:04,2021-04-15 14:35:12.109120
843,3694,5,3694,28,924,28,9,1,9,Faculty & Staff Support,2,924,26,2021-04-15 14:05:04,2021-04-15 14:35:12.109120
844,3695,5,3695,33,924,33,10,0,10,Friendships,2,924,26,2021-04-15 14:05:04,2021-04-15 14:35:12.109120
845,3721,4,3721,17,930,17,6,0,6,Life - School Balance,2,930,34,2021-04-15 14:05:05,2021-04-15 14:06:17.949127
846,3722,1,3722,21,930,21,7,1,7,Discrimination,2,930,34,2021-04-15 14:05:05,2021-04-15 14:06:17.949127
847,3723,1,3723,23,930,23,8,1,8,Financial Pressure,2,930,34,2021-04-15 14:05:05,2021-04-15 14:06:17.949127
848,3724,6,3724,28,930,28,9,1,9,Faculty & Staff Support,2,930,34,2021-04-15 14:05:05,2021-04-15 14:06:17.949127
849,3725,3,3725,33,930,33,10,0,10,Friendships,2,930,34,2021-04-15 14:05:05,2021-04-15 14:06:17.949127
850,3741,4,3741,17,934,17,6,0,6,Life - School Balance,2,934,41,2021-04-15 14:05:06,2021-04-15 14:28:45.929529
851,3742,5,3742,19,934,19,7,0,7,Discrimination,2,934,41,2021-04-15 14:05:06,2021-04-15 14:28:45.929529
852,3743,4,3743,25,934,25,8,0,8,Financial Pressure,2,934,41,2021-04-15 14:05:06,2021-04-15 14:28:45.929529
853,3744,5,3744,26,934,26,9,1,9,Faculty & Staff Support,2,934,41,2021-04-15 14:05:06,2021-04-15 14:28:45.929529
854,3745,4,3745,31,934,31,10,1,10,Friendships,2,934,41,2021-04-15 14:05:06,2021-04-15 14:28:45.929529
855,3786,1,3786,17,943,17,6,0,6,Life - School Balance,2,943,52,2021-04-15 14:05:07,2021-04-15 17:06:20.603326
856,3787,2,3787,21,943,21,7,1,7,Discrimination,2,943,52,2021-04-15 14:05:07,2021-04-15 17:06:20.603326
857,3788,6,3788,22,943,22,8,1,8,Financial Pressure,2,943,52,2021-04-15 14:05:07,2021-04-15 17:06:20.603326
858,3789,6,3789,28,943,28,9,1,9,Faculty & Staff Support,2,943,52,2021-04-15 14:05:07,2021-04-15 17:06:20.603326
859,3790,2,3790,33,943,33,10,0,10,Friendships,2,943,52,2021-04-15 14:05:07,2021-04-15 17:06:20.603326
860,3796,4,3796,17,945,17,6,0,6,Life - School Balance,2,945,55,2021-04-15 14:05:08,2021-04-15 14:51:59.571367
861,3797,4,3797,21,945,21,7,1,7,Discrimination,2,945,55,2021-04-15 14:05:08,2021-04-15 14:51:59.571367
862,3798,2,3798,23,945,23,8,1,8,Financial Pressure,2,945,55,2021-04-15 14:05:08,2021-04-15 14:51:59.571367
863,3799,5,3799,28,945,28,9,1,9,Faculty & Staff Support,2,945,55,2021-04-15 14:05:08,2021-04-15 14:51:59.571367
864,3800,4,3800,32,945,32,10,1,10,Friendships,2,945,55,2021-04-15 14:05:08,2021-04-15 14:51:59.571367
865,3826,3,3826,17,951,17,6,0,6,Life - School Balance,2,951,64,2021-04-15 14:05:09,2021-04-15 19:20:22.879336
866,3827,3,3827,19,951,19,7,0,7,Discrimination,2,951,64,2021-04-15 14:05:09,2021-04-15 19:20:22.879336
867,3828,4,3828,22,951,22,8,1,8,Financial Pressure,2,951,64,2021-04-15 14:05:09,2021-04-15 19:20:22.879336
868,3829,3,3829,29,951,29,9,0,9,Faculty & Staff Support,2,951,64,2021-04-15 14:05:09,2021-04-15 19:20:22.879336
869,3830,4,3830,30,951,30,10,1,10,Friendships,2,951,64,2021-04-15 14:05:09,2021-04-15 19:20:22.879336
870,3841,3,3841,17,954,17,6,0,6,Life - School Balance,2,954,67,2021-04-15 14:05:10,2021-04-15 15:57:02.066899
871,3842,3,3842,21,954,21,7,1,7,Discrimination,2,954,67,2021-04-15 14:05:10,2021-04-15 15:57:02.066899
872,3843,6,3843,23,954,23,8,1,8,Financial Pressure,2,954,67,2021-04-15 14:05:10,2021-04-15 15:57:02.066899
873,3844,5,3844,27,954,27,9,1,9,Faculty & Staff Support,2,954,67,2021-04-15 14:05:10,2021-04-15 15:57:02.066899
874,3845,3,3845,33,954,33,10,0,10,Friendships,2,954,67,2021-04-15 14:05:10,2021-04-15 15:57:02.066899
875,3856,4,3856,17,957,17,6,0,6,Life - School Balance,2,957,70,2021-04-15 14:05:10,2021-04-15 14:12:18.610183
876,3857,5,3857,21,957,21,7,1,7,Discrimination,2,957,70,2021-04-15 14:05:10,2021-04-15 14:12:18.610183
877,3858,3,3858,22,957,22,8,1,8,Financial Pressure,2,957,70,2021-04-15 14:05:10,2021-04-15 14:12:18.610183
878,3859,4,3859,29,957,29,9,0,9,Faculty & Staff Support,2,957,70,2021-04-15 14:05:10,2021-04-15 14:12:18.610183
879,3860,4,3860,30,957,30,10,1,10,Friendships,2,957,70,2021-04-15 14:05:10,2021-04-15 14:12:18.610183
880,3861,3,3861,17,958,17,6,0,6,Life - School Balance,2,958,71,2021-04-15 14:05:10,2021-04-15 14:44:09.155866
881,3862,5,3862,21,958,21,7,1,7,Discrimination,2,958,71,2021-04-15 14:05:10,2021-04-15 14:44:09.155866
882,3863,3,3863,22,958,22,8,1,8,Financial Pressure,2,958,71,2021-04-15 14:05:10,2021-04-15 14:44:09.155866
883,3864,5,3864,27,958,27,9,1,9,Faculty & Staff Support,2,958,71,2021-04-15 14:05:10,2021-04-15 14:44:09.155866
884,3865,4,3865,33,958,33,10,0,10,Friendships,2,958,71,2021-04-15 14:05:10,2021-04-15 14:44:09.155866
885,3871,6,3871,17,960,17,6,0,6,Life - School Balance,2,960,73,2021-04-15 14:05:11,2021-04-15 14:33:02.532119
886,3872,6,3872,20,960,20,7,1,7,Discrimination,2,960,73,2021-04-15 14:05:11,2021-04-15 14:33:02.532119
887,3873,2,3873,22,960,22,8,1,8,Financial Pressure,2,960,73,2021-04-15 14:05:11,2021-04-15 14:33:02.532119
888,3874,6,3874,28,960,28,9,1,9,Faculty & Staff Support,2,960,73,2021-04-15 14:05:11,2021-04-15 14:33:02.532119
889,3875,6,3875,32,960,32,10,1,10,Friendships,2,960,73,2021-04-15 14:05:11,2021-04-15 14:33:02.532119
890,3896,3,3896,17,965,17,6,0,6,Life - School Balance,2,965,78,2021-04-15 14:05:11,2021-04-15 16:04:34.850341
891,3897,5,3897,21,965,21,7,1,7,Discrimination,2,965,78,2021-04-15 14:05:11,2021-04-15 16:04:34.850341
892,3898,4,3898,24,965,24,8,1,8,Financial Pressure,2,965,78,2021-04-15 14:05:11,2021-04-15 16:04:34.850341
893,3899,5,3899,26,965,26,9,1,9,Faculty & Staff Support,2,965,78,2021-04-15 14:05:11,2021-04-15 16:04:34.850341
894,3900,5,3900,33,965,33,10,0,10,Friendships,2,965,78,2021-04-15 14:05:11,2021-04-15 16:04:34.850341
895,3921,6,3921,17,970,17,6,0,6,Life - School Balance,2,970,87,2021-04-15 14:05:12,2021-04-15 14:15:48.505389
896,3922,5,3922,19,970,19,7,0,7,Discrimination,2,970,87,2021-04-15 14:05:12,2021-04-15 14:15:48.505389
897,3923,4,3923,24,970,24,8,1,8,Financial Pressure,2,970,87,2021-04-15 14:05:12,2021-04-15 14:15:48.505389
898,3924,5,3924,29,970,29,9,0,9,Faculty & Staff Support,2,970,87,2021-04-15 14:05:12,2021-04-15 14:15:48.505389
899,3925,4,3925,30,970,30,10,1,10,Friendships,2,970,87,2021-04-15 14:05:12,2021-04-15 14:15:48.505389
900,3926,5,3926,17,971,17,6,0,6,Life - School Balance,2,971,88,2021-04-15 14:05:12,2021-04-15 15:42:58.509272
901,3927,5,3927,21,971,21,7,1,7,Discrimination,2,971,88,2021-04-15 14:05:12,2021-04-15 15:42:58.509272
902,3928,4,3928,22,971,22,8,1,8,Financial Pressure,2,971,88,2021-04-15 14:05:12,2021-04-15 15:42:58.509272
903,3929,6,3929,29,971,29,9,0,9,Faculty & Staff Support,2,971,88,2021-04-15 14:05:12,2021-04-15 15:42:58.509272
904,3930,5,3930,30,971,30,10,1,10,Friendships,2,971,88,2021-04-15 14:05:12,2021-04-15 15:42:58.509272
905,3931,6,3931,17,972,17,6,0,6,Life - School Balance,2,972,89,2021-04-15 14:05:13,2021-04-15 16:18:22.096514
906,3932,5,3932,21,972,21,7,1,7,Discrimination,2,972,89,2021-04-15 14:05:13,2021-04-15 16:18:22.096514
907,3933,1,3933,25,972,25,8,0,8,Financial Pressure,2,972,89,2021-04-15 14:05:13,2021-04-15 16:18:22.096514
908,3934,6,3934,29,972,29,9,0,9,Faculty & Staff Support,2,972,89,2021-04-15 14:05:13,2021-04-15 16:18:22.096514
909,3935,6,3935,30,972,30,10,1,10,Friendships,2,972,89,2021-04-15 14:05:13,2021-04-15 16:18:22.096514
910,3936,3,3936,17,973,17,6,0,6,Life - School Balance,2,973,90,2021-04-15 14:05:13,2021-04-15 14:08:52.462296
911,3937,5,3937,20,973,20,7,1,7,Discrimination,2,973,90,2021-04-15 14:05:13,2021-04-15 14:08:52.462296
912,3938,4,3938,25,973,25,8,0,8,Financial Pressure,2,973,90,2021-04-15 14:05:13,2021-04-15 14:08:52.462296
913,3939,4,3939,29,973,29,9,0,9,Faculty & Staff Support,2,973,90,2021-04-15 14:05:13,2021-04-15 14:08:52.462296
914,3940,5,3940,31,973,31,10,1,10,Friendships,2,973,90,2021-04-15 14:05:13,2021-04-15 14:08:52.462296
915,3941,5,3941,17,974,17,6,0,6,Life - School Balance,2,974,91,2021-04-15 14:05:13,2021-04-15 14:09:55.101230
916,3942,5,3942,21,974,21,7,1,7,Discrimination,2,974,91,2021-04-15 14:05:13,2021-04-15 14:09:55.101230
917,3943,5,3943,25,974,25,8,0,8,Financial Pressure,2,974,91,2021-04-15 14:05:13,2021-04-15 14:09:55.101230
918,3944,6,3944,28,974,28,9,1,9,Faculty & Staff Support,2,974,91,2021-04-15 14:05:13,2021-04-15 14:09:55.101230
919,3945,5,3945,33,974,33,10,0,10,Friendships,2,974,91,2021-04-15 14:05:13,2021-04-15 14:09:55.101230
920,3946,2,3946,17,975,17,6,0,6,Life - School Balance,2,975,93,2021-04-15 14:05:13,2021-04-15 23:37:40.937604
921,3947,6,3947,19,975,19,7,0,7,Discrimination,2,975,93,2021-04-15 14:05:13,2021-04-15 23:37:40.937604
922,3948,5,3948,24,975,24,8,1,8,Financial Pressure,2,975,93,2021-04-15 14:05:13,2021-04-15 23:37:40.937604
923,3949,4,3949,26,975,26,9,1,9,Faculty & Staff Support,2,975,93,2021-04-15 14:05:13,2021-04-15 23:37:40.937604
924,3950,2,3950,30,975,30,10,1,10,Friendships,2,975,93,2021-04-15 14:05:13,2021-04-15 23:37:40.937604
925,3951,6,3951,17,976,17,6,0,6,Life - School Balance,2,976,94,2021-04-15 14:05:13,2021-04-15 14:17:26.427781
926,3952,6,3952,19,976,19,7,0,7,Discrimination,2,976,94,2021-04-15 14:05:13,2021-04-15 14:17:26.427781
927,3953,3,3953,22,976,22,8,1,8,Financial Pressure,2,976,94,2021-04-15 14:05:13,2021-04-15 14:17:26.427781
928,3954,6,3954,28,976,28,9,1,9,Faculty & Staff Support,2,976,94,2021-04-15 14:05:13,2021-04-15 14:17:26.427781
929,3955,6,3955,30,976,30,10,1,10,Friendships,2,976,94,2021-04-15 14:05:13,2021-04-15 14:17:26.427781
930,3961,4,3961,17,978,17,6,0,6,Life - School Balance,2,978,96,2021-04-15 14:05:14,2021-04-15 14:06:40.563608
931,3962,5,3962,19,978,19,7,0,7,Discrimination,2,978,96,2021-04-15 14:05:14,2021-04-15 14:06:40.563608
932,3963,6,3963,24,978,24,8,1,8,Financial Pressure,2,978,96,2021-04-15 14:05:14,2021-04-15 14:06:40.563608
933,3964,4,3964,26,978,26,9,1,9,Faculty & Staff Support,2,978,96,2021-04-15 14:05:14,2021-04-15 14:06:40.563608
934,3965,4,3965,30,978,30,10,1,10,Friendships,2,978,96,2021-04-15 14:05:14,2021-04-15 14:06:40.563608
935,3966,5,3966,17,979,17,6,0,6,Life - School Balance,2,979,98,2021-04-15 14:05:14,2021-04-15 14:07:55.598320
936,3967,3,3967,20,979,20,7,1,7,Discrimination,2,979,98,2021-04-15 14:05:14,2021-04-15 14:07:55.598320
937,3968,6,3968,25,979,25,8,0,8,Financial Pressure,2,979,98,2021-04-15 14:05:14,2021-04-15 14:07:55.598320
938,3969,2,3969,26,979,26,9,1,9,Faculty & Staff Support,2,979,98,2021-04-15 14:05:14,2021-04-15 14:07:55.598320
939,3970,6,3970,31,979,31,10,1,10,Friendships,2,979,98,2021-04-15 14:05:14,2021-04-15 14:07:55.598320
940,3981,2,3981,17,982,17,6,0,6,Life - School Balance,2,982,101,2021-04-15 14:05:14,2021-04-15 14:12:25.074398
941,3982,5,3982,21,982,21,7,1,7,Discrimination,2,982,101,2021-04-15 14:05:14,2021-04-15 14:12:25.074398
942,3983,5,3983,25,982,25,8,0,8,Financial Pressure,2,982,101,2021-04-15 14:05:14,2021-04-15 14:12:25.074398
943,3984,5,3984,27,982,27,9,1,9,Faculty & Staff Support,2,982,101,2021-04-15 14:05:14,2021-04-15 14:12:25.074398
944,3985,5,3985,30,982,30,10,1,10,Friendships,2,982,101,2021-04-15 14:05:14,2021-04-15 14:12:25.074398
945,4101,2,4101,17,1006,17,6,0,6,Life - School Balance,2,1006,6,2021-04-20 19:05:01,2021-04-20 19:06:21.152138
946,4102,5,4102,19,1006,19,7,0,7,Discrimination,2,1006,6,2021-04-20 19:05:01,2021-04-20 19:06:21.152138
947,4103,6,4103,24,1006,24,8,1,8,Financial Pressure,2,1006,6,2021-04-20 19:05:01,2021-04-20 19:06:21.152138
948,4104,6,4104,26,1006,26,9,1,9,Faculty & Staff Support,2,1006,6,2021-04-20 19:05:01,2021-04-20 19:06:21.152138
949,4105,6,4105,30,1006,30,10,1,10,Friendships,2,1006,6,2021-04-20 19:05:01,2021-04-20 19:06:21.152138
950,4116,4,4116,17,1009,17,6,0,6,Life - School Balance,2,1009,13,2021-04-20 19:05:02,2021-04-20 23:25:51.654462
951,4117,5,4117,19,1009,19,7,0,7,Discrimination,2,1009,13,2021-04-20 19:05:02,2021-04-20 23:25:51.654462
952,4118,5,4118,25,1009,25,8,0,8,Financial Pressure,2,1009,13,2021-04-20 19:05:02,2021-04-20 23:25:51.654462
953,4119,5,4119,26,1009,26,9,1,9,Faculty & Staff Support,2,1009,13,2021-04-20 19:05:02,2021-04-20 23:25:51.654462
954,4120,5,4120,32,1009,32,10,1,10,Friendships,2,1009,13,2021-04-20 19:05:02,2021-04-20 23:25:51.654462
955,4156,3,4156,17,1017,17,6,0,6,Life - School Balance,2,1017,23,2021-04-20 19:05:03,2021-04-20 19:33:23.810195
956,4157,5,4157,19,1017,19,7,0,7,Discrimination,2,1017,23,2021-04-20 19:05:03,2021-04-20 19:33:23.810195
957,4158,6,4158,22,1017,22,8,1,8,Financial Pressure,2,1017,23,2021-04-20 19:05:03,2021-04-20 19:33:23.810195
958,4159,4,4159,26,1017,26,9,1,9,Faculty & Staff Support,2,1017,23,2021-04-20 19:05:03,2021-04-20 19:33:23.810195
959,4160,4,4160,31,1017,31,10,1,10,Friendships,2,1017,23,2021-04-20 19:05:03,2021-04-20 19:33:23.810195
960,4181,3,4181,17,1022,17,6,0,6,Life - School Balance,2,1022,31,2021-04-20 19:05:04,2021-04-20 19:07:20.729878
961,4182,4,4182,20,1022,20,7,1,7,Discrimination,2,1022,31,2021-04-20 19:05:04,2021-04-20 19:07:20.729878
962,4183,6,4183,25,1022,25,8,0,8,Financial Pressure,2,1022,31,2021-04-20 19:05:04,2021-04-20 19:07:20.729878
963,4184,3,4184,29,1022,29,9,0,9,Faculty & Staff Support,2,1022,31,2021-04-20 19:05:04,2021-04-20 19:07:20.729878
964,4185,3,4185,30,1022,30,10,1,10,Friendships,2,1022,31,2021-04-20 19:05:04,2021-04-20 19:07:20.729878
965,4191,3,4191,17,1024,17,6,0,6,Life - School Balance,2,1024,34,2021-04-20 19:05:05,2021-04-20 19:32:58.877972
966,4192,4,4192,20,1024,20,7,1,7,Discrimination,2,1024,34,2021-04-20 19:05:05,2021-04-20 19:32:58.877972
967,4193,4,4193,25,1024,25,8,0,8,Financial Pressure,2,1024,34,2021-04-20 19:05:05,2021-04-20 19:32:58.877972
968,4194,6,4194,26,1024,26,9,1,9,Faculty & Staff Support,2,1024,34,2021-04-20 19:05:05,2021-04-20 19:32:58.877972
969,4195,4,4195,33,1024,33,10,0,10,Friendships,2,1024,34,2021-04-20 19:05:05,2021-04-20 19:32:58.877972
970,4201,3,4201,17,1026,17,6,0,6,Life - School Balance,2,1026,36,2021-04-20 19:05:05,2021-04-20 19:09:04.340475
971,4202,3,4202,19,1026,19,7,0,7,Discrimination,2,1026,36,2021-04-20 19:05:05,2021-04-20 19:09:04.340475
972,4203,5,4203,22,1026,22,8,1,8,Financial Pressure,2,1026,36,2021-04-20 19:05:05,2021-04-20 19:09:04.340475
973,4204,4,4204,26,1026,26,9,1,9,Faculty & Staff Support,2,1026,36,2021-04-20 19:05:05,2021-04-20 19:09:04.340475
974,4205,4,4205,30,1026,30,10,1,10,Friendships,2,1026,36,2021-04-20 19:05:05,2021-04-20 19:09:04.340475
975,4211,5,4211,17,1028,17,6,0,6,Life - School Balance,2,1028,41,2021-04-20 19:05:05,2021-04-20 22:37:50.951490
976,4212,4,4212,21,1028,21,7,1,7,Discrimination,2,1028,41,2021-04-20 19:05:05,2021-04-20 22:37:50.951490
977,4213,4,4213,22,1028,22,8,1,8,Financial Pressure,2,1028,41,2021-04-20 19:05:05,2021-04-20 22:37:50.951490
978,4214,5,4214,27,1028,27,9,1,9,Faculty & Staff Support,2,1028,41,2021-04-20 19:05:05,2021-04-20 22:37:50.951490
979,4215,4,4215,30,1028,30,10,1,10,Friendships,2,1028,41,2021-04-20 19:05:05,2021-04-20 22:37:50.951490
980,4231,3,4231,17,1032,17,6,0,6,Life - School Balance,2,1032,46,2021-04-20 19:05:06,2021-04-20 19:09:49.735444
981,4232,4,4232,21,1032,21,7,1,7,Discrimination,2,1032,46,2021-04-20 19:05:06,2021-04-20 19:09:49.735444
982,4233,4,4233,23,1032,23,8,1,8,Financial Pressure,2,1032,46,2021-04-20 19:05:06,2021-04-20 19:09:49.735444
983,4234,4,4234,29,1032,29,9,0,9,Faculty & Staff Support,2,1032,46,2021-04-20 19:05:06,2021-04-20 19:09:49.735444
984,4235,6,4235,31,1032,31,10,1,10,Friendships,2,1032,46,2021-04-20 19:05:06,2021-04-20 19:09:49.735444
985,4256,1,4256,17,1037,17,6,0,6,Life - School Balance,2,1037,52,2021-04-20 19:05:07,2021-04-20 19:09:27.892386
986,4257,4,4257,20,1037,20,7,1,7,Discrimination,2,1037,52,2021-04-20 19:05:07,2021-04-20 19:09:27.892386
987,4258,6,4258,25,1037,25,8,0,8,Financial Pressure,2,1037,52,2021-04-20 19:05:07,2021-04-20 19:09:27.892386
988,4259,6,4259,26,1037,26,9,1,9,Faculty & Staff Support,2,1037,52,2021-04-20 19:05:07,2021-04-20 19:09:27.892386
989,4260,2,4260,32,1037,32,10,1,10,Friendships,2,1037,52,2021-04-20 19:05:07,2021-04-20 19:09:27.892386
990,4261,4,4261,17,1038,17,6,0,6,Life - School Balance,2,1038,54,2021-04-20 19:05:07,2021-04-20 19:05:57.148331
991,4262,4,4262,21,1038,21,7,1,7,Discrimination,2,1038,54,2021-04-20 19:05:07,2021-04-20 19:05:57.148331
992,4263,4,4263,24,1038,24,8,1,8,Financial Pressure,2,1038,54,2021-04-20 19:05:07,2021-04-20 19:05:57.148331
993,4264,6,4264,29,1038,29,9,0,9,Faculty & Staff Support,2,1038,54,2021-04-20 19:05:07,2021-04-20 19:05:57.148331
994,4265,5,4265,32,1038,32,10,1,10,Friendships,2,1038,54,2021-04-20 19:05:07,2021-04-20 19:05:57.148331
995,4271,5,4271,17,1040,17,6,0,6,Life - School Balance,2,1040,57,2021-04-20 19:05:07,2021-04-20 19:16:57.906695
996,4272,6,4272,20,1040,20,7,1,7,Discrimination,2,1040,57,2021-04-20 19:05:07,2021-04-20 19:16:57.906695
997,4273,3,4273,22,1040,22,8,1,8,Financial Pressure,2,1040,57,2021-04-20 19:05:07,2021-04-20 19:16:57.906695
998,4274,5,4274,28,1040,28,9,1,9,Faculty & Staff Support,2,1040,57,2021-04-20 19:05:07,2021-04-20 19:16:57.906695
999,4275,6,4275,30,1040,30,10,1,10,Friendships,2,1040,57,2021-04-20 19:05:07,2021-04-20 19:16:57.906695
1000,4331,4,4331,17,1052,17,6,0,6,Life - School Balance,2,1052,71,2021-04-20 19:05:09,2021-04-20 19:06:06.854992
1001,4332,5,4332,20,1052,20,7,1,7,Discrimination,2,1052,71,2021-04-20 19:05:09,2021-04-20 19:06:06.854992
1002,4333,3,4333,24,1052,24,8,1,8,Financial Pressure,2,1052,71,2021-04-20 19:05:09,2021-04-20 19:06:06.854992
1003,4334,5,4334,29,1052,29,9,0,9,Faculty & Staff Support,2,1052,71,2021-04-20 19:05:09,2021-04-20 19:06:06.854992
1004,4335,5,4335,31,1052,31,10,1,10,Friendships,2,1052,71,2021-04-20 19:05:09,2021-04-20 19:06:06.854992
1005,4341,6,4341,17,1054,17,6,0,6,Life - School Balance,2,1054,73,2021-04-20 19:05:09,2021-04-20 19:43:46.751321
1006,4342,6,4342,21,1054,21,7,1,7,Discrimination,2,1054,73,2021-04-20 19:05:09,2021-04-20 19:43:46.751321
1007,4343,2,4343,24,1054,24,8,1,8,Financial Pressure,2,1054,73,2021-04-20 19:05:09,2021-04-20 19:43:46.751321
1008,4344,6,4344,28,1054,28,9,1,9,Faculty & Staff Support,2,1054,73,2021-04-20 19:05:09,2021-04-20 19:43:46.751321
1009,4345,6,4345,32,1054,32,10,1,10,Friendships,2,1054,73,2021-04-20 19:05:09,2021-04-20 19:43:46.751321
1010,4356,3,4356,17,1057,17,6,0,6,Life - School Balance,2,1057,76,2021-04-20 19:05:10,2021-04-20 19:21:29.590617
1011,4357,4,4357,20,1057,20,7,1,7,Discrimination,2,1057,76,2021-04-20 19:05:10,2021-04-20 19:21:29.590617
1012,4358,2,4358,23,1057,23,8,1,8,Financial Pressure,2,1057,76,2021-04-20 19:05:10,2021-04-20 19:21:29.590617
1013,4359,5,4359,29,1057,29,9,0,9,Faculty & Staff Support,2,1057,76,2021-04-20 19:05:10,2021-04-20 19:21:29.590617
1014,4360,4,4360,31,1057,31,10,1,10,Friendships,2,1057,76,2021-04-20 19:05:10,2021-04-20 19:21:29.590617
1015,4431,3,4431,17,1072,17,6,0,6,Life - School Balance,2,1072,96,2021-04-20 19:05:12,2021-04-20 22:03:24.905567
1016,4432,5,4432,21,1072,21,7,1,7,Discrimination,2,1072,96,2021-04-20 19:05:12,2021-04-20 22:03:24.905567
1017,4433,6,4433,22,1072,22,8,1,8,Financial Pressure,2,1072,96,2021-04-20 19:05:12,2021-04-20 22:03:24.905567
1018,4434,4,4434,26,1072,26,9,1,9,Faculty & Staff Support,2,1072,96,2021-04-20 19:05:12,2021-04-20 22:03:24.905567
1019,4435,5,4435,33,1072,33,10,0,10,Friendships,2,1072,96,2021-04-20 19:05:12,2021-04-20 22:03:24.905567
1020,4451,3,4451,17,1076,17,6,0,6,Life - School Balance,2,1076,101,2021-04-20 19:05:13,2021-04-20 19:16:28.024076
1021,4452,5,4452,21,1076,21,7,1,7,Discrimination,2,1076,101,2021-04-20 19:05:13,2021-04-20 19:16:28.024076
1022,4453,5,4453,22,1076,22,8,1,8,Financial Pressure,2,1076,101,2021-04-20 19:05:13,2021-04-20 19:16:28.024076
1023,4454,4,4454,26,1076,26,9,1,9,Faculty & Staff Support,2,1076,101,2021-04-20 19:05:13,2021-04-20 19:16:28.024076
1024,4455,6,4455,33,1076,33,10,0,10,Friendships,2,1076,101,2021-04-20 19:05:13,2021-04-20 19:16:28.024076
1025,4496,3,4496,17,1085,17,6,0,6,Life - School Balance,2,1085,6,2021-04-22 14:05:01,2021-04-22 14:05:45.010879
1026,4497,5,4497,21,1085,21,7,1,7,Discrimination,2,1085,6,2021-04-22 14:05:01,2021-04-22 14:05:45.010879
1027,4498,5,4498,23,1085,23,8,1,8,Financial Pressure,2,1085,6,2021-04-22 14:05:01,2021-04-22 14:05:45.010879
1028,4499,4,4499,28,1085,28,9,1,9,Faculty & Staff Support,2,1085,6,2021-04-22 14:05:01,2021-04-22 14:05:45.010879
1029,4500,5,4500,32,1085,32,10,1,10,Friendships,2,1085,6,2021-04-22 14:05:01,2021-04-22 14:05:45.010879
1030,4536,4,4536,17,1093,17,6,0,6,Life - School Balance,2,1093,19,2021-04-22 14:05:03,2021-04-22 15:35:28.463337
1031,4537,4,4537,20,1093,20,7,1,7,Discrimination,2,1093,19,2021-04-22 14:05:03,2021-04-22 15:35:28.463337
1032,4538,2,4538,25,1093,25,8,0,8,Financial Pressure,2,1093,19,2021-04-22 14:05:03,2021-04-22 15:35:28.463337
1033,4539,5,4539,27,1093,27,9,1,9,Faculty & Staff Support,2,1093,19,2021-04-22 14:05:03,2021-04-22 15:35:28.463337
1034,4540,5,4540,31,1093,31,10,1,10,Friendships,2,1093,19,2021-04-22 14:05:03,2021-04-22 15:35:28.463337
1035,4606,5,4606,17,1107,17,6,0,6,Life - School Balance,2,1107,41,2021-04-22 14:05:05,2021-04-22 15:13:46.824809
1036,4607,5,4607,19,1107,19,7,0,7,Discrimination,2,1107,41,2021-04-22 14:05:05,2021-04-22 15:13:46.824809
1037,4608,4,4608,23,1107,23,8,1,8,Financial Pressure,2,1107,41,2021-04-22 14:05:05,2021-04-22 15:13:46.824809
1038,4609,5,4609,27,1107,27,9,1,9,Faculty & Staff Support,2,1107,41,2021-04-22 14:05:05,2021-04-22 15:13:46.824809
1039,4610,5,4610,31,1107,31,10,1,10,Friendships,2,1107,41,2021-04-22 14:05:05,2021-04-22 15:13:46.824809
1040,4641,3,4641,17,1114,17,6,0,6,Life - School Balance,2,1114,49,2021-04-22 14:05:06,2021-04-23 11:46:06.981944
1041,4642,4,4642,21,1114,21,7,1,7,Discrimination,2,1114,49,2021-04-22 14:05:06,2021-04-23 11:46:06.981944
1042,4643,5,4643,22,1114,22,8,1,8,Financial Pressure,2,1114,49,2021-04-22 14:05:06,2021-04-23 11:46:06.981944
1043,4644,4,4644,26,1114,26,9,1,9,Faculty & Staff Support,2,1114,49,2021-04-22 14:05:06,2021-04-23 11:46:06.981944
1044,4645,4,4645,30,1114,30,10,1,10,Friendships,2,1114,49,2021-04-22 14:05:06,2021-04-23 11:46:06.981944
1045,4671,3,4671,17,1120,17,6,0,6,Life - School Balance,2,1120,58,2021-04-22 14:05:07,2021-04-22 14:08:16.019520
1046,4672,3,4672,21,1120,21,7,1,7,Discrimination,2,1120,58,2021-04-22 14:05:07,2021-04-22 14:08:16.019520
1047,4673,2,4673,22,1120,22,8,1,8,Financial Pressure,2,1120,58,2021-04-22 14:05:07,2021-04-22 14:08:16.019520
1048,4674,5,4674,29,1120,29,9,0,9,Faculty & Staff Support,2,1120,58,2021-04-22 14:05:07,2021-04-22 14:08:16.019520
1049,4675,3,4675,33,1120,33,10,0,10,Friendships,2,1120,58,2021-04-22 14:05:07,2021-04-22 14:08:16.019520
1050,4696,2,4696,17,1125,17,6,0,6,Life - School Balance,2,1125,65,2021-04-22 14:05:08,2021-04-22 14:56:10.843567
1051,4697,5,4697,20,1125,20,7,1,7,Discrimination,2,1125,65,2021-04-22 14:05:08,2021-04-22 14:56:10.843567
1052,4698,3,4698,23,1125,23,8,1,8,Financial Pressure,2,1125,65,2021-04-22 14:05:08,2021-04-22 14:56:10.843567
1053,4699,6,4699,27,1125,27,9,1,9,Faculty & Staff Support,2,1125,65,2021-04-22 14:05:08,2021-04-22 14:56:10.843567
1054,4700,5,4700,33,1125,33,10,0,10,Friendships,2,1125,65,2021-04-22 14:05:08,2021-04-22 14:56:10.843567
1055,4741,3,4741,17,1134,17,6,0,6,Life - School Balance,2,1134,74,2021-04-22 14:05:10,2021-04-22 14:38:54.776286
1056,4742,6,4742,20,1134,20,7,1,7,Discrimination,2,1134,74,2021-04-22 14:05:10,2021-04-22 14:38:54.776286
1057,4743,5,4743,22,1134,22,8,1,8,Financial Pressure,2,1134,74,2021-04-22 14:05:10,2021-04-22 14:38:54.776286
1058,4744,6,4744,27,1134,27,9,1,9,Faculty & Staff Support,2,1134,74,2021-04-22 14:05:10,2021-04-22 14:38:54.776286
1059,4745,6,4745,32,1134,32,10,1,10,Friendships,2,1134,74,2021-04-22 14:05:10,2021-04-22 14:38:54.776286
1060,4756,4,4756,17,1137,17,6,0,6,Life - School Balance,2,1137,77,2021-04-22 14:05:10,2021-04-22 14:20:29.875445
1061,4757,3,4757,20,1137,20,7,1,7,Discrimination,2,1137,77,2021-04-22 14:05:10,2021-04-22 14:20:29.875445
1062,4758,4,4758,25,1137,25,8,0,8,Financial Pressure,2,1137,77,2021-04-22 14:05:10,2021-04-22 14:20:29.875445
1063,4759,4,4759,28,1137,28,9,1,9,Faculty & Staff Support,2,1137,77,2021-04-22 14:05:10,2021-04-22 14:20:29.875445
1064,4760,4,4760,32,1137,32,10,1,10,Friendships,2,1137,77,2021-04-22 14:05:10,2021-04-22 14:20:29.875445
1065,4786,4,4786,17,1143,17,6,0,6,Life - School Balance,2,1143,87,2021-04-22 14:05:11,2021-04-22 14:06:18.794077
1066,4787,5,4787,21,1143,21,7,1,7,Discrimination,2,1143,87,2021-04-22 14:05:11,2021-04-22 14:06:18.794077
1067,4788,2,4788,22,1143,22,8,1,8,Financial Pressure,2,1143,87,2021-04-22 14:05:11,2021-04-22 14:06:18.794077
1068,4789,5,4789,28,1143,28,9,1,9,Faculty & Staff Support,2,1143,87,2021-04-22 14:05:11,2021-04-22 14:06:18.794077
1069,4790,5,4790,32,1143,32,10,1,10,Friendships,2,1143,87,2021-04-22 14:05:11,2021-04-22 14:06:18.794077
1070,4796,6,4796,17,1145,17,6,0,6,Life - School Balance,2,1145,89,2021-04-22 14:05:11,2021-04-22 17:09:52.611617
1071,4797,5,4797,19,1145,19,7,0,7,Discrimination,2,1145,89,2021-04-22 14:05:11,2021-04-22 17:09:52.611617
1072,4798,2,4798,22,1145,22,8,1,8,Financial Pressure,2,1145,89,2021-04-22 14:05:11,2021-04-22 17:09:52.611617
1073,4799,6,4799,26,1145,26,9,1,9,Faculty & Staff Support,2,1145,89,2021-04-22 14:05:11,2021-04-22 17:09:52.611617
1074,4800,6,4800,31,1145,31,10,1,10,Friendships,2,1145,89,2021-04-22 14:05:11,2021-04-22 17:09:52.611617
1075,4811,1,4811,17,1148,17,6,0,6,Life - School Balance,2,1148,93,2021-04-22 14:05:12,2021-04-22 15:38:07.480536
1076,4812,5,4812,21,1148,21,7,1,7,Discrimination,2,1148,93,2021-04-22 14:05:12,2021-04-22 15:38:07.480536
1077,4813,3,4813,23,1148,23,8,1,8,Financial Pressure,2,1148,93,2021-04-22 14:05:12,2021-04-22 15:38:07.480536
1078,4814,4,4814,26,1148,26,9,1,9,Faculty & Staff Support,2,1148,93,2021-04-22 14:05:12,2021-04-22 15:38:07.480536
1079,4815,5,4815,32,1148,32,10,1,10,Friendships,2,1148,93,2021-04-22 14:05:12,2021-04-22 15:38:07.480536
1080,4816,6,4816,17,1149,17,6,0,6,Life - School Balance,2,1149,94,2021-04-22 14:05:12,2021-04-22 14:06:42.049922
1081,4817,6,4817,20,1149,20,7,1,7,Discrimination,2,1149,94,2021-04-22 14:05:12,2021-04-22 14:06:42.049922
1082,4818,3,4818,23,1149,23,8,1,8,Financial Pressure,2,1149,94,2021-04-22 14:05:12,2021-04-22 14:06:42.049922
1083,4819,6,4819,28,1149,28,9,1,9,Faculty & Staff Support,2,1149,94,2021-04-22 14:05:12,2021-04-22 14:06:42.049922
1084,4820,6,4820,33,1149,33,10,0,10,Friendships,2,1149,94,2021-04-22 14:05:12,2021-04-22 14:06:42.049922
1085,4826,3,4826,17,1151,17,6,0,6,Life - School Balance,2,1151,96,2021-04-22 14:05:12,2021-04-22 16:20:07.935374
1086,4827,5,4827,21,1151,21,7,1,7,Discrimination,2,1151,96,2021-04-22 14:05:12,2021-04-22 16:20:07.935374
1087,4828,6,4828,24,1151,24,8,1,8,Financial Pressure,2,1151,96,2021-04-22 14:05:12,2021-04-22 16:20:07.935374
1088,4829,5,4829,26,1151,26,9,1,9,Faculty & Staff Support,2,1151,96,2021-04-22 14:05:12,2021-04-22 16:20:07.935374
1089,4830,4,4830,31,1151,31,10,1,10,Friendships,2,1151,96,2021-04-22 14:05:12,2021-04-22 16:20:07.935374
1090,4831,5,4831,17,1152,17,6,0,6,Life - School Balance,2,1152,98,2021-04-22 14:05:13,2021-04-22 14:20:40.610565
1091,4832,5,4832,21,1152,21,7,1,7,Discrimination,2,1152,98,2021-04-22 14:05:13,2021-04-22 14:20:40.610565
1092,4833,5,4833,24,1152,24,8,1,8,Financial Pressure,2,1152,98,2021-04-22 14:05:13,2021-04-22 14:20:40.610565
1093,4834,2,4834,27,1152,27,9,1,9,Faculty & Staff Support,2,1152,98,2021-04-22 14:05:13,2021-04-22 14:20:40.610565
1094,4835,6,4835,31,1152,31,10,1,10,Friendships,2,1152,98,2021-04-22 14:05:13,2021-04-22 14:20:40.610565
1095,4841,3,4841,17,1154,17,6,0,6,Life - School Balance,2,1154,100,2021-04-22 14:05:13,2021-04-22 14:41:47.274331
1096,4842,5,4842,20,1154,20,7,1,7,Discrimination,2,1154,100,2021-04-22 14:05:13,2021-04-22 14:41:47.274331
1097,4843,5,4843,25,1154,25,8,0,8,Financial Pressure,2,1154,100,2021-04-22 14:05:13,2021-04-22 14:41:47.274331
1098,4844,6,4844,29,1154,29,9,0,9,Faculty & Staff Support,2,1154,100,2021-04-22 14:05:13,2021-04-22 14:41:47.274331
1099,4845,5,4845,32,1154,32,10,1,10,Friendships,2,1154,100,2021-04-22 14:05:13,2021-04-22 14:41:47.274331
1100,4846,2,4846,17,1155,17,6,0,6,Life - School Balance,2,1155,101,2021-04-22 14:05:13,2021-04-22 14:06:56.008140
1101,4847,6,4847,19,1155,19,7,0,7,Discrimination,2,1155,101,2021-04-22 14:05:13,2021-04-22 14:06:56.008140
1102,4848,5,4848,25,1155,25,8,0,8,Financial Pressure,2,1155,101,2021-04-22 14:05:13,2021-04-22 14:06:56.008140
1103,4849,5,4849,27,1155,27,9,1,9,Faculty & Staff Support,2,1155,101,2021-04-22 14:05:13,2021-04-22 14:06:56.008140
1104,4850,5,4850,32,1155,32,10,1,10,Friendships,2,1155,101,2021-04-22 14:05:13,2021-04-22 14:06:56.008140
1105,20086,3,20086,17,2017,17,6,0,6,Life - School Balance,2,2017,6,2021-04-27 19:05:02,2021-04-27 20:26:51.077879
1106,20087,6,20087,19,2017,19,7,0,7,Discrimination,2,2017,6,2021-04-27 19:05:02,2021-04-27 20:26:51.077879
1107,20088,5,20088,23,2017,23,8,1,8,Financial Pressure,2,2017,6,2021-04-27 19:05:02,2021-04-27 20:26:51.077879
1108,20089,5,20089,27,2017,27,9,1,9,Faculty & Staff Support,2,2017,6,2021-04-27 19:05:02,2021-04-27 20:26:51.077879
1109,20090,5,20090,33,2017,33,10,0,10,Friendships,2,2017,6,2021-04-27 19:05:02,2021-04-27 20:26:51.077879
1110,20091,3,20091,17,2018,17,6,0,6,Life - School Balance,2,2018,9,2021-04-27 19:05:02,2021-04-27 19:05:55.247026
1111,20092,6,20092,20,2018,20,7,1,7,Discrimination,2,2018,9,2021-04-27 19:05:02,2021-04-27 19:05:55.247026
1112,20093,5,20093,24,2018,24,8,1,8,Financial Pressure,2,2018,9,2021-04-27 19:05:02,2021-04-27 19:05:55.247026
1113,20094,5,20094,28,2018,28,9,1,9,Faculty & Staff Support,2,2018,9,2021-04-27 19:05:02,2021-04-27 19:05:55.247026
1114,20095,6,20095,31,2018,31,10,1,10,Friendships,2,2018,9,2021-04-27 19:05:02,2021-04-27 19:05:55.247026
1115,20096,3,20096,17,2019,17,6,0,6,Life - School Balance,2,2019,10,2021-04-27 19:05:02,2021-04-27 20:29:08.509365
1116,20097,6,20097,19,2019,19,7,0,7,Discrimination,2,2019,10,2021-04-27 19:05:02,2021-04-27 20:29:08.509365
1117,20098,4,20098,23,2019,23,8,1,8,Financial Pressure,2,2019,10,2021-04-27 19:05:02,2021-04-27 20:29:08.509365
1118,20099,5,20099,27,2019,27,9,1,9,Faculty & Staff Support,2,2019,10,2021-04-27 19:05:02,2021-04-27 20:29:08.509365
1119,20100,6,20100,33,2019,33,10,0,10,Friendships,2,2019,10,2021-04-27 19:05:02,2021-04-27 20:29:08.509365
1120,20101,3,20101,17,2020,17,6,0,6,Life - School Balance,2,2020,13,2021-04-27 19:05:03,2021-04-28 16:31:41.765148
1121,20102,5,20102,20,2020,20,7,1,7,Discrimination,2,2020,13,2021-04-27 19:05:03,2021-04-28 16:31:41.765148
1122,20103,4,20103,22,2020,22,8,1,8,Financial Pressure,2,2020,13,2021-04-27 19:05:03,2021-04-28 16:31:41.765148
1123,20104,4,20104,27,2020,27,9,1,9,Faculty & Staff Support,2,2020,13,2021-04-27 19:05:03,2021-04-28 16:31:41.765148
1124,20105,5,20105,31,2020,31,10,1,10,Friendships,2,2020,13,2021-04-27 19:05:03,2021-04-28 16:31:41.765148
1125,20121,3,20121,17,2024,17,6,0,6,Life - School Balance,2,2024,18,2021-04-27 19:05:03,2021-04-27 19:31:18.698603
1126,20122,3,20122,21,2024,21,7,1,7,Discrimination,2,2024,18,2021-04-27 19:05:03,2021-04-27 19:31:18.698603
1127,20123,6,20123,22,2024,22,8,1,8,Financial Pressure,2,2024,18,2021-04-27 19:05:03,2021-04-27 19:31:18.698603
1128,20124,4,20124,27,2024,27,9,1,9,Faculty & Staff Support,2,2024,18,2021-04-27 19:05:03,2021-04-27 19:31:18.698603
1129,20125,4,20125,33,2024,33,10,0,10,Friendships,2,2024,18,2021-04-27 19:05:03,2021-04-27 19:31:18.698603
1130,20141,3,20141,17,2028,17,6,0,6,Life - School Balance,2,2028,23,2021-04-27 19:05:04,2021-04-27 19:11:36.399721
1131,20142,4,20142,20,2028,20,7,1,7,Discrimination,2,2028,23,2021-04-27 19:05:04,2021-04-27 19:11:36.399721
1132,20143,6,20143,25,2028,25,8,0,8,Financial Pressure,2,2028,23,2021-04-27 19:05:04,2021-04-27 19:11:36.399721
1133,20144,5,20144,26,2028,26,9,1,9,Faculty & Staff Support,2,2028,23,2021-04-27 19:05:04,2021-04-27 19:11:36.399721
1134,20145,4,20145,30,2028,30,10,1,10,Friendships,2,2028,23,2021-04-27 19:05:04,2021-04-27 19:11:36.399721
1135,20146,4,20146,17,2029,17,6,0,6,Life - School Balance,2,2029,26,2021-04-27 19:05:04,2021-04-27 19:17:13.996489
1136,20147,6,20147,20,2029,20,7,1,7,Discrimination,2,2029,26,2021-04-27 19:05:04,2021-04-27 19:17:13.996489
1137,20148,3,20148,25,2029,25,8,0,8,Financial Pressure,2,2029,26,2021-04-27 19:05:04,2021-04-27 19:17:13.996489
1138,20149,6,20149,27,2029,27,9,1,9,Faculty & Staff Support,2,2029,26,2021-04-27 19:05:04,2021-04-27 19:17:13.996489
1139,20150,5,20150,32,2029,32,10,1,10,Friendships,2,2029,26,2021-04-27 19:05:04,2021-04-27 19:17:13.996489
1140,20196,5,20196,17,2039,17,6,0,6,Life - School Balance,2,2039,41,2021-04-27 19:05:06,2021-04-27 19:05:59.263628
1141,20197,4,20197,21,2039,21,7,1,7,Discrimination,2,2039,41,2021-04-27 19:05:06,2021-04-27 19:05:59.263628
1142,20198,4,20198,22,2039,22,8,1,8,Financial Pressure,2,2039,41,2021-04-27 19:05:06,2021-04-27 19:05:59.263628
1143,20199,5,20199,28,2039,28,9,1,9,Faculty & Staff Support,2,2039,41,2021-04-27 19:05:06,2021-04-27 19:05:59.263628
1144,20200,5,20200,32,2039,32,10,1,10,Friendships,2,2039,41,2021-04-27 19:05:06,2021-04-27 19:05:59.263628
1145,20211,5,20211,17,2042,17,6,0,6,Life - School Balance,2,2042,45,2021-04-27 19:05:06,2021-04-27 19:17:02.408876
1146,20212,6,20212,20,2042,20,7,1,7,Discrimination,2,2042,45,2021-04-27 19:05:06,2021-04-27 19:17:02.408876
1147,20213,2,20213,25,2042,25,8,0,8,Financial Pressure,2,2042,45,2021-04-27 19:05:06,2021-04-27 19:17:02.408876
1148,20214,5,20214,27,2042,27,9,1,9,Faculty & Staff Support,2,2042,45,2021-04-27 19:05:06,2021-04-27 19:17:02.408876
1149,20215,4,20215,32,2042,32,10,1,10,Friendships,2,2042,45,2021-04-27 19:05:06,2021-04-27 19:17:02.408876
1150,20216,3,20216,17,2043,17,6,0,6,Life - School Balance,2,2043,46,2021-04-27 19:05:07,2021-04-27 20:09:52.751319
1151,20217,6,20217,19,2043,19,7,0,7,Discrimination,2,2043,46,2021-04-27 19:05:07,2021-04-27 20:09:52.751319
1152,20218,5,20218,24,2043,24,8,1,8,Financial Pressure,2,2043,46,2021-04-27 19:05:07,2021-04-27 20:09:52.751319
1153,20219,4,20219,28,2043,28,9,1,9,Faculty & Staff Support,2,2043,46,2021-04-27 19:05:07,2021-04-27 20:09:52.751319
1154,20220,6,20220,31,2043,31,10,1,10,Friendships,2,2043,46,2021-04-27 19:05:07,2021-04-27 20:09:52.751319
1155,20241,2,20241,17,2048,17,6,0,6,Life - School Balance,2,2048,52,2021-04-27 19:05:07,2021-04-27 19:06:02.422430
1156,20242,2,20242,19,2048,19,7,0,7,Discrimination,2,2048,52,2021-04-27 19:05:07,2021-04-27 19:06:02.422430
1157,20243,6,20243,22,2048,22,8,1,8,Financial Pressure,2,2048,52,2021-04-27 19:05:07,2021-04-27 19:06:02.422430
1158,20244,6,20244,28,2048,28,9,1,9,Faculty & Staff Support,2,2048,52,2021-04-27 19:05:07,2021-04-27 19:06:02.422430
1159,20245,5,20245,31,2048,31,10,1,10,Friendships,2,2048,52,2021-04-27 19:05:07,2021-04-27 19:06:02.422430
1160,20281,2,20281,17,2056,17,6,0,6,Life - School Balance,2,2056,64,2021-04-27 19:05:09,2021-04-27 19:40:51.546328
1161,20282,4,20282,19,2056,19,7,0,7,Discrimination,2,2056,64,2021-04-27 19:05:09,2021-04-27 19:40:51.546328
1162,20283,4,20283,23,2056,23,8,1,8,Financial Pressure,2,2056,64,2021-04-27 19:05:09,2021-04-27 19:40:51.546328
1163,20284,3,20284,27,2056,27,9,1,9,Faculty & Staff Support,2,2056,64,2021-04-27 19:05:09,2021-04-27 19:40:51.546328
1164,20285,6,20285,31,2056,31,10,1,10,Friendships,2,2056,64,2021-04-27 19:05:09,2021-04-27 19:40:51.546328
1165,20401,1,20401,17,2080,17,6,0,6,Life - School Balance,2,2080,93,2021-04-27 19:05:12,2021-04-27 19:06:53.630140
1166,20402,6,20402,21,2080,21,7,1,7,Discrimination,2,2080,93,2021-04-27 19:05:12,2021-04-27 19:06:53.630140
1167,20403,3,20403,25,2080,25,8,0,8,Financial Pressure,2,2080,93,2021-04-27 19:05:12,2021-04-27 19:06:53.630140
1168,20404,4,20404,26,2080,26,9,1,9,Faculty & Staff Support,2,2080,93,2021-04-27 19:05:12,2021-04-27 19:06:53.630140
1169,20405,6,20405,31,2080,31,10,1,10,Friendships,2,2080,93,2021-04-27 19:05:12,2021-04-27 19:06:53.630140
1170,20406,6,20406,17,2081,17,6,0,6,Life - School Balance,2,2081,94,2021-04-27 19:05:13,2021-04-27 19:06:29.090512
1171,20407,6,20407,21,2081,21,7,1,7,Discrimination,2,2081,94,2021-04-27 19:05:13,2021-04-27 19:06:29.090512
1172,20408,4,20408,25,2081,25,8,0,8,Financial Pressure,2,2081,94,2021-04-27 19:05:13,2021-04-27 19:06:29.090512
1173,20409,6,20409,28,2081,28,9,1,9,Faculty & Staff Support,2,2081,94,2021-04-27 19:05:13,2021-04-27 19:06:29.090512
1174,20410,6,20410,32,2081,32,10,1,10,Friendships,2,2081,94,2021-04-27 19:05:13,2021-04-27 19:06:29.090512
1175,20451,3,20451,17,2090,17,6,0,6,Life - School Balance,2,2090,105,2021-04-27 19:05:14,2021-04-27 19:13:09.183072
1176,20452,3,20452,19,2090,19,7,0,7,Discrimination,2,2090,105,2021-04-27 19:05:14,2021-04-27 19:13:09.183072
1177,20453,6,20453,22,2090,22,8,1,8,Financial Pressure,2,2090,105,2021-04-27 19:05:14,2021-04-27 19:13:09.183072
1178,20454,4,20454,27,2090,27,9,1,9,Faculty & Staff Support,2,2090,105,2021-04-27 19:05:14,2021-04-27 19:13:09.183072
1179,20455,3,20455,30,2090,30,10,1,10,Friendships,2,2090,105,2021-04-27 19:05:14,2021-04-27 19:13:09.183072
1180,20515,3,20515,17,2101,17,6,0,6,Life - School Balance,2,2101,5,2021-04-29 15:03:21,2021-04-29 15:18:26.798961
1181,20516,5,20516,20,2101,20,7,1,7,Discrimination,2,2101,5,2021-04-29 15:03:21,2021-04-29 15:18:26.798961
1182,20517,4,20517,23,2101,23,8,1,8,Financial Pressure,2,2101,5,2021-04-29 15:03:21,2021-04-29 15:18:26.798961
1183,20518,5,20518,28,2101,28,9,1,9,Faculty & Staff Support,2,2101,5,2021-04-29 15:03:21,2021-04-29 15:18:26.798961
1184,20519,4,20519,30,2101,30,10,1,10,Friendships,2,2101,5,2021-04-29 15:03:21,2021-04-29 15:18:26.798961
1185,20525,3,20525,17,2103,17,6,0,6,Life - School Balance,2,2103,9,2021-04-29 15:03:22,2021-04-29 15:04:03.307417
1186,20526,5,20526,19,2103,19,7,0,7,Discrimination,2,2103,9,2021-04-29 15:03:22,2021-04-29 15:04:03.307417
1187,20527,4,20527,25,2103,25,8,0,8,Financial Pressure,2,2103,9,2021-04-29 15:03:22,2021-04-29 15:04:03.307417
1188,20528,6,20528,29,2103,29,9,0,9,Faculty & Staff Support,2,2103,9,2021-04-29 15:03:22,2021-04-29 15:04:03.307417
1189,20529,6,20529,30,2103,30,10,1,10,Friendships,2,2103,9,2021-04-29 15:03:22,2021-04-29 15:04:03.307417
1190,20565,3,20565,17,2111,17,6,0,6,Life - School Balance,2,2111,20,2021-04-29 15:03:23,2021-04-29 16:53:43.492638
1191,20566,4,20566,21,2111,21,7,1,7,Discrimination,2,2111,20,2021-04-29 15:03:23,2021-04-29 16:53:43.492638
1192,20567,5,20567,25,2111,25,8,0,8,Financial Pressure,2,2111,20,2021-04-29 15:03:23,2021-04-29 16:53:43.492638
1193,20568,4,20568,28,2111,28,9,1,9,Faculty & Staff Support,2,2111,20,2021-04-29 15:03:23,2021-04-29 16:53:43.492638
1194,20569,4,20569,31,2111,31,10,1,10,Friendships,2,2111,20,2021-04-29 15:03:23,2021-04-29 16:53:43.492638
1195,20570,3,20570,17,2112,17,6,0,6,Life - School Balance,2,2112,22,2021-04-29 15:03:23,2021-04-29 17:24:26.813003
1196,20571,6,20571,19,2112,19,7,0,7,Discrimination,2,2112,22,2021-04-29 15:03:23,2021-04-29 17:24:26.813003
1197,20572,5,20572,22,2112,22,8,1,8,Financial Pressure,2,2112,22,2021-04-29 15:03:23,2021-04-29 17:24:26.813003
1198,20573,5,20573,26,2112,26,9,1,9,Faculty & Staff Support,2,2112,22,2021-04-29 15:03:23,2021-04-29 17:24:26.813003
1199,20574,4,20574,33,2112,33,10,0,10,Friendships,2,2112,22,2021-04-29 15:03:23,2021-04-29 17:24:26.813003
1200,20580,4,20580,17,2114,17,6,0,6,Life - School Balance,2,2114,26,2021-04-29 15:03:24,2021-04-29 15:43:39.765152
1201,20581,6,20581,20,2114,20,7,1,7,Discrimination,2,2114,26,2021-04-29 15:03:24,2021-04-29 15:43:39.765152
1202,20582,4,20582,22,2114,22,8,1,8,Financial Pressure,2,2114,26,2021-04-29 15:03:24,2021-04-29 15:43:39.765152
1203,20583,5,20583,28,2114,28,9,1,9,Faculty & Staff Support,2,2114,26,2021-04-29 15:03:24,2021-04-29 15:43:39.765152
1204,20584,5,20584,33,2114,33,10,0,10,Friendships,2,2114,26,2021-04-29 15:03:24,2021-04-29 15:43:39.765152
1205,20585,4,20585,17,2115,17,6,0,6,Life - School Balance,2,2115,27,2021-04-29 15:03:24,2021-04-29 19:15:27.873530
1206,20586,5,20586,21,2115,21,7,1,7,Discrimination,2,2115,27,2021-04-29 15:03:24,2021-04-29 19:15:27.873530
1207,20587,3,20587,25,2115,25,8,0,8,Financial Pressure,2,2115,27,2021-04-29 15:03:24,2021-04-29 19:15:27.873530
1208,20588,5,20588,26,2115,26,9,1,9,Faculty & Staff Support,2,2115,27,2021-04-29 15:03:24,2021-04-29 19:15:27.873530
1209,20589,5,20589,30,2115,30,10,1,10,Friendships,2,2115,27,2021-04-29 15:03:24,2021-04-29 19:15:27.873530
1210,20595,1,20595,17,2117,17,6,0,6,Life - School Balance,2,2117,30,2021-04-29 15:03:24,2021-04-29 15:04:32.334945
1211,20596,5,20596,20,2117,20,7,1,7,Discrimination,2,2117,30,2021-04-29 15:03:24,2021-04-29 15:04:32.334945
1212,20597,2,20597,24,2117,24,8,1,8,Financial Pressure,2,2117,30,2021-04-29 15:03:24,2021-04-29 15:04:32.334945
1213,20598,6,20598,29,2117,29,9,0,9,Faculty & Staff Support,2,2117,30,2021-04-29 15:03:24,2021-04-29 15:04:32.334945
1214,20599,1,20599,30,2117,30,10,1,10,Friendships,2,2117,30,2021-04-29 15:03:24,2021-04-29 15:04:32.334945
1215,20600,2,20600,17,2118,17,6,0,6,Life - School Balance,2,2118,31,2021-04-29 15:03:24,2021-04-29 15:08:12.742676
1216,20601,6,20601,19,2118,19,7,0,7,Discrimination,2,2118,31,2021-04-29 15:03:24,2021-04-29 15:08:12.742676
1217,20602,6,20602,22,2118,22,8,1,8,Financial Pressure,2,2118,31,2021-04-29 15:03:24,2021-04-29 15:08:12.742676
1218,20603,3,20603,27,2118,27,9,1,9,Faculty & Staff Support,2,2118,31,2021-04-29 15:03:24,2021-04-29 15:08:12.742676
1219,20604,3,20604,33,2118,33,10,0,10,Friendships,2,2118,31,2021-04-29 15:03:24,2021-04-29 15:08:12.742676
1220,20620,3,20620,17,2122,17,6,0,6,Life - School Balance,2,2122,36,2021-04-29 15:03:25,2021-04-29 15:26:43.549094
1221,20621,3,20621,19,2122,19,7,0,7,Discrimination,2,2122,36,2021-04-29 15:03:25,2021-04-29 15:26:43.549094
1222,20622,5,20622,23,2122,23,8,1,8,Financial Pressure,2,2122,36,2021-04-29 15:03:25,2021-04-29 15:26:43.549094
1223,20623,4,20623,26,2122,26,9,1,9,Faculty & Staff Support,2,2122,36,2021-04-29 15:03:25,2021-04-29 15:26:43.549094
1224,20624,4,20624,30,2122,30,10,1,10,Friendships,2,2122,36,2021-04-29 15:03:25,2021-04-29 15:26:43.549094
1225,20665,3,20665,17,2131,17,6,0,6,Life - School Balance,2,2131,49,2021-04-29 15:03:27,2021-04-30 03:35:28.478216
1226,20666,4,20666,20,2131,20,7,1,7,Discrimination,2,2131,49,2021-04-29 15:03:27,2021-04-30 03:35:28.478216
1227,20667,4,20667,22,2131,22,8,1,8,Financial Pressure,2,2131,49,2021-04-29 15:03:27,2021-04-30 03:35:28.478216
1228,20668,4,20668,28,2131,28,9,1,9,Faculty & Staff Support,2,2131,49,2021-04-29 15:03:27,2021-04-30 03:35:28.478216
1229,20669,4,20669,32,2131,32,10,1,10,Friendships,2,2131,49,2021-04-29 15:03:27,2021-04-30 03:35:28.478216
1230,20680,5,20680,17,2134,17,6,0,6,Life - School Balance,2,2134,54,2021-04-29 15:03:27,2021-04-29 15:19:59.084211
1231,20681,5,20681,20,2134,20,7,1,7,Discrimination,2,2134,54,2021-04-29 15:03:27,2021-04-29 15:19:59.084211
1232,20682,3,20682,23,2134,23,8,1,8,Financial Pressure,2,2134,54,2021-04-29 15:03:27,2021-04-29 15:19:59.084211
1233,20683,6,20683,26,2134,26,9,1,9,Faculty & Staff Support,2,2134,54,2021-04-29 15:03:27,2021-04-29 15:19:59.084211
1234,20684,5,20684,31,2134,31,10,1,10,Friendships,2,2134,54,2021-04-29 15:03:27,2021-04-29 15:19:59.084211
1235,20700,3,20700,17,2138,17,6,0,6,Life - School Balance,2,2138,60,2021-04-29 15:03:28,2021-04-29 18:23:31.948888
1236,20701,3,20701,21,2138,21,7,1,7,Discrimination,2,2138,60,2021-04-29 15:03:28,2021-04-29 18:23:31.948888
1237,20702,6,20702,23,2138,23,8,1,8,Financial Pressure,2,2138,60,2021-04-29 15:03:28,2021-04-29 18:23:31.948888
1238,20703,5,20703,28,2138,28,9,1,9,Faculty & Staff Support,2,2138,60,2021-04-29 15:03:28,2021-04-29 18:23:31.948888
1239,20704,6,20704,31,2138,31,10,1,10,Friendships,2,2138,60,2021-04-29 15:03:28,2021-04-29 18:23:31.948888
1240,20735,2,20735,17,2145,17,6,0,6,Life - School Balance,2,2145,68,2021-04-29 15:03:29,2021-04-29 15:35:45.916487
1241,20736,3,20736,19,2145,19,7,0,7,Discrimination,2,2145,68,2021-04-29 15:03:29,2021-04-29 15:35:45.916487
1242,20737,5,20737,25,2145,25,8,0,8,Financial Pressure,2,2145,68,2021-04-29 15:03:29,2021-04-29 15:35:45.916487
1243,20738,2,20738,28,2145,28,9,1,9,Faculty & Staff Support,2,2145,68,2021-04-29 15:03:29,2021-04-29 15:35:45.916487
1244,20739,4,20739,32,2145,32,10,1,10,Friendships,2,2145,68,2021-04-29 15:03:29,2021-04-29 15:35:45.916487
1245,20775,4,20775,17,2153,17,6,0,6,Life - School Balance,2,2153,76,2021-04-29 15:03:30,2021-04-29 15:06:34.874136
1246,20776,4,20776,20,2153,20,7,1,7,Discrimination,2,2153,76,2021-04-29 15:03:30,2021-04-29 15:06:34.874136
1247,20777,2,20777,22,2153,22,8,1,8,Financial Pressure,2,2153,76,2021-04-29 15:03:30,2021-04-29 15:06:34.874136
1248,20778,4,20778,26,2153,26,9,1,9,Faculty & Staff Support,2,2153,76,2021-04-29 15:03:30,2021-04-29 15:06:34.874136
1249,20779,4,20779,31,2153,31,10,1,10,Friendships,2,2153,76,2021-04-29 15:03:30,2021-04-29 15:06:34.874136
1250,20840,6,20840,17,2166,17,6,0,6,Life - School Balance,2,2166,94,2021-04-29 15:03:33,2021-04-29 15:05:59.883378
1251,20841,6,20841,19,2166,19,7,0,7,Discrimination,2,2166,94,2021-04-29 15:03:33,2021-04-29 15:05:59.883378
1252,20842,3,20842,22,2166,22,8,1,8,Financial Pressure,2,2166,94,2021-04-29 15:03:33,2021-04-29 15:05:59.883378
1253,20843,6,20843,28,2166,28,9,1,9,Faculty & Staff Support,2,2166,94,2021-04-29 15:03:33,2021-04-29 15:05:59.883378
1254,20844,6,20844,33,2166,33,10,0,10,Friendships,2,2166,94,2021-04-29 15:03:33,2021-04-29 15:05:59.883378
1255,20850,3,20850,17,2168,17,6,0,6,Life - School Balance,2,2168,96,2021-04-29 15:03:33,2021-04-29 16:02:43.458752
1256,20851,6,20851,21,2168,21,7,1,7,Discrimination,2,2168,96,2021-04-29 15:03:33,2021-04-29 16:02:43.458752
1257,20852,6,20852,24,2168,24,8,1,8,Financial Pressure,2,2168,96,2021-04-29 15:03:33,2021-04-29 16:02:43.458752
1258,20853,5,20853,29,2168,29,9,0,9,Faculty & Staff Support,2,2168,96,2021-04-29 15:03:33,2021-04-29 16:02:43.458752
1259,20854,5,20854,30,2168,30,10,1,10,Friendships,2,2168,96,2021-04-29 15:03:33,2021-04-29 16:02:43.458752
1260,21105,4,21105,17,2219,17,6,0,6,Life - School Balance,2,2219,18,2021-05-04 19:05:02,2021-05-04 19:56:37.018897
1261,21106,4,21106,20,2219,20,7,1,7,Discrimination,2,2219,18,2021-05-04 19:05:02,2021-05-04 19:56:37.018897
1262,21107,6,21107,24,2219,24,8,1,8,Financial Pressure,2,2219,18,2021-05-04 19:05:02,2021-05-04 19:56:37.018897
1263,21108,5,21108,29,2219,29,9,0,9,Faculty & Staff Support,2,2219,18,2021-05-04 19:05:02,2021-05-04 19:56:37.018897
1264,21109,6,21109,31,2219,31,10,1,10,Friendships,2,2219,18,2021-05-04 19:05:02,2021-05-04 19:56:37.018897
1265,21110,4,21110,17,2220,17,6,0,6,Life - School Balance,2,2220,19,2021-05-04 19:05:03,2021-05-04 21:01:18.107101
1266,21111,5,21111,19,2220,19,7,0,7,Discrimination,2,2220,19,2021-05-04 19:05:03,2021-05-04 21:01:18.107101
1267,21112,3,21112,25,2220,25,8,0,8,Financial Pressure,2,2220,19,2021-05-04 19:05:03,2021-05-04 21:01:18.107101
1268,21113,5,21113,29,2220,29,9,0,9,Faculty & Staff Support,2,2220,19,2021-05-04 19:05:03,2021-05-04 21:01:18.107101
1269,21114,5,21114,31,2220,31,10,1,10,Friendships,2,2220,19,2021-05-04 19:05:03,2021-05-04 21:01:18.107101
1270,21115,3,21115,17,2221,17,6,0,6,Life - School Balance,2,2221,20,2021-05-04 19:05:03,2021-05-04 19:50:38.825989
1271,21116,3,21116,19,2221,19,7,0,7,Discrimination,2,2221,20,2021-05-04 19:05:03,2021-05-04 19:50:38.825989
1272,21117,5,21117,23,2221,23,8,1,8,Financial Pressure,2,2221,20,2021-05-04 19:05:03,2021-05-04 19:50:38.825989
1273,21118,4,21118,27,2221,27,9,1,9,Faculty & Staff Support,2,2221,20,2021-05-04 19:05:03,2021-05-04 19:50:38.825989
1274,21119,4,21119,31,2221,31,10,1,10,Friendships,2,2221,20,2021-05-04 19:05:03,2021-05-04 19:50:38.825989
1275,21125,3,21125,17,2223,17,6,0,6,Life - School Balance,2,2223,23,2021-05-04 19:05:03,2021-05-05 00:32:49.251428
1276,21126,4,21126,20,2223,20,7,1,7,Discrimination,2,2223,23,2021-05-04 19:05:03,2021-05-05 00:32:49.251428
1277,21127,6,21127,22,2223,22,8,1,8,Financial Pressure,2,2223,23,2021-05-04 19:05:03,2021-05-05 00:32:49.251428
1278,21128,5,21128,29,2223,29,9,0,9,Faculty & Staff Support,2,2223,23,2021-05-04 19:05:03,2021-05-05 00:32:49.251428
1279,21129,4,21129,32,2223,32,10,1,10,Friendships,2,2223,23,2021-05-04 19:05:03,2021-05-05 00:32:49.251428
1280,21135,3,21135,17,2225,17,6,0,6,Life - School Balance,2,2225,27,2021-05-04 19:05:03,2021-05-04 20:36:26.356692
1281,21136,4,21136,19,2225,19,7,0,7,Discrimination,2,2225,27,2021-05-04 19:05:03,2021-05-04 20:36:26.356692
1282,21137,3,21137,25,2225,25,8,0,8,Financial Pressure,2,2225,27,2021-05-04 19:05:03,2021-05-04 20:36:26.356692
1283,21138,5,21138,26,2225,26,9,1,9,Faculty & Staff Support,2,2225,27,2021-05-04 19:05:03,2021-05-04 20:36:26.356692
1284,21139,6,21139,31,2225,31,10,1,10,Friendships,2,2225,27,2021-05-04 19:05:03,2021-05-04 20:36:26.356692
1285,21145,1,21145,17,2227,17,6,0,6,Life - School Balance,2,2227,30,2021-05-04 19:05:04,2021-05-04 19:06:06.968308
1286,21146,6,21146,19,2227,19,7,0,7,Discrimination,2,2227,30,2021-05-04 19:05:04,2021-05-04 19:06:06.968308
1287,21147,4,21147,23,2227,23,8,1,8,Financial Pressure,2,2227,30,2021-05-04 19:05:04,2021-05-04 19:06:06.968308
1288,21148,6,21148,29,2227,29,9,0,9,Faculty & Staff Support,2,2227,30,2021-05-04 19:05:04,2021-05-04 19:06:06.968308
1289,21149,5,21149,31,2227,31,10,1,10,Friendships,2,2227,30,2021-05-04 19:05:04,2021-05-04 19:06:06.968308
1290,21205,5,21205,17,2239,17,6,0,6,Life - School Balance,2,2239,47,2021-05-04 19:05:06,2021-05-04 19:12:36.578772
1291,21206,5,21206,20,2239,20,7,1,7,Discrimination,2,2239,47,2021-05-04 19:05:06,2021-05-04 19:12:36.578772
1292,21207,3,21207,25,2239,25,8,0,8,Financial Pressure,2,2239,47,2021-05-04 19:05:06,2021-05-04 19:12:36.578772
1293,21208,6,21208,26,2239,26,9,1,9,Faculty & Staff Support,2,2239,47,2021-05-04 19:05:06,2021-05-04 19:12:36.578772
1294,21209,5,21209,32,2239,32,10,1,10,Friendships,2,2239,47,2021-05-04 19:05:06,2021-05-04 19:12:36.578772
1295,21215,3,21215,17,2241,17,6,0,6,Life - School Balance,2,2241,49,2021-05-04 19:05:06,2021-05-04 22:48:11.382532
1296,21216,4,21216,21,2241,21,7,1,7,Discrimination,2,2241,49,2021-05-04 19:05:06,2021-05-04 22:48:11.382532
1297,21217,4,21217,22,2241,22,8,1,8,Financial Pressure,2,2241,49,2021-05-04 19:05:06,2021-05-04 22:48:11.382532
1298,21218,4,21218,27,2241,27,9,1,9,Faculty & Staff Support,2,2241,49,2021-05-04 19:05:06,2021-05-04 22:48:11.382532
1299,21219,4,21219,32,2241,32,10,1,10,Friendships,2,2241,49,2021-05-04 19:05:06,2021-05-04 22:48:11.382532
1300,21235,4,21235,17,2245,17,6,0,6,Life - School Balance,2,2245,55,2021-05-04 19:05:07,2021-05-04 19:06:23.258578
1301,21236,5,21236,19,2245,19,7,0,7,Discrimination,2,2245,55,2021-05-04 19:05:07,2021-05-04 19:06:23.258578
1302,21237,3,21237,23,2245,23,8,1,8,Financial Pressure,2,2245,55,2021-05-04 19:05:07,2021-05-04 19:06:23.258578
1303,21238,4,21238,27,2245,27,9,1,9,Faculty & Staff Support,2,2245,55,2021-05-04 19:05:07,2021-05-04 19:06:23.258578
1304,21239,4,21239,30,2245,30,10,1,10,Friendships,2,2245,55,2021-05-04 19:05:07,2021-05-04 19:06:23.258578
1305,21245,3,21245,17,2247,17,6,0,6,Life - School Balance,2,2247,58,2021-05-04 19:05:07,2021-05-04 19:06:44.100544
1306,21246,4,21246,19,2247,19,7,0,7,Discrimination,2,2247,58,2021-05-04 19:05:07,2021-05-04 19:06:44.100544
1307,21247,2,21247,22,2247,22,8,1,8,Financial Pressure,2,2247,58,2021-05-04 19:05:07,2021-05-04 19:06:44.100544
1308,21248,6,21248,26,2247,26,9,1,9,Faculty & Staff Support,2,2247,58,2021-05-04 19:05:07,2021-05-04 19:06:44.100544
1309,21249,5,21249,30,2247,30,10,1,10,Friendships,2,2247,58,2021-05-04 19:05:07,2021-05-04 19:06:44.100544
1310,21280,4,21280,17,2254,17,6,0,6,Life - School Balance,2,2254,67,2021-05-04 19:05:08,2021-05-04 20:01:30.212511
1311,21281,3,21281,19,2254,19,7,0,7,Discrimination,2,2254,67,2021-05-04 19:05:08,2021-05-04 20:01:30.212511
1312,21282,5,21282,22,2254,22,8,1,8,Financial Pressure,2,2254,67,2021-05-04 19:05:08,2021-05-04 20:01:30.212511
1313,21283,5,21283,28,2254,28,9,1,9,Faculty & Staff Support,2,2254,67,2021-05-04 19:05:08,2021-05-04 20:01:30.212511
1314,21284,4,21284,31,2254,31,10,1,10,Friendships,2,2254,67,2021-05-04 19:05:08,2021-05-04 20:01:30.212511
1315,21285,4,21285,17,2255,17,6,0,6,Life - School Balance,2,2255,68,2021-05-04 19:05:08,2021-05-04 19:06:49.462153
1316,21286,4,21286,21,2255,21,7,1,7,Discrimination,2,2255,68,2021-05-04 19:05:08,2021-05-04 19:06:49.462153
1317,21287,3,21287,23,2255,23,8,1,8,Financial Pressure,2,2255,68,2021-05-04 19:05:08,2021-05-04 19:06:49.462153
1318,21288,5,21288,27,2255,27,9,1,9,Faculty & Staff Support,2,2255,68,2021-05-04 19:05:08,2021-05-04 19:06:49.462153
1319,21289,4,21289,31,2255,31,10,1,10,Friendships,2,2255,68,2021-05-04 19:05:08,2021-05-04 19:06:49.462153
1320,21295,3,21295,17,2257,17,6,0,6,Life - School Balance,2,2257,70,2021-05-04 19:05:08,2021-05-04 19:28:30.720590
1321,21296,4,21296,21,2257,21,7,1,7,Discrimination,2,2257,70,2021-05-04 19:05:08,2021-05-04 19:28:30.720590
1322,21297,3,21297,23,2257,23,8,1,8,Financial Pressure,2,2257,70,2021-05-04 19:05:08,2021-05-04 19:28:30.720590
1323,21298,4,21298,29,2257,29,9,0,9,Faculty & Staff Support,2,2257,70,2021-05-04 19:05:08,2021-05-04 19:28:30.720590
1324,21299,4,21299,33,2257,33,10,0,10,Friendships,2,2257,70,2021-05-04 19:05:08,2021-05-04 19:28:30.720590
1325,21310,6,21310,17,2260,17,6,0,6,Life - School Balance,2,2260,73,2021-05-04 19:05:09,2021-05-04 20:15:15.977019
1326,21311,6,21311,20,2260,20,7,1,7,Discrimination,2,2260,73,2021-05-04 19:05:09,2021-05-04 20:15:15.977019
1327,21312,6,21312,25,2260,25,8,0,8,Financial Pressure,2,2260,73,2021-05-04 19:05:09,2021-05-04 20:15:15.977019
1328,21313,6,21313,28,2260,28,9,1,9,Faculty & Staff Support,2,2260,73,2021-05-04 19:05:09,2021-05-04 20:15:15.977019
1329,21314,6,21314,32,2260,32,10,1,10,Friendships,2,2260,73,2021-05-04 19:05:09,2021-05-04 20:15:15.977019
1330,21325,3,21325,17,2263,17,6,0,6,Life - School Balance,2,2263,76,2021-05-04 19:05:09,2021-05-04 20:03:14.804112
1331,21326,5,21326,19,2263,19,7,0,7,Discrimination,2,2263,76,2021-05-04 19:05:09,2021-05-04 20:03:14.804112
1332,21327,2,21327,22,2263,22,8,1,8,Financial Pressure,2,2263,76,2021-05-04 19:05:09,2021-05-04 20:03:14.804112
1333,21328,5,21328,26,2263,26,9,1,9,Faculty & Staff Support,2,2263,76,2021-05-04 19:05:09,2021-05-04 20:03:14.804112
1334,21329,6,21329,33,2263,33,10,0,10,Friendships,2,2263,76,2021-05-04 19:05:09,2021-05-04 20:03:14.804112
1335,21330,5,21330,17,2264,17,6,0,6,Life - School Balance,2,2264,77,2021-05-04 19:05:10,2021-05-04 19:10:44.360982
1336,21331,5,21331,21,2264,21,7,1,7,Discrimination,2,2264,77,2021-05-04 19:05:10,2021-05-04 19:10:44.360982
1337,21332,5,21332,24,2264,24,8,1,8,Financial Pressure,2,2264,77,2021-05-04 19:05:10,2021-05-04 19:10:44.360982
1338,21333,4,21333,26,2264,26,9,1,9,Faculty & Staff Support,2,2264,77,2021-05-04 19:05:10,2021-05-04 19:10:44.360982
1339,21334,4,21334,30,2264,30,10,1,10,Friendships,2,2264,77,2021-05-04 19:05:10,2021-05-04 19:10:44.360982
1340,21350,5,21350,17,2268,17,6,0,6,Life - School Balance,2,2268,85,2021-05-04 19:05:10,2021-05-04 20:55:38.964585
1341,21351,6,21351,21,2268,21,7,1,7,Discrimination,2,2268,85,2021-05-04 19:05:10,2021-05-04 20:55:38.964585
1342,21352,3,21352,22,2268,22,8,1,8,Financial Pressure,2,2268,85,2021-05-04 19:05:10,2021-05-04 20:55:38.964585
1343,21353,4,21353,28,2268,28,9,1,9,Faculty & Staff Support,2,2268,85,2021-05-04 19:05:10,2021-05-04 20:55:38.964585
1344,21354,5,21354,30,2268,30,10,1,10,Friendships,2,2268,85,2021-05-04 19:05:10,2021-05-04 20:55:38.964585
1345,21375,3,21375,17,2273,17,6,0,6,Life - School Balance,2,2273,90,2021-05-04 19:05:11,2021-05-04 19:24:41.601731
1346,21376,4,21376,19,2273,19,7,0,7,Discrimination,2,2273,90,2021-05-04 19:05:11,2021-05-04 19:24:41.601731
1347,21377,4,21377,25,2273,25,8,0,8,Financial Pressure,2,2273,90,2021-05-04 19:05:11,2021-05-04 19:24:41.601731
1348,21378,5,21378,28,2273,28,9,1,9,Faculty & Staff Support,2,2273,90,2021-05-04 19:05:11,2021-05-04 19:24:41.601731
1349,21379,6,21379,30,2273,30,10,1,10,Friendships,2,2273,90,2021-05-04 19:05:11,2021-05-04 19:24:41.601731
1350,21390,6,21390,17,2276,17,6,0,6,Life - School Balance,2,2276,94,2021-05-04 19:05:11,2021-05-04 20:10:36.485802
1351,21391,6,21391,21,2276,21,7,1,7,Discrimination,2,2276,94,2021-05-04 19:05:11,2021-05-04 20:10:36.485802
1352,21392,2,21392,25,2276,25,8,0,8,Financial Pressure,2,2276,94,2021-05-04 19:05:11,2021-05-04 20:10:36.485802
1353,21393,6,21393,27,2276,27,9,1,9,Faculty & Staff Support,2,2276,94,2021-05-04 19:05:11,2021-05-04 20:10:36.485802
1354,21394,6,21394,33,2276,33,10,0,10,Friendships,2,2276,94,2021-05-04 19:05:11,2021-05-04 20:10:36.485802
1355,21395,3,21395,17,2277,17,6,0,6,Life - School Balance,2,2277,95,2021-05-04 19:05:11,2021-05-04 19:06:25.072706
1356,21396,6,21396,19,2277,19,7,0,7,Discrimination,2,2277,95,2021-05-04 19:05:11,2021-05-04 19:06:25.072706
1357,21397,4,21397,23,2277,23,8,1,8,Financial Pressure,2,2277,95,2021-05-04 19:05:11,2021-05-04 19:06:25.072706
1358,21398,6,21398,26,2277,26,9,1,9,Faculty & Staff Support,2,2277,95,2021-05-04 19:05:11,2021-05-04 19:06:25.072706
1359,21399,6,21399,31,2277,31,10,1,10,Friendships,2,2277,95,2021-05-04 19:05:11,2021-05-04 19:06:25.072706
1360,21519,4,21519,17,2300,17,6,0,6,Life - School Balance,2,2300,5,2021-05-06 14:05:02,2021-05-06 14:20:16.250811
1361,21520,5,21520,19,2300,19,7,0,7,Discrimination,2,2300,5,2021-05-06 14:05:02,2021-05-06 14:20:16.250811
1362,21521,4,21521,24,2300,24,8,1,8,Financial Pressure,2,2300,5,2021-05-06 14:05:02,2021-05-06 14:20:16.250811
1363,21522,4,21522,27,2300,27,9,1,9,Faculty & Staff Support,2,2300,5,2021-05-06 14:05:02,2021-05-06 14:20:16.250811
1364,21523,5,21523,31,2300,31,10,1,10,Friendships,2,2300,5,2021-05-06 14:05:02,2021-05-06 14:20:16.250811
1365,21524,4,21524,17,2301,17,6,0,6,Life - School Balance,2,2301,6,2021-05-06 14:05:02,2021-05-06 14:38:08.602881
1366,21525,5,21525,19,2301,19,7,0,7,Discrimination,2,2301,6,2021-05-06 14:05:02,2021-05-06 14:38:08.602881
1367,21526,4,21526,23,2301,23,8,1,8,Financial Pressure,2,2301,6,2021-05-06 14:05:02,2021-05-06 14:38:08.602881
1368,21527,5,21527,29,2301,29,9,0,9,Faculty & Staff Support,2,2301,6,2021-05-06 14:05:02,2021-05-06 14:38:08.602881
1369,21528,4,21528,31,2301,31,10,1,10,Friendships,2,2301,6,2021-05-06 14:05:02,2021-05-06 14:38:08.602881
1370,21539,3,21539,17,2304,17,6,0,6,Life - School Balance,2,2304,13,2021-05-06 14:05:03,2021-05-06 19:47:27.549587
1371,21540,4,21540,19,2304,19,7,0,7,Discrimination,2,2304,13,2021-05-06 14:05:03,2021-05-06 19:47:27.549587
1372,21541,3,21541,25,2304,25,8,0,8,Financial Pressure,2,2304,13,2021-05-06 14:05:03,2021-05-06 19:47:27.549587
1373,21542,4,21542,29,2304,29,9,0,9,Faculty & Staff Support,2,2304,13,2021-05-06 14:05:03,2021-05-06 19:47:27.549587
1374,21543,5,21543,32,2304,32,10,1,10,Friendships,2,2304,13,2021-05-06 14:05:03,2021-05-06 19:47:27.549587
1375,21579,3,21579,17,2312,17,6,0,6,Life - School Balance,2,2312,23,2021-05-06 14:05:04,2021-05-06 15:06:10.142653
1376,21580,5,21580,19,2312,19,7,0,7,Discrimination,2,2312,23,2021-05-06 14:05:04,2021-05-06 15:06:10.142653
1377,21581,6,21581,24,2312,24,8,1,8,Financial Pressure,2,2312,23,2021-05-06 14:05:04,2021-05-06 15:06:10.142653
1378,21582,5,21582,26,2312,26,9,1,9,Faculty & Staff Support,2,2312,23,2021-05-06 14:05:04,2021-05-06 15:06:10.142653
1379,21583,4,21583,32,2312,32,10,1,10,Friendships,2,2312,23,2021-05-06 14:05:04,2021-05-06 15:06:10.142653
1380,21604,5,21604,17,2317,17,6,0,6,Life - School Balance,2,2317,31,2021-05-06 14:05:05,2021-05-06 14:05:48.974764
1381,21605,4,21605,20,2317,20,7,1,7,Discrimination,2,2317,31,2021-05-06 14:05:05,2021-05-06 14:05:48.974764
1382,21606,5,21606,24,2317,24,8,1,8,Financial Pressure,2,2317,31,2021-05-06 14:05:05,2021-05-06 14:05:48.974764
1383,21607,4,21607,29,2317,29,9,0,9,Faculty & Staff Support,2,2317,31,2021-05-06 14:05:05,2021-05-06 14:05:48.974764
1384,21608,4,21608,33,2317,33,10,0,10,Friendships,2,2317,31,2021-05-06 14:05:05,2021-05-06 14:05:48.974764
1385,21634,5,21634,17,2323,17,6,0,6,Life - School Balance,2,2323,41,2021-05-06 14:05:06,2021-05-06 14:11:33.605811
1386,21635,5,21635,20,2323,20,7,1,7,Discrimination,2,2323,41,2021-05-06 14:05:06,2021-05-06 14:11:33.605811
1387,21636,4,21636,25,2323,25,8,0,8,Financial Pressure,2,2323,41,2021-05-06 14:05:06,2021-05-06 14:11:33.605811
1388,21637,6,21637,29,2323,29,9,0,9,Faculty & Staff Support,2,2323,41,2021-05-06 14:05:06,2021-05-06 14:11:33.605811
1389,21638,5,21638,33,2323,33,10,0,10,Friendships,2,2323,41,2021-05-06 14:05:06,2021-05-06 14:11:33.605811
1390,21654,3,21654,17,2327,17,6,0,6,Life - School Balance,2,2327,46,2021-05-06 14:05:06,2021-05-06 23:12:26.083455
1391,21655,6,21655,19,2327,19,7,0,7,Discrimination,2,2327,46,2021-05-06 14:05:06,2021-05-06 23:12:26.083455
1392,21656,5,21656,22,2327,22,8,1,8,Financial Pressure,2,2327,46,2021-05-06 14:05:06,2021-05-06 23:12:26.083455
1393,21657,6,21657,29,2327,29,9,0,9,Faculty & Staff Support,2,2327,46,2021-05-06 14:05:06,2021-05-06 23:12:26.083455
1394,21658,4,21658,32,2327,32,10,1,10,Friendships,2,2327,46,2021-05-06 14:05:06,2021-05-06 23:12:26.083455
1395,21659,5,21659,17,2328,17,6,0,6,Life - School Balance,2,2328,47,2021-05-06 14:05:07,2021-05-06 14:07:37.134339
1396,21660,6,21660,21,2328,21,7,1,7,Discrimination,2,2328,47,2021-05-06 14:05:07,2021-05-06 14:07:37.134339
1397,21661,4,21661,24,2328,24,8,1,8,Financial Pressure,2,2328,47,2021-05-06 14:05:07,2021-05-06 14:07:37.134339
1398,21662,6,21662,26,2328,26,9,1,9,Faculty & Staff Support,2,2328,47,2021-05-06 14:05:07,2021-05-06 14:07:37.134339
1399,21663,5,21663,30,2328,30,10,1,10,Friendships,2,2328,47,2021-05-06 14:05:07,2021-05-06 14:07:37.134339
1400,21694,4,21694,17,2335,17,6,0,6,Life - School Balance,2,2335,57,2021-05-06 14:05:08,2021-05-06 14:06:09.846747
1401,21695,6,21695,19,2335,19,7,0,7,Discrimination,2,2335,57,2021-05-06 14:05:08,2021-05-06 14:06:09.846747
1402,21696,2,21696,24,2335,24,8,1,8,Financial Pressure,2,2335,57,2021-05-06 14:05:08,2021-05-06 14:06:09.846747
1403,21697,5,21697,26,2335,26,9,1,9,Faculty & Staff Support,2,2335,57,2021-05-06 14:05:08,2021-05-06 14:06:09.846747
1404,21698,6,21698,32,2335,32,10,1,10,Friendships,2,2335,57,2021-05-06 14:05:08,2021-05-06 14:06:09.846747
1405,21704,3,21704,17,2337,17,6,0,6,Life - School Balance,2,2337,60,2021-05-06 14:05:08,2021-05-06 14:27:35.253594
1406,21705,4,21705,20,2337,20,7,1,7,Discrimination,2,2337,60,2021-05-06 14:05:08,2021-05-06 14:27:35.253594
1407,21706,6,21706,23,2337,23,8,1,8,Financial Pressure,2,2337,60,2021-05-06 14:05:08,2021-05-06 14:27:35.253594
1408,21707,4,21707,28,2337,28,9,1,9,Faculty & Staff Support,2,2337,60,2021-05-06 14:05:08,2021-05-06 14:27:35.253594
1409,21708,4,21708,32,2337,32,10,1,10,Friendships,2,2337,60,2021-05-06 14:05:08,2021-05-06 14:27:35.253594
1410,21719,3,21719,17,2340,17,6,0,6,Life - School Balance,2,2340,64,2021-05-06 14:05:09,2021-05-06 18:55:11.611662
1411,21720,4,21720,20,2340,20,7,1,7,Discrimination,2,2340,64,2021-05-06 14:05:09,2021-05-06 18:55:11.611662
1412,21721,4,21721,24,2340,24,8,1,8,Financial Pressure,2,2340,64,2021-05-06 14:05:09,2021-05-06 18:55:11.611662
1413,21722,4,21722,27,2340,27,9,1,9,Faculty & Staff Support,2,2340,64,2021-05-06 14:05:09,2021-05-06 18:55:11.611662
1414,21723,4,21723,30,2340,30,10,1,10,Friendships,2,2340,64,2021-05-06 14:05:09,2021-05-06 18:55:11.611662
1415,21724,5,21724,17,2341,17,6,0,6,Life - School Balance,2,2341,65,2021-05-06 14:05:09,2021-05-06 16:22:27.723530
1416,21725,5,21725,20,2341,20,7,1,7,Discrimination,2,2341,65,2021-05-06 14:05:09,2021-05-06 16:22:27.723530
1417,21726,5,21726,25,2341,25,8,0,8,Financial Pressure,2,2341,65,2021-05-06 14:05:09,2021-05-06 16:22:27.723530
1418,21727,5,21727,28,2341,28,9,1,9,Faculty & Staff Support,2,2341,65,2021-05-06 14:05:09,2021-05-06 16:22:27.723530
1419,21728,5,21728,32,2341,32,10,1,10,Friendships,2,2341,65,2021-05-06 14:05:09,2021-05-06 16:22:27.723530
1420,21739,2,21739,17,2344,17,6,0,6,Life - School Balance,2,2344,68,2021-05-06 14:05:09,2021-05-06 14:06:35.067624
1421,21740,4,21740,21,2344,21,7,1,7,Discrimination,2,2344,68,2021-05-06 14:05:09,2021-05-06 14:06:35.067624
1422,21741,5,21741,23,2344,23,8,1,8,Financial Pressure,2,2344,68,2021-05-06 14:05:09,2021-05-06 14:06:35.067624
1423,21742,6,21742,26,2344,26,9,1,9,Faculty & Staff Support,2,2344,68,2021-05-06 14:05:09,2021-05-06 14:06:35.067624
1424,21743,3,21743,31,2344,31,10,1,10,Friendships,2,2344,68,2021-05-06 14:05:09,2021-05-06 14:06:35.067624
1425,21749,3,21749,17,2346,17,6,0,6,Life - School Balance,2,2346,70,2021-05-06 14:05:10,2021-05-06 15:51:21.537257
1426,21750,4,21750,19,2346,19,7,0,7,Discrimination,2,2346,70,2021-05-06 14:05:10,2021-05-06 15:51:21.537257
1427,21751,3,21751,23,2346,23,8,1,8,Financial Pressure,2,2346,70,2021-05-06 14:05:10,2021-05-06 15:51:21.537257
1428,21752,4,21752,28,2346,28,9,1,9,Faculty & Staff Support,2,2346,70,2021-05-06 14:05:10,2021-05-06 15:51:21.537257
1429,21753,4,21753,33,2346,33,10,0,10,Friendships,2,2346,70,2021-05-06 14:05:10,2021-05-06 15:51:21.537257
1430,21754,4,21754,17,2347,17,6,0,6,Life - School Balance,2,2347,71,2021-05-06 14:05:10,2021-05-06 14:26:03.362400
1431,21755,4,21755,19,2347,19,7,0,7,Discrimination,2,2347,71,2021-05-06 14:05:10,2021-05-06 14:26:03.362400
1432,21756,4,21756,25,2347,25,8,0,8,Financial Pressure,2,2347,71,2021-05-06 14:05:10,2021-05-06 14:26:03.362400
1433,21757,4,21757,29,2347,29,9,0,9,Faculty & Staff Support,2,2347,71,2021-05-06 14:05:10,2021-05-06 14:26:03.362400
1434,21758,5,21758,31,2347,31,10,1,10,Friendships,2,2347,71,2021-05-06 14:05:10,2021-05-06 14:26:03.362400
1435,21764,6,21764,17,2349,17,6,0,6,Life - School Balance,2,2349,73,2021-05-06 14:05:10,2021-05-06 19:33:48.304677
1436,21765,6,21765,20,2349,20,7,1,7,Discrimination,2,2349,73,2021-05-06 14:05:10,2021-05-06 19:33:48.304677
1437,21766,1,21766,24,2349,24,8,1,8,Financial Pressure,2,2349,73,2021-05-06 14:05:10,2021-05-06 19:33:48.304677
1438,21767,6,21767,26,2349,26,9,1,9,Faculty & Staff Support,2,2349,73,2021-05-06 14:05:10,2021-05-06 19:33:48.304677
1439,21768,6,21768,33,2349,33,10,0,10,Friendships,2,2349,73,2021-05-06 14:05:10,2021-05-06 19:33:48.304677
1440,21774,4,21774,17,2351,17,6,0,6,Life - School Balance,2,2351,75,2021-05-06 14:05:10,2021-05-06 14:14:01.966809
1441,21775,6,21775,21,2351,21,7,1,7,Discrimination,2,2351,75,2021-05-06 14:05:10,2021-05-06 14:14:01.966809
1442,21776,3,21776,24,2351,24,8,1,8,Financial Pressure,2,2351,75,2021-05-06 14:05:10,2021-05-06 14:14:01.966809
1443,21777,6,21777,27,2351,27,9,1,9,Faculty & Staff Support,2,2351,75,2021-05-06 14:05:10,2021-05-06 14:14:01.966809
1444,21778,6,21778,33,2351,33,10,0,10,Friendships,2,2351,75,2021-05-06 14:05:10,2021-05-06 14:14:01.966809
1445,21814,4,21814,17,2359,17,6,0,6,Life - School Balance,2,2359,87,2021-05-06 14:05:12,2021-05-06 14:10:17.902489
1446,21815,5,21815,21,2359,21,7,1,7,Discrimination,2,2359,87,2021-05-06 14:05:12,2021-05-06 14:10:17.902489
1447,21816,2,21816,25,2359,25,8,0,8,Financial Pressure,2,2359,87,2021-05-06 14:05:12,2021-05-06 14:10:17.902489
1448,21817,5,21817,29,2359,29,9,0,9,Faculty & Staff Support,2,2359,87,2021-05-06 14:05:12,2021-05-06 14:10:17.902489
1449,21818,6,21818,32,2359,32,10,1,10,Friendships,2,2359,87,2021-05-06 14:05:12,2021-05-06 14:10:17.902489
1450,21819,5,21819,17,2360,17,6,0,6,Life - School Balance,2,2360,88,2021-05-06 14:05:12,2021-05-06 14:58:50.135218
1451,21820,6,21820,19,2360,19,7,0,7,Discrimination,2,2360,88,2021-05-06 14:05:12,2021-05-06 14:58:50.135218
1452,21821,4,21821,22,2360,22,8,1,8,Financial Pressure,2,2360,88,2021-05-06 14:05:12,2021-05-06 14:58:50.135218
1453,21822,5,21822,29,2360,29,9,0,9,Faculty & Staff Support,2,2360,88,2021-05-06 14:05:12,2021-05-06 14:58:50.135218
1454,21823,6,21823,31,2360,31,10,1,10,Friendships,2,2360,88,2021-05-06 14:05:12,2021-05-06 14:58:50.135218
1455,21824,3,21824,17,2361,17,6,0,6,Life - School Balance,2,2361,89,2021-05-06 14:05:12,2021-05-06 14:44:33.820217
1456,21825,5,21825,20,2361,20,7,1,7,Discrimination,2,2361,89,2021-05-06 14:05:12,2021-05-06 14:44:33.820217
1457,21826,2,21826,25,2361,25,8,0,8,Financial Pressure,2,2361,89,2021-05-06 14:05:12,2021-05-06 14:44:33.820217
1458,21827,6,21827,28,2361,28,9,1,9,Faculty & Staff Support,2,2361,89,2021-05-06 14:05:12,2021-05-06 14:44:33.820217
1459,21828,6,21828,30,2361,30,10,1,10,Friendships,2,2361,89,2021-05-06 14:05:12,2021-05-06 14:44:33.820217
1460,21839,3,21839,17,2364,17,6,0,6,Life - School Balance,2,2364,93,2021-05-06 14:05:12,2021-05-06 16:49:49.186901
1461,21840,6,21840,21,2364,21,7,1,7,Discrimination,2,2364,93,2021-05-06 14:05:12,2021-05-06 16:49:49.186901
1462,21841,4,21841,25,2364,25,8,0,8,Financial Pressure,2,2364,93,2021-05-06 14:05:12,2021-05-06 16:49:49.186901
1463,21842,4,21842,26,2364,26,9,1,9,Faculty & Staff Support,2,2364,93,2021-05-06 14:05:12,2021-05-06 16:49:49.186901
1464,21843,4,21843,32,2364,32,10,1,10,Friendships,2,2364,93,2021-05-06 14:05:12,2021-05-06 16:49:49.186901
1465,21864,3,21864,17,2369,17,6,0,6,Life - School Balance,2,2369,99,2021-05-06 14:05:13,2021-05-06 15:35:09.341758
1466,21865,6,21865,21,2369,21,7,1,7,Discrimination,2,2369,99,2021-05-06 14:05:13,2021-05-06 15:35:09.341758
1467,21866,4,21866,24,2369,24,8,1,8,Financial Pressure,2,2369,99,2021-05-06 14:05:13,2021-05-06 15:35:09.341758
1468,21867,6,21867,26,2369,26,9,1,9,Faculty & Staff Support,2,2369,99,2021-05-06 14:05:13,2021-05-06 15:35:09.341758
1469,21868,4,21868,31,2369,31,10,1,10,Friendships,2,2369,99,2021-05-06 14:05:13,2021-05-06 15:35:09.341758
1470,21889,3,21889,17,2374,17,6,0,6,Life - School Balance,2,2374,105,2021-05-06 14:05:14,2021-05-06 14:58:15.622651
1471,21890,4,21890,21,2374,21,7,1,7,Discrimination,2,2374,105,2021-05-06 14:05:14,2021-05-06 14:58:15.622651
1472,21891,3,21891,23,2374,23,8,1,8,Financial Pressure,2,2374,105,2021-05-06 14:05:14,2021-05-06 14:58:15.622651
1473,21892,4,21892,27,2374,27,9,1,9,Faculty & Staff Support,2,2374,105,2021-05-06 14:05:14,2021-05-06 14:58:15.622651
1474,21893,2,21893,33,2374,33,10,0,10,Friendships,2,2374,105,2021-05-06 14:05:14,2021-05-06 14:58:15.622651
1475,21,4,21,18,144,18,6,1,6,Life - School Balance,2,144,7,2021-03-16 17:05:02,
1476,22,6,22,20,144,20,7,1,7,Discrimination,2,144,7,2021-03-16 17:05:02,
1477,23,4,23,25,144,25,8,0,8,Financial Pressure,2,144,7,2021-03-16 17:05:02,
1478,24,5,24,27,144,27,9,1,9,Faculty & Staff Support,2,144,7,2021-03-16 17:05:02,
1479,25,6,25,30,144,30,10,1,10,Friendships,2,144,7,2021-03-16 17:05:02,
1480,26,5,26,18,145,18,6,1,6,Life - School Balance,2,145,9,2021-03-16 17:05:02,2021-03-16 17:06:03.832434
1481,27,5,27,20,145,20,7,1,7,Discrimination,2,145,9,2021-03-16 17:05:02,2021-03-16 17:06:03.832434
1482,28,4,28,23,145,23,8,1,8,Financial Pressure,2,145,9,2021-03-16 17:05:02,2021-03-16 17:06:03.832434
1483,29,3,29,26,145,26,9,1,9,Faculty & Staff Support,2,145,9,2021-03-16 17:05:02,2021-03-16 17:06:03.832434
1484,30,5,30,31,145,31,10,1,10,Friendships,2,145,9,2021-03-16 17:05:02,2021-03-16 17:06:03.832434
1485,66,5,66,18,153,18,6,1,6,Life - School Balance,2,153,20,2021-03-16 17:05:03,2021-03-16 19:36:35.573713
1486,67,5,67,21,153,21,7,1,7,Discrimination,2,153,20,2021-03-16 17:05:03,2021-03-16 19:36:35.573713
1487,68,6,68,24,153,24,8,1,8,Financial Pressure,2,153,20,2021-03-16 17:05:03,2021-03-16 19:36:35.573713
1488,69,5,69,29,153,29,9,0,9,Faculty & Staff Support,2,153,20,2021-03-16 17:05:03,2021-03-16 19:36:35.573713
1489,70,4,70,30,153,30,10,1,10,Friendships,2,153,20,2021-03-16 17:05:03,2021-03-16 19:36:35.573713
1490,281,2,281,18,196,18,6,1,6,Life - School Balance,2,196,77,2021-03-16 17:05:12,2021-03-16 19:18:58.814493
1491,282,5,282,19,196,19,7,0,7,Discrimination,2,196,77,2021-03-16 17:05:12,2021-03-16 19:18:58.814493
1492,283,2,283,23,196,23,8,1,8,Financial Pressure,2,196,77,2021-03-16 17:05:12,2021-03-16 19:18:58.814493
1493,284,4,284,28,196,28,9,1,9,Faculty & Staff Support,2,196,77,2021-03-16 17:05:12,2021-03-16 19:18:58.814493
1494,285,5,285,33,196,33,10,0,10,Friendships,2,196,77,2021-03-16 17:05:12,2021-03-16 19:18:58.814493
1495,311,5,311,18,202,18,6,1,6,Life - School Balance,2,202,6,2021-03-16 19:05:02,2021-03-16 19:34:51.853745
1496,312,6,312,19,202,19,7,0,7,Discrimination,2,202,6,2021-03-16 19:05:02,2021-03-16 19:34:51.853745
1497,313,6,313,22,202,22,8,1,8,Financial Pressure,2,202,6,2021-03-16 19:05:02,2021-03-16 19:34:51.853745
1498,314,5,314,26,202,26,9,1,9,Faculty & Staff Support,2,202,6,2021-03-16 19:05:02,2021-03-16 19:34:51.853745
1499,315,5,315,30,202,30,10,1,10,Friendships,2,202,6,2021-03-16 19:05:02,2021-03-16 19:34:51.853745
1500,326,2,326,18,205,18,6,1,6,Life - School Balance,2,205,10,2021-03-16 19:05:02,2021-03-16 19:35:45.269260
1501,327,5,327,20,205,20,7,1,7,Discrimination,2,205,10,2021-03-16 19:05:02,2021-03-16 19:35:45.269260
1502,328,6,328,24,205,24,8,1,8,Financial Pressure,2,205,10,2021-03-16 19:05:02,2021-03-16 19:35:45.269260
1503,329,5,329,29,205,29,9,0,9,Faculty & Staff Support,2,205,10,2021-03-16 19:05:02,2021-03-16 19:35:45.269260
1504,330,4,330,31,205,31,10,1,10,Friendships,2,205,10,2021-03-16 19:05:02,2021-03-16 19:35:45.269260
1505,356,4,356,18,211,18,6,1,6,Life - School Balance,2,211,19,2021-03-16 19:05:03,2021-03-16 20:29:24.943268
1506,357,5,357,21,211,21,7,1,7,Discrimination,2,211,19,2021-03-16 19:05:03,2021-03-16 20:29:24.943268
1507,358,3,358,23,211,23,8,1,8,Financial Pressure,2,211,19,2021-03-16 19:05:03,2021-03-16 20:29:24.943268
1508,359,4,359,26,211,26,9,1,9,Faculty & Staff Support,2,211,19,2021-03-16 19:05:03,2021-03-16 20:29:24.943268
1509,360,4,360,32,211,32,10,1,10,Friendships,2,211,19,2021-03-16 19:05:03,2021-03-16 20:29:24.943268
1510,371,4,371,18,214,18,6,1,6,Life - School Balance,2,214,23,2021-03-16 19:05:04,2021-03-16 19:25:29.250715
1511,372,5,372,21,214,21,7,1,7,Discrimination,2,214,23,2021-03-16 19:05:04,2021-03-16 19:25:29.250715
1512,373,6,373,22,214,22,8,1,8,Financial Pressure,2,214,23,2021-03-16 19:05:04,2021-03-16 19:25:29.250715
1513,374,6,374,26,214,26,9,1,9,Faculty & Staff Support,2,214,23,2021-03-16 19:05:04,2021-03-16 19:25:29.250715
1514,375,1,375,33,214,33,10,0,10,Friendships,2,214,23,2021-03-16 19:05:04,2021-03-16 19:25:29.250715
1515,461,4,461,18,232,18,6,1,6,Life - School Balance,2,232,49,2021-03-16 19:05:07,2021-03-17 04:37:57.288272
1516,462,3,462,21,232,21,7,1,7,Discrimination,2,232,49,2021-03-16 19:05:07,2021-03-17 04:37:57.288272
1517,463,5,463,24,232,24,8,1,8,Financial Pressure,2,232,49,2021-03-16 19:05:07,2021-03-17 04:37:57.288272
1518,464,4,464,26,232,26,9,1,9,Faculty & Staff Support,2,232,49,2021-03-16 19:05:07,2021-03-17 04:37:57.288272
1519,465,3,465,32,232,32,10,1,10,Friendships,2,232,49,2021-03-16 19:05:07,2021-03-17 04:37:57.288272
1520,521,5,521,18,244,18,6,1,6,Life - School Balance,2,244,66,2021-03-16 19:05:09,2021-03-16 19:26:48.050392
1521,522,5,522,19,244,19,7,0,7,Discrimination,2,244,66,2021-03-16 19:05:09,2021-03-16 19:26:48.050392
1522,523,4,523,22,244,22,8,1,8,Financial Pressure,2,244,66,2021-03-16 19:05:09,2021-03-16 19:26:48.050392
1523,524,3,524,28,244,28,9,1,9,Faculty & Staff Support,2,244,66,2021-03-16 19:05:09,2021-03-16 19:26:48.050392
1524,525,3,525,32,244,32,10,1,10,Friendships,2,244,66,2021-03-16 19:05:09,2021-03-16 19:26:48.050392
1525,616,5,616,18,263,18,6,1,6,Life - School Balance,2,263,9,2021-03-18 14:05:02,2021-03-18 14:41:50.665677
1526,617,6,617,19,263,19,7,0,7,Discrimination,2,263,9,2021-03-18 14:05:02,2021-03-18 14:41:50.665677
1527,618,4,618,22,263,22,8,1,8,Financial Pressure,2,263,9,2021-03-18 14:05:02,2021-03-18 14:41:50.665677
1528,619,6,619,26,263,26,9,1,9,Faculty & Staff Support,2,263,9,2021-03-18 14:05:02,2021-03-18 14:41:50.665677
1529,620,6,620,33,263,33,10,0,10,Friendships,2,263,9,2021-03-18 14:05:02,2021-03-18 14:41:50.665677
1530,646,4,646,18,269,18,6,1,6,Life - School Balance,2,269,18,2021-03-18 14:05:03,2021-03-18 14:41:46.780851
1531,647,3,647,19,269,19,7,0,7,Discrimination,2,269,18,2021-03-18 14:05:03,2021-03-18 14:41:46.780851
1532,648,6,648,24,269,24,8,1,8,Financial Pressure,2,269,18,2021-03-18 14:05:03,2021-03-18 14:41:46.780851
1533,649,5,649,29,269,29,9,0,9,Faculty & Staff Support,2,269,18,2021-03-18 14:05:03,2021-03-18 14:41:46.780851
1534,650,3,650,33,269,33,10,0,10,Friendships,2,269,18,2021-03-18 14:05:03,2021-03-18 14:41:46.780851
1535,681,2,681,18,276,18,6,1,6,Life - School Balance,2,276,28,2021-03-18 14:05:04,2021-03-18 14:54:39.118870
1536,682,6,682,21,276,21,7,1,7,Discrimination,2,276,28,2021-03-18 14:05:04,2021-03-18 14:54:39.118870
1537,683,5,683,23,276,23,8,1,8,Financial Pressure,2,276,28,2021-03-18 14:05:04,2021-03-18 14:54:39.118870
1538,684,5,684,28,276,28,9,1,9,Faculty & Staff Support,2,276,28,2021-03-18 14:05:04,2021-03-18 14:54:39.118870
1539,685,6,685,32,276,32,10,1,10,Friendships,2,276,28,2021-03-18 14:05:04,2021-03-18 14:54:39.118870
1540,686,2,686,18,277,18,6,1,6,Life - School Balance,2,277,30,2021-03-18 14:05:04,2021-03-18 14:06:25.621398
1541,687,5,687,20,277,20,7,1,7,Discrimination,2,277,30,2021-03-18 14:05:04,2021-03-18 14:06:25.621398
1542,688,3,688,25,277,25,8,0,8,Financial Pressure,2,277,30,2021-03-18 14:05:04,2021-03-18 14:06:25.621398
1543,689,6,689,28,277,28,9,1,9,Faculty & Staff Support,2,277,30,2021-03-18 14:05:04,2021-03-18 14:06:25.621398
1544,690,5,690,30,277,30,10,1,10,Friendships,2,277,30,2021-03-18 14:05:04,2021-03-18 14:06:25.621398
1545,706,3,706,18,281,18,6,1,6,Life - School Balance,2,281,35,2021-03-18 14:05:05,2021-03-18 14:07:21.102662
1546,707,4,707,20,281,20,7,1,7,Discrimination,2,281,35,2021-03-18 14:05:05,2021-03-18 14:07:21.102662
1547,708,3,708,23,281,23,8,1,8,Financial Pressure,2,281,35,2021-03-18 14:05:05,2021-03-18 14:07:21.102662
1548,709,5,709,27,281,27,9,1,9,Faculty & Staff Support,2,281,35,2021-03-18 14:05:05,2021-03-18 14:07:21.102662
1549,710,5,710,33,281,33,10,0,10,Friendships,2,281,35,2021-03-18 14:05:05,2021-03-18 14:07:21.102662
1550,721,4,721,18,284,18,6,1,6,Life - School Balance,2,284,41,2021-03-18 14:05:06,2021-03-18 14:53:30.962397
1551,722,4,722,20,284,20,7,1,7,Discrimination,2,284,41,2021-03-18 14:05:06,2021-03-18 14:53:30.962397
1552,723,3,723,24,284,24,8,1,8,Financial Pressure,2,284,41,2021-03-18 14:05:06,2021-03-18 14:53:30.962397
1553,724,5,724,29,284,29,9,0,9,Faculty & Staff Support,2,284,41,2021-03-18 14:05:06,2021-03-18 14:53:30.962397
1554,725,5,725,32,284,32,10,1,10,Friendships,2,284,41,2021-03-18 14:05:06,2021-03-18 14:53:30.962397
1555,731,4,731,18,286,18,6,1,6,Life - School Balance,2,286,44,2021-03-18 14:05:06,2021-03-18 14:54:11.861001
1556,732,4,732,20,286,20,7,1,7,Discrimination,2,286,44,2021-03-18 14:05:06,2021-03-18 14:54:11.861001
1557,733,3,733,23,286,23,8,1,8,Financial Pressure,2,286,44,2021-03-18 14:05:06,2021-03-18 14:54:11.861001
1558,734,5,734,28,286,28,9,1,9,Faculty & Staff Support,2,286,44,2021-03-18 14:05:06,2021-03-18 14:54:11.861001
1559,735,5,735,31,286,31,10,1,10,Friendships,2,286,44,2021-03-18 14:05:06,2021-03-18 14:54:11.861001
1560,751,3,751,18,290,18,6,1,6,Life - School Balance,2,290,48,2021-03-18 14:05:06,2021-03-18 14:12:25.954263
1561,752,6,752,19,290,19,7,0,7,Discrimination,2,290,48,2021-03-18 14:05:06,2021-03-18 14:12:25.954263
1562,753,3,753,25,290,25,8,0,8,Financial Pressure,2,290,48,2021-03-18 14:05:06,2021-03-18 14:12:25.954263
1563,754,6,754,29,290,29,9,0,9,Faculty & Staff Support,2,290,48,2021-03-18 14:05:06,2021-03-18 14:12:25.954263
1564,755,6,755,32,290,32,10,1,10,Friendships,2,290,48,2021-03-18 14:05:06,2021-03-18 14:12:25.954263
1565,756,4,756,18,291,18,6,1,6,Life - School Balance,2,291,49,2021-03-18 14:05:07,2021-03-18 14:34:41.592158
1566,757,3,757,20,291,20,7,1,7,Discrimination,2,291,49,2021-03-18 14:05:07,2021-03-18 14:34:41.592158
1567,758,5,758,22,291,22,8,1,8,Financial Pressure,2,291,49,2021-03-18 14:05:07,2021-03-18 14:34:41.592158
1568,759,4,759,26,291,26,9,1,9,Faculty & Staff Support,2,291,49,2021-03-18 14:05:07,2021-03-18 14:34:41.592158
1569,760,4,760,31,291,31,10,1,10,Friendships,2,291,49,2021-03-18 14:05:07,2021-03-18 14:34:41.592158
1570,791,4,791,18,298,18,6,1,6,Life - School Balance,2,298,60,2021-03-18 14:05:08,2021-03-18 17:11:06.114447
1571,792,5,792,20,298,20,7,1,7,Discrimination,2,298,60,2021-03-18 14:05:08,2021-03-18 17:11:06.114447
1572,793,6,793,22,298,22,8,1,8,Financial Pressure,2,298,60,2021-03-18 14:05:08,2021-03-18 17:11:06.114447
1573,794,6,794,29,298,29,9,0,9,Faculty & Staff Support,2,298,60,2021-03-18 14:05:08,2021-03-18 17:11:06.114447
1574,795,5,795,30,298,30,10,1,10,Friendships,2,298,60,2021-03-18 14:05:08,2021-03-18 17:11:06.114447
1575,806,4,806,18,301,18,6,1,6,Life - School Balance,2,301,64,2021-03-18 14:05:08,2021-03-18 15:19:07.085903
1576,807,6,807,19,301,19,7,0,7,Discrimination,2,301,64,2021-03-18 14:05:08,2021-03-18 15:19:07.085903
1577,808,3,808,23,301,23,8,1,8,Financial Pressure,2,301,64,2021-03-18 14:05:08,2021-03-18 15:19:07.085903
1578,809,5,809,26,301,26,9,1,9,Faculty & Staff Support,2,301,64,2021-03-18 14:05:08,2021-03-18 15:19:07.085903
1579,810,6,810,31,301,31,10,1,10,Friendships,2,301,64,2021-03-18 14:05:08,2021-03-18 15:19:07.085903
1580,826,3,826,18,305,18,6,1,6,Life - School Balance,2,305,68,2021-03-18 14:05:09,2021-03-18 17:28:28.383003
1581,827,4,827,21,305,21,7,1,7,Discrimination,2,305,68,2021-03-18 14:05:09,2021-03-18 17:28:28.383003
1582,828,3,828,23,305,23,8,1,8,Financial Pressure,2,305,68,2021-03-18 14:05:09,2021-03-18 17:28:28.383003
1583,829,4,829,28,305,28,9,1,9,Faculty & Staff Support,2,305,68,2021-03-18 14:05:09,2021-03-18 17:28:28.383003
1584,830,1,830,33,305,33,10,0,10,Friendships,2,305,68,2021-03-18 14:05:09,2021-03-18 17:28:28.383003
1585,861,3,861,18,312,18,6,1,6,Life - School Balance,2,312,75,2021-03-18 14:05:10,2021-03-18 14:47:49.397608
1586,862,5,862,19,312,19,7,0,7,Discrimination,2,312,75,2021-03-18 14:05:10,2021-03-18 14:47:49.397608
1587,863,3,863,23,312,23,8,1,8,Financial Pressure,2,312,75,2021-03-18 14:05:10,2021-03-18 14:47:49.397608
1588,864,6,864,26,312,26,9,1,9,Faculty & Staff Support,2,312,75,2021-03-18 14:05:10,2021-03-18 14:47:49.397608
1589,865,6,865,32,312,32,10,1,10,Friendships,2,312,75,2021-03-18 14:05:10,2021-03-18 14:47:49.397608
1590,981,1,981,18,362,18,6,1,6,Life - School Balance,2,362,30,2021-03-23 19:05:04,2021-03-23 19:09:53.403518
1591,982,6,982,21,362,21,7,1,7,Discrimination,2,362,30,2021-03-23 19:05:04,2021-03-23 19:09:53.403518
1592,983,5,983,23,362,23,8,1,8,Financial Pressure,2,362,30,2021-03-23 19:05:04,2021-03-23 19:09:53.403518
1593,984,6,984,29,362,29,9,0,9,Faculty & Staff Support,2,362,30,2021-03-23 19:05:04,2021-03-23 19:09:53.403518
1594,985,5,985,33,362,33,10,0,10,Friendships,2,362,30,2021-03-23 19:05:04,2021-03-23 19:09:53.403518
1595,991,3,991,18,364,18,6,1,6,Life - School Balance,2,364,32,2021-03-23 19:05:04,2021-03-23 19:11:06.041763
1596,992,5,992,21,364,21,7,1,7,Discrimination,2,364,32,2021-03-23 19:05:04,2021-03-23 19:11:06.041763
1597,993,6,993,24,364,24,8,1,8,Financial Pressure,2,364,32,2021-03-23 19:05:04,2021-03-23 19:11:06.041763
1598,994,4,994,26,364,26,9,1,9,Faculty & Staff Support,2,364,32,2021-03-23 19:05:04,2021-03-23 19:11:06.041763
1599,995,5,995,31,364,31,10,1,10,Friendships,2,364,32,2021-03-23 19:05:04,2021-03-23 19:11:06.041763
1600,1016,5,1016,18,369,18,6,1,6,Life - School Balance,2,369,41,2021-03-23 19:05:05,2021-03-23 20:14:51.790972
1601,1017,5,1017,20,369,20,7,1,7,Discrimination,2,369,41,2021-03-23 19:05:05,2021-03-23 20:14:51.790972
1602,1018,3,1018,23,369,23,8,1,8,Financial Pressure,2,369,41,2021-03-23 19:05:05,2021-03-23 20:14:51.790972
1603,1019,5,1019,28,369,28,9,1,9,Faculty & Staff Support,2,369,41,2021-03-23 19:05:05,2021-03-23 20:14:51.790972
1604,1020,5,1020,33,369,33,10,0,10,Friendships,2,369,41,2021-03-23 19:05:05,2021-03-23 20:14:51.790972
1605,1031,6,1031,18,372,18,6,1,6,Life - School Balance,2,372,45,2021-03-23 19:05:06,2021-03-23 19:09:31.209851
1606,1032,6,1032,20,372,20,7,1,7,Discrimination,2,372,45,2021-03-23 19:05:06,2021-03-23 19:09:31.209851
1607,1033,2,1033,24,372,24,8,1,8,Financial Pressure,2,372,45,2021-03-23 19:05:06,2021-03-23 19:09:31.209851
1608,1034,6,1034,28,372,28,9,1,9,Faculty & Staff Support,2,372,45,2021-03-23 19:05:06,2021-03-23 19:09:31.209851
1609,1035,4,1035,30,372,30,10,1,10,Friendships,2,372,45,2021-03-23 19:05:06,2021-03-23 19:09:31.209851
1610,1036,2,1036,18,373,18,6,1,6,Life - School Balance,2,373,46,2021-03-23 19:05:06,2021-03-23 19:06:07.554339
1611,1037,5,1037,21,373,21,7,1,7,Discrimination,2,373,46,2021-03-23 19:05:06,2021-03-23 19:06:07.554339
1612,1038,3,1038,22,373,22,8,1,8,Financial Pressure,2,373,46,2021-03-23 19:05:06,2021-03-23 19:06:07.554339
1613,1039,5,1039,28,373,28,9,1,9,Faculty & Staff Support,2,373,46,2021-03-23 19:05:06,2021-03-23 19:06:07.554339
1614,1040,5,1040,30,373,30,10,1,10,Friendships,2,373,46,2021-03-23 19:05:06,2021-03-23 19:06:07.554339
1615,1056,4,1056,18,377,18,6,1,6,Life - School Balance,2,377,50,2021-03-23 19:05:07,2021-03-23 19:10:01.797348
1616,1057,6,1057,19,377,19,7,0,7,Discrimination,2,377,50,2021-03-23 19:05:07,2021-03-23 19:10:01.797348
1617,1058,5,1058,24,377,24,8,1,8,Financial Pressure,2,377,50,2021-03-23 19:05:07,2021-03-23 19:10:01.797348
1618,1059,5,1059,27,377,27,9,1,9,Faculty & Staff Support,2,377,50,2021-03-23 19:05:07,2021-03-23 19:10:01.797348
1619,1060,4,1060,33,377,33,10,0,10,Friendships,2,377,50,2021-03-23 19:05:07,2021-03-23 19:10:01.797348
1620,1061,6,1061,18,378,18,6,1,6,Life - School Balance,2,378,52,2021-03-23 19:05:07,2021-03-23 19:06:06.316004
1621,1062,1,1062,21,378,21,7,1,7,Discrimination,2,378,52,2021-03-23 19:05:07,2021-03-23 19:06:06.316004
1622,1063,6,1063,25,378,25,8,0,8,Financial Pressure,2,378,52,2021-03-23 19:05:07,2021-03-23 19:06:06.316004
1623,1064,6,1064,29,378,29,9,0,9,Faculty & Staff Support,2,378,52,2021-03-23 19:05:07,2021-03-23 19:06:06.316004
1624,1065,5,1065,30,378,30,10,1,10,Friendships,2,378,52,2021-03-23 19:05:07,2021-03-23 19:06:06.316004
1625,1066,3,1066,18,379,18,6,1,6,Life - School Balance,2,379,54,2021-03-23 19:05:07,2021-03-23 19:17:54.221397
1626,1067,3,1067,21,379,21,7,1,7,Discrimination,2,379,54,2021-03-23 19:05:07,2021-03-23 19:17:54.221397
1627,1068,5,1068,23,379,23,8,1,8,Financial Pressure,2,379,54,2021-03-23 19:05:07,2021-03-23 19:17:54.221397
1628,1069,6,1069,28,379,28,9,1,9,Faculty & Staff Support,2,379,54,2021-03-23 19:05:07,2021-03-23 19:17:54.221397
1629,1070,6,1070,31,379,31,10,1,10,Friendships,2,379,54,2021-03-23 19:05:07,2021-03-23 19:17:54.221397
1630,1081,3,1081,18,382,18,6,1,6,Life - School Balance,2,382,58,2021-03-23 19:05:07,2021-03-24 12:08:53.326437
1631,1082,2,1082,19,382,19,7,0,7,Discrimination,2,382,58,2021-03-23 19:05:07,2021-03-24 12:08:53.326437
1632,1083,3,1083,22,382,22,8,1,8,Financial Pressure,2,382,58,2021-03-23 19:05:07,2021-03-24 12:08:53.326437
1633,1084,4,1084,26,382,26,9,1,9,Faculty & Staff Support,2,382,58,2021-03-23 19:05:07,2021-03-24 12:08:53.326437
1634,1085,5,1085,31,382,31,10,1,10,Friendships,2,382,58,2021-03-23 19:05:07,2021-03-24 12:08:53.326437
1635,1086,4,1086,18,383,18,6,1,6,Life - School Balance,2,383,60,2021-03-23 19:05:07,2021-03-23 20:02:19.920034
1636,1087,4,1087,20,383,20,7,1,7,Discrimination,2,383,60,2021-03-23 19:05:07,2021-03-23 20:02:19.920034
1637,1088,4,1088,25,383,25,8,0,8,Financial Pressure,2,383,60,2021-03-23 19:05:07,2021-03-23 20:02:19.920034
1638,1089,5,1089,27,383,27,9,1,9,Faculty & Staff Support,2,383,60,2021-03-23 19:05:07,2021-03-23 20:02:19.920034
1639,1090,4,1090,33,383,33,10,0,10,Friendships,2,383,60,2021-03-23 19:05:07,2021-03-23 20:02:19.920034
1640,1121,3,1121,18,390,18,6,1,6,Life - School Balance,2,390,68,2021-03-23 19:05:08,2021-03-23 19:06:53.062831
1641,1122,4,1122,21,390,21,7,1,7,Discrimination,2,390,68,2021-03-23 19:05:08,2021-03-23 19:06:53.062831
1642,1123,3,1123,25,390,25,8,0,8,Financial Pressure,2,390,68,2021-03-23 19:05:08,2021-03-23 19:06:53.062831
1643,1124,5,1124,27,390,27,9,1,9,Faculty & Staff Support,2,390,68,2021-03-23 19:05:08,2021-03-23 19:06:53.062831
1644,1125,1,1125,33,390,33,10,0,10,Friendships,2,390,68,2021-03-23 19:05:08,2021-03-23 19:06:53.062831
1645,1126,5,1126,18,391,18,6,1,6,Life - School Balance,2,391,69,2021-03-23 19:05:09,2021-03-23 20:54:50.605521
1646,1127,5,1127,19,391,19,7,0,7,Discrimination,2,391,69,2021-03-23 19:05:09,2021-03-23 20:54:50.605521
1647,1128,3,1128,25,391,25,8,0,8,Financial Pressure,2,391,69,2021-03-23 19:05:09,2021-03-23 20:54:50.605521
1648,1129,5,1129,29,391,29,9,0,9,Faculty & Staff Support,2,391,69,2021-03-23 19:05:09,2021-03-23 20:54:50.605521
1649,1130,4,1130,33,391,33,10,0,10,Friendships,2,391,69,2021-03-23 19:05:09,2021-03-23 20:54:50.605521
1650,1146,5,1146,18,395,18,6,1,6,Life - School Balance,2,395,73,2021-03-23 19:05:09,2021-03-23 20:10:34.674201
1651,1147,6,1147,19,395,19,7,0,7,Discrimination,2,395,73,2021-03-23 19:05:09,2021-03-23 20:10:34.674201
1652,1148,1,1148,23,395,23,8,1,8,Financial Pressure,2,395,73,2021-03-23 19:05:09,2021-03-23 20:10:34.674201
1653,1149,4,1149,28,395,28,9,1,9,Faculty & Staff Support,2,395,73,2021-03-23 19:05:09,2021-03-23 20:10:34.674201
1654,1150,6,1150,32,395,32,10,1,10,Friendships,2,395,73,2021-03-23 19:05:09,2021-03-23 20:10:34.674201
1655,1151,5,1151,18,396,18,6,1,6,Life - School Balance,2,396,74,2021-03-23 19:05:09,2021-03-24 03:33:25.312778
1656,1152,6,1152,20,396,20,7,1,7,Discrimination,2,396,74,2021-03-23 19:05:09,2021-03-24 03:33:25.312778
1657,1153,5,1153,22,396,22,8,1,8,Financial Pressure,2,396,74,2021-03-23 19:05:09,2021-03-24 03:33:25.312778
1658,1154,5,1154,26,396,26,9,1,9,Faculty & Staff Support,2,396,74,2021-03-23 19:05:09,2021-03-24 03:33:25.312778
1659,1155,6,1155,32,396,32,10,1,10,Friendships,2,396,74,2021-03-23 19:05:09,2021-03-24 03:33:25.312778
1660,1156,4,1156,18,397,18,6,1,6,Life - School Balance,2,397,75,2021-03-23 19:05:10,2021-03-23 19:10:10.691408
1661,1157,6,1157,20,397,20,7,1,7,Discrimination,2,397,75,2021-03-23 19:05:10,2021-03-23 19:10:10.691408
1662,1158,2,1158,22,397,22,8,1,8,Financial Pressure,2,397,75,2021-03-23 19:05:10,2021-03-23 19:10:10.691408
1663,1159,6,1159,27,397,27,9,1,9,Faculty & Staff Support,2,397,75,2021-03-23 19:05:10,2021-03-23 19:10:10.691408
1664,1160,6,1160,30,397,30,10,1,10,Friendships,2,397,75,2021-03-23 19:05:10,2021-03-23 19:10:10.691408
1665,1181,5,1181,18,402,18,6,1,6,Life - School Balance,2,402,84,2021-03-23 19:05:10,2021-03-23 19:11:58.069168
1666,1182,6,1182,21,402,21,7,1,7,Discrimination,2,402,84,2021-03-23 19:05:10,2021-03-23 19:11:58.069168
1667,1183,4,1183,22,402,22,8,1,8,Financial Pressure,2,402,84,2021-03-23 19:05:10,2021-03-23 19:11:58.069168
1668,1184,5,1184,27,402,27,9,1,9,Faculty & Staff Support,2,402,84,2021-03-23 19:05:10,2021-03-23 19:11:58.069168
1669,1185,6,1185,31,402,31,10,1,10,Friendships,2,402,84,2021-03-23 19:05:10,2021-03-23 19:11:58.069168
1670,1201,4,1201,18,406,18,6,1,6,Life - School Balance,2,406,89,2021-03-23 19:05:11,2021-03-23 19:11:06.330709
1671,1202,6,1202,20,406,20,7,1,7,Discrimination,2,406,89,2021-03-23 19:05:11,2021-03-23 19:11:06.330709
1672,1203,4,1203,24,406,24,8,1,8,Financial Pressure,2,406,89,2021-03-23 19:05:11,2021-03-23 19:11:06.330709
1673,1204,5,1204,28,406,28,9,1,9,Faculty & Staff Support,2,406,89,2021-03-23 19:05:11,2021-03-23 19:11:06.330709
1674,1205,6,1205,32,406,32,10,1,10,Friendships,2,406,89,2021-03-23 19:05:11,2021-03-23 19:11:06.330709
1675,1206,3,1206,18,407,18,6,1,6,Life - School Balance,2,407,90,2021-03-23 19:05:11,2021-03-23 19:29:20.354672
1676,1207,5,1207,21,407,21,7,1,7,Discrimination,2,407,90,2021-03-23 19:05:11,2021-03-23 19:29:20.354672
1677,1208,5,1208,22,407,22,8,1,8,Financial Pressure,2,407,90,2021-03-23 19:05:11,2021-03-23 19:29:20.354672
1678,1209,6,1209,27,407,27,9,1,9,Faculty & Staff Support,2,407,90,2021-03-23 19:05:11,2021-03-23 19:29:20.354672
1679,1210,6,1210,30,407,30,10,1,10,Friendships,2,407,90,2021-03-23 19:05:11,2021-03-23 19:29:20.354672
1680,1221,6,1221,18,410,18,6,1,6,Life - School Balance,2,410,94,2021-03-23 19:05:12,2021-03-23 19:06:57.213415
1681,1222,6,1222,19,410,19,7,0,7,Discrimination,2,410,94,2021-03-23 19:05:12,2021-03-23 19:06:57.213415
1682,1223,4,1223,23,410,23,8,1,8,Financial Pressure,2,410,94,2021-03-23 19:05:12,2021-03-23 19:06:57.213415
1683,1224,6,1224,27,410,27,9,1,9,Faculty & Staff Support,2,410,94,2021-03-23 19:05:12,2021-03-23 19:06:57.213415
1684,1225,6,1225,31,410,31,10,1,10,Friendships,2,410,94,2021-03-23 19:05:12,2021-03-23 19:06:57.213415
1685,1226,4,1226,18,411,18,6,1,6,Life - School Balance,2,411,95,2021-03-23 19:05:12,2021-03-23 19:08:25.766817
1686,1227,5,1227,20,411,20,7,1,7,Discrimination,2,411,95,2021-03-23 19:05:12,2021-03-23 19:08:25.766817
1687,1228,5,1228,22,411,22,8,1,8,Financial Pressure,2,411,95,2021-03-23 19:05:12,2021-03-23 19:08:25.766817
1688,1229,6,1229,28,411,28,9,1,9,Faculty & Staff Support,2,411,95,2021-03-23 19:05:12,2021-03-23 19:08:25.766817
1689,1230,6,1230,30,411,30,10,1,10,Friendships,2,411,95,2021-03-23 19:05:12,2021-03-23 19:08:25.766817
1690,1236,4,1236,18,413,18,6,1,6,Life - School Balance,2,413,99,2021-03-23 19:05:12,2021-03-24 03:00:49.021373
1691,1237,6,1237,20,413,20,7,1,7,Discrimination,2,413,99,2021-03-23 19:05:12,2021-03-24 03:00:49.021373
1692,1238,1,1238,23,413,23,8,1,8,Financial Pressure,2,413,99,2021-03-23 19:05:12,2021-03-24 03:00:49.021373
1693,1239,4,1239,27,413,27,9,1,9,Faculty & Staff Support,2,413,99,2021-03-23 19:05:12,2021-03-24 03:00:49.021373
1694,1240,5,1240,31,413,31,10,1,10,Friendships,2,413,99,2021-03-23 19:05:12,2021-03-24 03:00:49.021373
1695,1246,5,1246,18,415,18,6,1,6,Life - School Balance,2,415,101,2021-03-23 19:05:12,2021-03-23 20:05:43.030334
1696,1247,6,1247,20,415,20,7,1,7,Discrimination,2,415,101,2021-03-23 19:05:12,2021-03-23 20:05:43.030334
1697,1248,6,1248,23,415,23,8,1,8,Financial Pressure,2,415,101,2021-03-23 19:05:12,2021-03-23 20:05:43.030334
1698,1249,5,1249,28,415,28,9,1,9,Faculty & Staff Support,2,415,101,2021-03-23 19:05:12,2021-03-23 20:05:43.030334
1699,1250,6,1250,31,415,31,10,1,10,Friendships,2,415,101,2021-03-23 19:05:12,2021-03-23 20:05:43.030334
1700,1251,5,1251,18,416,18,6,1,6,Life - School Balance,2,416,103,2021-03-23 19:05:12,2021-03-23 19:07:54.121334
1701,1252,6,1252,20,416,20,7,1,7,Discrimination,2,416,103,2021-03-23 19:05:12,2021-03-23 19:07:54.121334
1702,1253,2,1253,22,416,22,8,1,8,Financial Pressure,2,416,103,2021-03-23 19:05:12,2021-03-23 19:07:54.121334
1703,1254,6,1254,27,416,27,9,1,9,Faculty & Staff Support,2,416,103,2021-03-23 19:05:12,2021-03-23 19:07:54.121334
1704,1255,6,1255,30,416,30,10,1,10,Friendships,2,416,103,2021-03-23 19:05:12,2021-03-23 19:07:54.121334
1705,1296,4,1296,18,425,18,6,1,6,Life - School Balance,2,425,13,2021-03-25 14:05:02,2021-03-25 15:10:01.492532
1706,1297,3,1297,21,425,21,7,1,7,Discrimination,2,425,13,2021-03-25 14:05:02,2021-03-25 15:10:01.492532
1707,1298,4,1298,23,425,23,8,1,8,Financial Pressure,2,425,13,2021-03-25 14:05:02,2021-03-25 15:10:01.492532
1708,1299,5,1299,29,425,29,9,0,9,Faculty & Staff Support,2,425,13,2021-03-25 14:05:02,2021-03-25 15:10:01.492532
1709,1300,5,1300,31,425,31,10,1,10,Friendships,2,425,13,2021-03-25 14:05:02,2021-03-25 15:10:01.492532
1710,1341,3,1341,18,434,18,6,1,6,Life - School Balance,2,434,26,2021-03-25 14:05:03,2021-03-25 14:11:28.443264
1711,1342,5,1342,21,434,21,7,1,7,Discrimination,2,434,26,2021-03-25 14:05:03,2021-03-25 14:11:28.443264
1712,1343,5,1343,24,434,24,8,1,8,Financial Pressure,2,434,26,2021-03-25 14:05:03,2021-03-25 14:11:28.443264
1713,1344,4,1344,28,434,28,9,1,9,Faculty & Staff Support,2,434,26,2021-03-25 14:05:03,2021-03-25 14:11:28.443264
1714,1345,5,1345,31,434,31,10,1,10,Friendships,2,434,26,2021-03-25 14:05:03,2021-03-25 14:11:28.443264
1715,1346,4,1346,18,435,18,6,1,6,Life - School Balance,2,435,27,2021-03-25 14:05:04,2021-03-25 14:43:41.047424
1716,1347,6,1347,20,435,20,7,1,7,Discrimination,2,435,27,2021-03-25 14:05:04,2021-03-25 14:43:41.047424
1717,1348,2,1348,23,435,23,8,1,8,Financial Pressure,2,435,27,2021-03-25 14:05:04,2021-03-25 14:43:41.047424
1718,1349,6,1349,28,435,28,9,1,9,Faculty & Staff Support,2,435,27,2021-03-25 14:05:04,2021-03-25 14:43:41.047424
1719,1350,4,1350,33,435,33,10,0,10,Friendships,2,435,27,2021-03-25 14:05:04,2021-03-25 14:43:41.047424
1720,1366,3,1366,18,439,18,6,1,6,Life - School Balance,2,439,32,2021-03-25 14:05:04,2021-03-25 19:45:15.246195
1721,1367,4,1367,20,439,20,7,1,7,Discrimination,2,439,32,2021-03-25 14:05:04,2021-03-25 19:45:15.246195
1722,1368,6,1368,23,439,23,8,1,8,Financial Pressure,2,439,32,2021-03-25 14:05:04,2021-03-25 19:45:15.246195
1723,1369,4,1369,28,439,28,9,1,9,Faculty & Staff Support,2,439,32,2021-03-25 14:05:04,2021-03-25 19:45:15.246195
1724,1370,4,1370,31,439,31,10,1,10,Friendships,2,439,32,2021-03-25 14:05:04,2021-03-25 19:45:15.246195
1725,1371,5,1371,18,440,18,6,1,6,Life - School Balance,2,440,34,2021-03-25 14:05:04,2021-03-25 14:16:05.421677
1726,1372,6,1372,20,440,20,7,1,7,Discrimination,2,440,34,2021-03-25 14:05:04,2021-03-25 14:16:05.421677
1727,1373,3,1373,22,440,22,8,1,8,Financial Pressure,2,440,34,2021-03-25 14:05:04,2021-03-25 14:16:05.421677
1728,1374,6,1374,28,440,28,9,1,9,Faculty & Staff Support,2,440,34,2021-03-25 14:05:04,2021-03-25 14:16:05.421677
1729,1375,6,1375,32,440,32,10,1,10,Friendships,2,440,34,2021-03-25 14:05:04,2021-03-25 14:16:05.421677
1730,1391,5,1391,18,444,18,6,1,6,Life - School Balance,2,444,41,2021-03-25 14:05:05,2021-03-25 15:49:16.784391
1731,1392,6,1392,21,444,21,7,1,7,Discrimination,2,444,41,2021-03-25 14:05:05,2021-03-25 15:49:16.784391
1732,1393,3,1393,24,444,24,8,1,8,Financial Pressure,2,444,41,2021-03-25 14:05:05,2021-03-25 15:49:16.784391
1733,1394,5,1394,28,444,28,9,1,9,Faculty & Staff Support,2,444,41,2021-03-25 14:05:05,2021-03-25 15:49:16.784391
1734,1395,5,1395,32,444,32,10,1,10,Friendships,2,444,41,2021-03-25 14:05:05,2021-03-25 15:49:16.784391
1735,1406,5,1406,18,447,18,6,1,6,Life - School Balance,2,447,45,2021-03-25 14:05:06,2021-03-25 14:06:03.168646
1736,1407,6,1407,19,447,19,7,0,7,Discrimination,2,447,45,2021-03-25 14:05:06,2021-03-25 14:06:03.168646
1737,1408,2,1408,24,447,24,8,1,8,Financial Pressure,2,447,45,2021-03-25 14:05:06,2021-03-25 14:06:03.168646
1738,1409,6,1409,28,447,28,9,1,9,Faculty & Staff Support,2,447,45,2021-03-25 14:05:06,2021-03-25 14:06:03.168646
1739,1410,4,1410,30,447,30,10,1,10,Friendships,2,447,45,2021-03-25 14:05:06,2021-03-25 14:06:03.168646
1740,1426,4,1426,18,451,18,6,1,6,Life - School Balance,2,451,49,2021-03-25 14:05:06,2021-03-25 16:22:45.091160
1741,1427,4,1427,21,451,21,7,1,7,Discrimination,2,451,49,2021-03-25 14:05:06,2021-03-25 16:22:45.091160
1742,1428,4,1428,24,451,24,8,1,8,Financial Pressure,2,451,49,2021-03-25 14:05:06,2021-03-25 16:22:45.091160
1743,1429,4,1429,27,451,27,9,1,9,Faculty & Staff Support,2,451,49,2021-03-25 14:05:06,2021-03-25 16:22:45.091160
1744,1430,4,1430,33,451,33,10,0,10,Friendships,2,451,49,2021-03-25 14:05:06,2021-03-25 16:22:45.091160
1745,1441,3,1441,18,454,18,6,1,6,Life - School Balance,2,454,54,2021-03-25 14:05:07,2021-03-25 14:09:43.059401
1746,1442,3,1442,20,454,20,7,1,7,Discrimination,2,454,54,2021-03-25 14:05:07,2021-03-25 14:09:43.059401
1747,1443,5,1443,24,454,24,8,1,8,Financial Pressure,2,454,54,2021-03-25 14:05:07,2021-03-25 14:09:43.059401
1748,1444,6,1444,26,454,26,9,1,9,Faculty & Staff Support,2,454,54,2021-03-25 14:05:07,2021-03-25 14:09:43.059401
1749,1445,5,1445,31,454,31,10,1,10,Friendships,2,454,54,2021-03-25 14:05:07,2021-03-25 14:09:43.059401
1750,1461,4,1461,18,458,18,6,1,6,Life - School Balance,2,458,60,2021-03-25 14:05:07,2021-03-25 14:39:12.620213
1751,1462,4,1462,21,458,21,7,1,7,Discrimination,2,458,60,2021-03-25 14:05:07,2021-03-25 14:39:12.620213
1752,1463,4,1463,24,458,24,8,1,8,Financial Pressure,2,458,60,2021-03-25 14:05:07,2021-03-25 14:39:12.620213
1753,1464,5,1464,26,458,26,9,1,9,Faculty & Staff Support,2,458,60,2021-03-25 14:05:07,2021-03-25 14:39:12.620213
1754,1465,5,1465,31,458,31,10,1,10,Friendships,2,458,60,2021-03-25 14:05:07,2021-03-25 14:39:12.620213
1755,1481,5,1481,18,462,18,6,1,6,Life - School Balance,2,462,65,2021-03-25 14:05:08,2021-03-25 14:07:11.024362
1756,1482,5,1482,19,462,19,7,0,7,Discrimination,2,462,65,2021-03-25 14:05:08,2021-03-25 14:07:11.024362
1757,1483,4,1483,22,462,22,8,1,8,Financial Pressure,2,462,65,2021-03-25 14:05:08,2021-03-25 14:07:11.024362
1758,1484,5,1484,28,462,28,9,1,9,Faculty & Staff Support,2,462,65,2021-03-25 14:05:08,2021-03-25 14:07:11.024362
1759,1485,4,1485,33,462,33,10,0,10,Friendships,2,462,65,2021-03-25 14:05:08,2021-03-25 14:07:11.024362
1760,1506,3,1506,18,467,18,6,1,6,Life - School Balance,2,467,70,2021-03-25 14:05:09,2021-03-25 15:17:28.926189
1761,1507,5,1507,20,467,20,7,1,7,Discrimination,2,467,70,2021-03-25 14:05:09,2021-03-25 15:17:28.926189
1762,1508,3,1508,22,467,22,8,1,8,Financial Pressure,2,467,70,2021-03-25 14:05:09,2021-03-25 15:17:28.926189
1763,1509,4,1509,27,467,27,9,1,9,Faculty & Staff Support,2,467,70,2021-03-25 14:05:09,2021-03-25 15:17:28.926189
1764,1510,4,1510,32,467,32,10,1,10,Friendships,2,467,70,2021-03-25 14:05:09,2021-03-25 15:17:28.926189
1765,1531,3,1531,18,472,18,6,1,6,Life - School Balance,2,472,75,2021-03-25 14:05:10,2021-03-25 15:38:41.117311
1766,1532,6,1532,21,472,21,7,1,7,Discrimination,2,472,75,2021-03-25 14:05:10,2021-03-25 15:38:41.117311
1767,1533,3,1533,22,472,22,8,1,8,Financial Pressure,2,472,75,2021-03-25 14:05:10,2021-03-25 15:38:41.117311
1768,1534,6,1534,29,472,29,9,0,9,Faculty & Staff Support,2,472,75,2021-03-25 14:05:10,2021-03-25 15:38:41.117311
1769,1535,6,1535,32,472,32,10,1,10,Friendships,2,472,75,2021-03-25 14:05:10,2021-03-25 15:38:41.117311
1770,1556,5,1556,18,477,18,6,1,6,Life - School Balance,2,477,84,2021-03-25 14:05:10,2021-03-25 15:43:20.940675
1771,1557,6,1557,21,477,21,7,1,7,Discrimination,2,477,84,2021-03-25 14:05:10,2021-03-25 15:43:20.940675
1772,1558,4,1558,22,477,22,8,1,8,Financial Pressure,2,477,84,2021-03-25 14:05:10,2021-03-25 15:43:20.940675
1773,1559,5,1559,26,477,26,9,1,9,Faculty & Staff Support,2,477,84,2021-03-25 14:05:10,2021-03-25 15:43:20.940675
1774,1560,5,1560,30,477,30,10,1,10,Friendships,2,477,84,2021-03-25 14:05:10,2021-03-25 15:43:20.940675
1775,1561,5,1561,18,478,18,6,1,6,Life - School Balance,2,478,86,2021-03-25 14:05:10,2021-03-25 16:35:55.926159
1776,1562,6,1562,19,478,19,7,0,7,Discrimination,2,478,86,2021-03-25 14:05:10,2021-03-25 16:35:55.926159
1777,1563,2,1563,22,478,22,8,1,8,Financial Pressure,2,478,86,2021-03-25 14:05:10,2021-03-25 16:35:55.926159
1778,1564,5,1564,26,478,26,9,1,9,Faculty & Staff Support,2,478,86,2021-03-25 14:05:10,2021-03-25 16:35:55.926159
1779,1565,4,1565,33,478,33,10,0,10,Friendships,2,478,86,2021-03-25 14:05:10,2021-03-25 16:35:55.926159
1780,1596,6,1596,18,485,18,6,1,6,Life - School Balance,2,485,94,2021-03-25 14:05:11,2021-03-25 14:07:03.358667
1781,1597,6,1597,20,485,20,7,1,7,Discrimination,2,485,94,2021-03-25 14:05:11,2021-03-25 14:07:03.358667
1782,1598,2,1598,22,485,22,8,1,8,Financial Pressure,2,485,94,2021-03-25 14:05:11,2021-03-25 14:07:03.358667
1783,1599,6,1599,28,485,28,9,1,9,Faculty & Staff Support,2,485,94,2021-03-25 14:05:11,2021-03-25 14:07:03.358667
1784,1600,6,1600,30,485,30,10,1,10,Friendships,2,485,94,2021-03-25 14:05:11,2021-03-25 14:07:03.358667
1785,1606,4,1606,18,487,18,6,1,6,Life - School Balance,2,487,96,2021-03-25 14:05:12,2021-03-25 14:37:50.193704
1786,1607,6,1607,19,487,19,7,0,7,Discrimination,2,487,96,2021-03-25 14:05:12,2021-03-25 14:37:50.193704
1787,1608,6,1608,25,487,25,8,0,8,Financial Pressure,2,487,96,2021-03-25 14:05:12,2021-03-25 14:37:50.193704
1788,1609,4,1609,26,487,26,9,1,9,Faculty & Staff Support,2,487,96,2021-03-25 14:05:12,2021-03-25 14:37:50.193704
1789,1610,4,1610,33,487,33,10,0,10,Friendships,2,487,96,2021-03-25 14:05:12,2021-03-25 14:37:50.193704
1790,1621,5,1621,18,490,18,6,1,6,Life - School Balance,2,490,101,2021-03-25 14:05:12,2021-03-25 14:07:35.252611
1791,1622,5,1622,19,490,19,7,0,7,Discrimination,2,490,101,2021-03-25 14:05:12,2021-03-25 14:07:35.252611
1792,1623,5,1623,23,490,23,8,1,8,Financial Pressure,2,490,101,2021-03-25 14:05:12,2021-03-25 14:07:35.252611
1793,1624,6,1624,28,490,28,9,1,9,Faculty & Staff Support,2,490,101,2021-03-25 14:05:12,2021-03-25 14:07:35.252611
1794,1625,6,1625,30,490,30,10,1,10,Friendships,2,490,101,2021-03-25 14:05:12,2021-03-25 14:07:35.252611
1795,1671,4,1671,18,520,18,6,1,6,Life - School Balance,2,520,13,2021-03-30 19:05:02,2021-03-30 19:45:13.753024
1796,1672,5,1672,20,520,20,7,1,7,Discrimination,2,520,13,2021-03-30 19:05:02,2021-03-30 19:45:13.753024
1797,1673,4,1673,24,520,24,8,1,8,Financial Pressure,2,520,13,2021-03-30 19:05:02,2021-03-30 19:45:13.753024
1798,1674,4,1674,26,520,26,9,1,9,Faculty & Staff Support,2,520,13,2021-03-30 19:05:02,2021-03-30 19:45:13.753024
1799,1675,5,1675,32,520,32,10,1,10,Friendships,2,520,13,2021-03-30 19:05:02,2021-03-30 19:45:13.753024
1800,1686,2,1686,18,523,18,6,1,6,Life - School Balance,2,523,17,2021-03-30 19:05:02,2021-03-30 19:05:46.920309
1801,1687,6,1687,19,523,19,7,0,7,Discrimination,2,523,17,2021-03-30 19:05:02,2021-03-30 19:05:46.920309
1802,1688,6,1688,24,523,24,8,1,8,Financial Pressure,2,523,17,2021-03-30 19:05:02,2021-03-30 19:05:46.920309
1803,1689,2,1689,28,523,28,9,1,9,Faculty & Staff Support,2,523,17,2021-03-30 19:05:02,2021-03-30 19:05:46.920309
1804,1690,5,1690,33,523,33,10,0,10,Friendships,2,523,17,2021-03-30 19:05:02,2021-03-30 19:05:46.920309
1805,1691,5,1691,18,524,18,6,1,6,Life - School Balance,2,524,18,2021-03-30 19:05:03,2021-03-30 23:49:08.469966
1806,1692,5,1692,21,524,21,7,1,7,Discrimination,2,524,18,2021-03-30 19:05:03,2021-03-30 23:49:08.469966
1807,1693,6,1693,24,524,24,8,1,8,Financial Pressure,2,524,18,2021-03-30 19:05:03,2021-03-30 23:49:08.469966
1808,1694,5,1694,27,524,27,9,1,9,Faculty & Staff Support,2,524,18,2021-03-30 19:05:03,2021-03-30 23:49:08.469966
1809,1695,6,1695,31,524,31,10,1,10,Friendships,2,524,18,2021-03-30 19:05:03,2021-03-30 23:49:08.469966
1810,1706,2,1706,18,527,18,6,1,6,Life - School Balance,2,527,22,2021-03-30 19:05:03,2021-03-30 19:08:57.243740
1811,1707,2,1707,21,527,21,7,1,7,Discrimination,2,527,22,2021-03-30 19:05:03,2021-03-30 19:08:57.243740
1812,1708,6,1708,24,527,24,8,1,8,Financial Pressure,2,527,22,2021-03-30 19:05:03,2021-03-30 19:08:57.243740
1813,1709,6,1709,28,527,28,9,1,9,Faculty & Staff Support,2,527,22,2021-03-30 19:05:03,2021-03-30 19:08:57.243740
1814,1710,4,1710,30,527,30,10,1,10,Friendships,2,527,22,2021-03-30 19:05:03,2021-03-30 19:08:57.243740
1815,1716,4,1716,18,529,18,6,1,6,Life - School Balance,2,529,26,2021-03-30 19:05:03,2021-03-30 19:22:11.805265
1816,1717,5,1717,19,529,19,7,0,7,Discrimination,2,529,26,2021-03-30 19:05:03,2021-03-30 19:22:11.805265
1817,1718,2,1718,23,529,23,8,1,8,Financial Pressure,2,529,26,2021-03-30 19:05:03,2021-03-30 19:22:11.805265
1818,1719,5,1719,27,529,27,9,1,9,Faculty & Staff Support,2,529,26,2021-03-30 19:05:03,2021-03-30 19:22:11.805265
1819,1720,5,1720,31,529,31,10,1,10,Friendships,2,529,26,2021-03-30 19:05:03,2021-03-30 19:22:11.805265
1820,1726,3,1726,18,531,18,6,1,6,Life - School Balance,2,531,28,2021-03-30 19:05:04,2021-03-31 17:14:29.234976
1821,1727,6,1727,19,531,19,7,0,7,Discrimination,2,531,28,2021-03-30 19:05:04,2021-03-31 17:14:29.234976
1822,1728,5,1728,22,531,22,8,1,8,Financial Pressure,2,531,28,2021-03-30 19:05:04,2021-03-31 17:14:29.234976
1823,1729,6,1729,27,531,27,9,1,9,Faculty & Staff Support,2,531,28,2021-03-30 19:05:04,2021-03-31 17:14:29.234976
1824,1730,6,1730,32,531,32,10,1,10,Friendships,2,531,28,2021-03-30 19:05:04,2021-03-31 17:14:29.234976
1825,1731,1,1731,18,532,18,6,1,6,Life - School Balance,2,532,30,2021-03-30 19:05:04,2021-03-30 19:06:15.970363
1826,1732,6,1732,19,532,19,7,0,7,Discrimination,2,532,30,2021-03-30 19:05:04,2021-03-30 19:06:15.970363
1827,1733,4,1733,22,532,22,8,1,8,Financial Pressure,2,532,30,2021-03-30 19:05:04,2021-03-30 19:06:15.970363
1828,1734,3,1734,28,532,28,9,1,9,Faculty & Staff Support,2,532,30,2021-03-30 19:05:04,2021-03-30 19:06:15.970363
1829,1735,4,1735,31,532,31,10,1,10,Friendships,2,532,30,2021-03-30 19:05:04,2021-03-30 19:06:15.970363
1830,1741,4,1741,18,534,18,6,1,6,Life - School Balance,2,534,32,2021-03-30 19:05:04,2021-03-30 19:05:50.740216
1831,1742,6,1742,19,534,19,7,0,7,Discrimination,2,534,32,2021-03-30 19:05:04,2021-03-30 19:05:50.740216
1832,1743,6,1743,23,534,23,8,1,8,Financial Pressure,2,534,32,2021-03-30 19:05:04,2021-03-30 19:05:50.740216
1833,1744,4,1744,28,534,28,9,1,9,Faculty & Staff Support,2,534,32,2021-03-30 19:05:04,2021-03-30 19:05:50.740216
1834,1745,3,1745,30,534,30,10,1,10,Friendships,2,534,32,2021-03-30 19:05:04,2021-03-30 19:05:50.740216
1835,1756,3,1756,18,537,18,6,1,6,Life - School Balance,2,537,36,2021-03-30 19:05:05,2021-03-30 19:46:26.027667
1836,1757,3,1757,19,537,19,7,0,7,Discrimination,2,537,36,2021-03-30 19:05:05,2021-03-30 19:46:26.027667
1837,1758,5,1758,23,537,23,8,1,8,Financial Pressure,2,537,36,2021-03-30 19:05:05,2021-03-30 19:46:26.027667
1838,1759,4,1759,26,537,26,9,1,9,Faculty & Staff Support,2,537,36,2021-03-30 19:05:05,2021-03-30 19:46:26.027667
1839,1760,4,1760,33,537,33,10,0,10,Friendships,2,537,36,2021-03-30 19:05:05,2021-03-30 19:46:26.027667
1840,1766,5,1766,18,539,18,6,1,6,Life - School Balance,2,539,41,2021-03-30 19:05:05,2021-03-30 20:07:56.599892
1841,1767,5,1767,19,539,19,7,0,7,Discrimination,2,539,41,2021-03-30 19:05:05,2021-03-30 20:07:56.599892
1842,1768,4,1768,25,539,25,8,0,8,Financial Pressure,2,539,41,2021-03-30 19:05:05,2021-03-30 20:07:56.599892
1843,1769,5,1769,29,539,29,9,0,9,Faculty & Staff Support,2,539,41,2021-03-30 19:05:05,2021-03-30 20:07:56.599892
1844,1770,5,1770,30,539,30,10,1,10,Friendships,2,539,41,2021-03-30 19:05:05,2021-03-30 20:07:56.599892
1845,1771,4,1771,18,540,18,6,1,6,Life - School Balance,2,540,42,2021-03-30 19:05:05,2021-03-30 19:05:51.602948
1846,1772,5,1772,19,540,19,7,0,7,Discrimination,2,540,42,2021-03-30 19:05:05,2021-03-30 19:05:51.602948
1847,1773,2,1773,25,540,25,8,0,8,Financial Pressure,2,540,42,2021-03-30 19:05:05,2021-03-30 19:05:51.602948
1848,1774,5,1774,28,540,28,9,1,9,Faculty & Staff Support,2,540,42,2021-03-30 19:05:05,2021-03-30 19:05:51.602948
1849,1775,5,1775,33,540,33,10,0,10,Friendships,2,540,42,2021-03-30 19:05:05,2021-03-30 19:05:51.602948
1850,1776,4,1776,18,541,18,6,1,6,Life - School Balance,2,541,44,2021-03-30 19:05:05,2021-03-30 19:06:05.720063
1851,1777,5,1777,19,541,19,7,0,7,Discrimination,2,541,44,2021-03-30 19:05:05,2021-03-30 19:06:05.720063
1852,1778,4,1778,24,541,24,8,1,8,Financial Pressure,2,541,44,2021-03-30 19:05:05,2021-03-30 19:06:05.720063
1853,1779,4,1779,27,541,27,9,1,9,Faculty & Staff Support,2,541,44,2021-03-30 19:05:05,2021-03-30 19:06:05.720063
1854,1780,5,1780,30,541,30,10,1,10,Friendships,2,541,44,2021-03-30 19:05:05,2021-03-30 19:06:05.720063
1855,1801,4,1801,18,546,18,6,1,6,Life - School Balance,2,546,49,2021-03-30 19:05:06,2021-03-31 01:09:54.403729
1856,1802,4,1802,21,546,21,7,1,7,Discrimination,2,546,49,2021-03-30 19:05:06,2021-03-31 01:09:54.403729
1857,1803,4,1803,24,546,24,8,1,8,Financial Pressure,2,546,49,2021-03-30 19:05:06,2021-03-31 01:09:54.403729
1858,1804,5,1804,29,546,29,9,0,9,Faculty & Staff Support,2,546,49,2021-03-30 19:05:06,2021-03-31 01:09:54.403729
1859,1805,4,1805,31,546,31,10,1,10,Friendships,2,546,49,2021-03-30 19:05:06,2021-03-31 01:09:54.403729
1860,1841,4,1841,18,554,18,6,1,6,Life - School Balance,2,554,61,2021-03-30 19:05:07,2021-03-30 19:07:13.757308
1861,1842,4,1842,19,554,19,7,0,7,Discrimination,2,554,61,2021-03-30 19:05:07,2021-03-30 19:07:13.757308
1862,1843,3,1843,23,554,23,8,1,8,Financial Pressure,2,554,61,2021-03-30 19:05:07,2021-03-30 19:07:13.757308
1863,1844,4,1844,29,554,29,9,0,9,Faculty & Staff Support,2,554,61,2021-03-30 19:05:07,2021-03-30 19:07:13.757308
1864,1845,5,1845,33,554,33,10,0,10,Friendships,2,554,61,2021-03-30 19:05:07,2021-03-30 19:07:13.757308
1865,1861,5,1861,18,558,18,6,1,6,Life - School Balance,2,558,66,2021-03-30 19:05:08,2021-03-30 19:27:13.783472
1866,1862,5,1862,20,558,20,7,1,7,Discrimination,2,558,66,2021-03-30 19:05:08,2021-03-30 19:27:13.783472
1867,1863,6,1863,23,558,23,8,1,8,Financial Pressure,2,558,66,2021-03-30 19:05:08,2021-03-30 19:27:13.783472
1868,1864,5,1864,27,558,27,9,1,9,Faculty & Staff Support,2,558,66,2021-03-30 19:05:08,2021-03-30 19:27:13.783472
1869,1865,6,1865,31,558,31,10,1,10,Friendships,2,558,66,2021-03-30 19:05:08,2021-03-30 19:27:13.783472
1870,1866,5,1866,18,559,18,6,1,6,Life - School Balance,2,559,67,2021-03-30 19:05:08,2021-03-30 20:17:59.433472
1871,1867,3,1867,19,559,19,7,0,7,Discrimination,2,559,67,2021-03-30 19:05:08,2021-03-30 20:17:59.433472
1872,1868,6,1868,24,559,24,8,1,8,Financial Pressure,2,559,67,2021-03-30 19:05:08,2021-03-30 20:17:59.433472
1873,1869,4,1869,28,559,28,9,1,9,Faculty & Staff Support,2,559,67,2021-03-30 19:05:08,2021-03-30 20:17:59.433472
1874,1870,3,1870,32,559,32,10,1,10,Friendships,2,559,67,2021-03-30 19:05:08,2021-03-30 20:17:59.433472
1875,1871,2,1871,18,560,18,6,1,6,Life - School Balance,2,560,68,2021-03-30 19:05:08,2021-03-30 19:14:04.318610
1876,1872,4,1872,20,560,20,7,1,7,Discrimination,2,560,68,2021-03-30 19:05:08,2021-03-30 19:14:04.318610
1877,1873,3,1873,22,560,22,8,1,8,Financial Pressure,2,560,68,2021-03-30 19:05:08,2021-03-30 19:14:04.318610
1878,1874,5,1874,28,560,28,9,1,9,Faculty & Staff Support,2,560,68,2021-03-30 19:05:08,2021-03-30 19:14:04.318610
1879,1875,3,1875,30,560,30,10,1,10,Friendships,2,560,68,2021-03-30 19:05:08,2021-03-30 19:14:04.318610
1880,1881,3,1881,18,562,18,6,1,6,Life - School Balance,2,562,70,2021-03-30 19:05:09,2021-03-30 19:45:22.046922
1881,1882,4,1882,21,562,21,7,1,7,Discrimination,2,562,70,2021-03-30 19:05:09,2021-03-30 19:45:22.046922
1882,1883,3,1883,25,562,25,8,0,8,Financial Pressure,2,562,70,2021-03-30 19:05:09,2021-03-30 19:45:22.046922
1883,1884,4,1884,26,562,26,9,1,9,Faculty & Staff Support,2,562,70,2021-03-30 19:05:09,2021-03-30 19:45:22.046922
1884,1885,4,1885,32,562,32,10,1,10,Friendships,2,562,70,2021-03-30 19:05:09,2021-03-30 19:45:22.046922
1885,1911,2,1911,18,568,18,6,1,6,Life - School Balance,2,568,76,2021-03-30 19:05:10,2021-03-30 23:19:47.547453
1886,1912,4,1912,20,568,20,7,1,7,Discrimination,2,568,76,2021-03-30 19:05:10,2021-03-30 23:19:47.547453
1887,1913,5,1913,25,568,25,8,0,8,Financial Pressure,2,568,76,2021-03-30 19:05:10,2021-03-30 23:19:47.547453
1888,1914,5,1914,27,568,27,9,1,9,Faculty & Staff Support,2,568,76,2021-03-30 19:05:10,2021-03-30 23:19:47.547453
1889,1915,3,1915,32,568,32,10,1,10,Friendships,2,568,76,2021-03-30 19:05:10,2021-03-30 23:19:47.547453
1890,1916,3,1916,18,569,18,6,1,6,Life - School Balance,2,569,77,2021-03-30 19:05:10,2021-03-30 19:13:26.679580
1891,1917,5,1917,19,569,19,7,0,7,Discrimination,2,569,77,2021-03-30 19:05:10,2021-03-30 19:13:26.679580
1892,1918,4,1918,25,569,25,8,0,8,Financial Pressure,2,569,77,2021-03-30 19:05:10,2021-03-30 19:13:26.679580
1893,1919,5,1919,27,569,27,9,1,9,Faculty & Staff Support,2,569,77,2021-03-30 19:05:10,2021-03-30 19:13:26.679580
1894,1920,3,1920,32,569,32,10,1,10,Friendships,2,569,77,2021-03-30 19:05:10,2021-03-30 19:13:26.679580
1895,1921,3,1921,18,570,18,6,1,6,Life - School Balance,2,570,78,2021-03-30 19:05:10,2021-03-30 19:07:16.863335
1896,1922,5,1922,21,570,21,7,1,7,Discrimination,2,570,78,2021-03-30 19:05:10,2021-03-30 19:07:16.863335
1897,1923,2,1923,24,570,24,8,1,8,Financial Pressure,2,570,78,2021-03-30 19:05:10,2021-03-30 19:07:16.863335
1898,1924,4,1924,28,570,28,9,1,9,Faculty & Staff Support,2,570,78,2021-03-30 19:05:10,2021-03-30 19:07:16.863335
1899,1925,6,1925,33,570,33,10,0,10,Friendships,2,570,78,2021-03-30 19:05:10,2021-03-30 19:07:16.863335
1900,1926,4,1926,18,571,18,6,1,6,Life - School Balance,2,571,79,2021-03-30 19:05:10,2021-03-30 23:06:52.389519
1901,1927,5,1927,21,571,21,7,1,7,Discrimination,2,571,79,2021-03-30 19:05:10,2021-03-30 23:06:52.389519
1902,1928,4,1928,23,571,23,8,1,8,Financial Pressure,2,571,79,2021-03-30 19:05:10,2021-03-30 23:06:52.389519
1903,1929,6,1929,28,571,28,9,1,9,Faculty & Staff Support,2,571,79,2021-03-30 19:05:10,2021-03-30 23:06:52.389519
1904,1930,4,1930,30,571,30,10,1,10,Friendships,2,571,79,2021-03-30 19:05:10,2021-03-30 23:06:52.389519
1905,1956,6,1956,18,577,18,6,1,6,Life - School Balance,2,577,89,2021-03-30 19:05:11,2021-03-30 19:08:09.618225
1906,1957,6,1957,19,577,19,7,0,7,Discrimination,2,577,89,2021-03-30 19:05:11,2021-03-30 19:08:09.618225
1907,1958,4,1958,24,577,24,8,1,8,Financial Pressure,2,577,89,2021-03-30 19:05:11,2021-03-30 19:08:09.618225
1908,1959,6,1959,27,577,27,9,1,9,Faculty & Staff Support,2,577,89,2021-03-30 19:05:11,2021-03-30 19:08:09.618225
1909,1960,6,1960,30,577,30,10,1,10,Friendships,2,577,89,2021-03-30 19:05:11,2021-03-30 19:08:09.618225
1910,1991,4,1991,18,584,18,6,1,6,Life - School Balance,2,584,98,2021-03-30 19:05:12,2021-03-30 19:49:56.887852
1911,1992,3,1992,20,584,20,7,1,7,Discrimination,2,584,98,2021-03-30 19:05:12,2021-03-30 19:49:56.887852
1912,1993,4,1993,24,584,24,8,1,8,Financial Pressure,2,584,98,2021-03-30 19:05:12,2021-03-30 19:49:56.887852
1913,1994,3,1994,26,584,26,9,1,9,Faculty & Staff Support,2,584,98,2021-03-30 19:05:12,2021-03-30 19:49:56.887852
1914,1995,3,1995,33,584,33,10,0,10,Friendships,2,584,98,2021-03-30 19:05:12,2021-03-30 19:49:56.887852
1915,2001,4,2001,18,586,18,6,1,6,Life - School Balance,2,586,100,2021-03-30 19:05:12,2021-03-30 19:10:14.106361
1916,2002,5,2002,20,586,20,7,1,7,Discrimination,2,586,100,2021-03-30 19:05:12,2021-03-30 19:10:14.106361
1917,2003,3,2003,23,586,23,8,1,8,Financial Pressure,2,586,100,2021-03-30 19:05:12,2021-03-30 19:10:14.106361
1918,2004,5,2004,26,586,26,9,1,9,Faculty & Staff Support,2,586,100,2021-03-30 19:05:12,2021-03-30 19:10:14.106361
1919,2005,5,2005,32,586,32,10,1,10,Friendships,2,586,100,2021-03-30 19:05:12,2021-03-30 19:10:14.106361
1920,2021,4,2021,18,590,18,6,1,6,Life - School Balance,2,590,105,2021-03-30 19:05:13,2021-03-30 19:06:48.437977
1921,2022,3,2022,20,590,20,7,1,7,Discrimination,2,590,105,2021-03-30 19:05:13,2021-03-30 19:06:48.437977
1922,2023,5,2023,22,590,22,8,1,8,Financial Pressure,2,590,105,2021-03-30 19:05:13,2021-03-30 19:06:48.437977
1923,2024,4,2024,26,590,26,9,1,9,Faculty & Staff Support,2,590,105,2021-03-30 19:05:13,2021-03-30 19:06:48.437977
1924,2025,5,2025,31,590,31,10,1,10,Friendships,2,590,105,2021-03-30 19:05:13,2021-03-30 19:06:48.437977
1925,2051,4,2051,18,596,18,6,1,6,Life - School Balance,2,596,6,2021-04-01 14:05:02,2021-04-01 14:51:05.406614
1926,2052,4,2052,20,596,20,7,1,7,Discrimination,2,596,6,2021-04-01 14:05:02,2021-04-01 14:51:05.406614
1927,2053,6,2053,24,596,24,8,1,8,Financial Pressure,2,596,6,2021-04-01 14:05:02,2021-04-01 14:51:05.406614
1928,2054,5,2054,28,596,28,9,1,9,Faculty & Staff Support,2,596,6,2021-04-01 14:05:02,2021-04-01 14:51:05.406614
1929,2055,4,2055,32,596,32,10,1,10,Friendships,2,596,6,2021-04-01 14:05:02,2021-04-01 14:51:05.406614
1930,2081,3,2081,18,602,18,6,1,6,Life - School Balance,2,602,17,2021-04-01 14:05:03,2021-04-01 14:36:18.349710
1931,2082,5,2082,21,602,21,7,1,7,Discrimination,2,602,17,2021-04-01 14:05:03,2021-04-01 14:36:18.349710
1932,2083,6,2083,24,602,24,8,1,8,Financial Pressure,2,602,17,2021-04-01 14:05:03,2021-04-01 14:36:18.349710
1933,2084,4,2084,26,602,26,9,1,9,Faculty & Staff Support,2,602,17,2021-04-01 14:05:03,2021-04-01 14:36:18.349710
1934,2085,4,2085,32,602,32,10,1,10,Friendships,2,602,17,2021-04-01 14:05:03,2021-04-01 14:36:18.349710
1935,2096,4,2096,18,605,18,6,1,6,Life - School Balance,2,605,20,2021-04-01 14:05:03,2021-04-01 15:10:49.545788
1936,2097,5,2097,21,605,21,7,1,7,Discrimination,2,605,20,2021-04-01 14:05:03,2021-04-01 15:10:49.545788
1937,2098,5,2098,23,605,23,8,1,8,Financial Pressure,2,605,20,2021-04-01 14:05:03,2021-04-01 15:10:49.545788
1938,2099,5,2099,26,605,26,9,1,9,Faculty & Staff Support,2,605,20,2021-04-01 14:05:03,2021-04-01 15:10:49.545788
1939,2100,2,2100,33,605,33,10,0,10,Friendships,2,605,20,2021-04-01 14:05:03,2021-04-01 15:10:49.545788
1940,2106,4,2106,18,607,18,6,1,6,Life - School Balance,2,607,23,2021-04-01 14:05:04,2021-04-01 15:03:42.091770
1941,2107,5,2107,19,607,19,7,0,7,Discrimination,2,607,23,2021-04-01 14:05:04,2021-04-01 15:03:42.091770
1942,2108,6,2108,22,607,22,8,1,8,Financial Pressure,2,607,23,2021-04-01 14:05:04,2021-04-01 15:03:42.091770
1943,2109,6,2109,27,607,27,9,1,9,Faculty & Staff Support,2,607,23,2021-04-01 14:05:04,2021-04-01 15:03:42.091770
1944,2110,3,2110,32,607,32,10,1,10,Friendships,2,607,23,2021-04-01 14:05:04,2021-04-01 15:03:42.091770
1945,2121,3,2121,18,610,18,6,1,6,Life - School Balance,2,610,28,2021-04-01 14:05:04,2021-04-01 16:15:47.615773
1946,2122,4,2122,20,610,20,7,1,7,Discrimination,2,610,28,2021-04-01 14:05:04,2021-04-01 16:15:47.615773
1947,2123,5,2123,24,610,24,8,1,8,Financial Pressure,2,610,28,2021-04-01 14:05:04,2021-04-01 16:15:47.615773
1948,2124,6,2124,26,610,26,9,1,9,Faculty & Staff Support,2,610,28,2021-04-01 14:05:04,2021-04-01 16:15:47.615773
1949,2125,6,2125,32,610,32,10,1,10,Friendships,2,610,28,2021-04-01 14:05:04,2021-04-01 16:15:47.615773
1950,2126,1,2126,18,611,18,6,1,6,Life - School Balance,2,611,30,2021-04-01 14:05:04,2021-04-01 14:42:50.230187
1951,2127,6,2127,21,611,21,7,1,7,Discrimination,2,611,30,2021-04-01 14:05:04,2021-04-01 14:42:50.230187
1952,2128,2,2128,22,611,22,8,1,8,Financial Pressure,2,611,30,2021-04-01 14:05:04,2021-04-01 14:42:50.230187
1953,2129,6,2129,29,611,29,9,0,9,Faculty & Staff Support,2,611,30,2021-04-01 14:05:04,2021-04-01 14:42:50.230187
1954,2130,6,2130,30,611,30,10,1,10,Friendships,2,611,30,2021-04-01 14:05:04,2021-04-01 14:42:50.230187
1955,2131,4,2131,18,612,18,6,1,6,Life - School Balance,2,612,31,2021-04-01 14:05:05,2021-04-01 14:06:19.287873
1956,2132,3,2132,20,612,20,7,1,7,Discrimination,2,612,31,2021-04-01 14:05:05,2021-04-01 14:06:19.287873
1957,2133,6,2133,22,612,22,8,1,8,Financial Pressure,2,612,31,2021-04-01 14:05:05,2021-04-01 14:06:19.287873
1958,2134,3,2134,26,612,26,9,1,9,Faculty & Staff Support,2,612,31,2021-04-01 14:05:05,2021-04-01 14:06:19.287873
1959,2135,3,2135,31,612,31,10,1,10,Friendships,2,612,31,2021-04-01 14:05:05,2021-04-01 14:06:19.287873
1960,2171,4,2171,18,620,18,6,1,6,Life - School Balance,2,620,44,2021-04-01 14:05:06,2021-04-01 15:09:31.245481
1961,2172,5,2172,20,620,20,7,1,7,Discrimination,2,620,44,2021-04-01 14:05:06,2021-04-01 15:09:31.245481
1962,2173,4,2173,25,620,25,8,0,8,Financial Pressure,2,620,44,2021-04-01 14:05:06,2021-04-01 15:09:31.245481
1963,2174,4,2174,28,620,28,9,1,9,Faculty & Staff Support,2,620,44,2021-04-01 14:05:06,2021-04-01 15:09:31.245481
1964,2175,5,2175,33,620,33,10,0,10,Friendships,2,620,44,2021-04-01 14:05:06,2021-04-01 15:09:31.245481
1965,2196,4,2196,18,625,18,6,1,6,Life - School Balance,2,625,49,2021-04-01 14:05:07,2021-04-01 18:08:20.136212
1966,2197,4,2197,19,625,19,7,0,7,Discrimination,2,625,49,2021-04-01 14:05:07,2021-04-01 18:08:20.136212
1967,2198,4,2198,23,625,23,8,1,8,Financial Pressure,2,625,49,2021-04-01 14:05:07,2021-04-01 18:08:20.136212
1968,2199,5,2199,29,625,29,9,0,9,Faculty & Staff Support,2,625,49,2021-04-01 14:05:07,2021-04-01 18:08:20.136212
1969,2200,3,2200,30,625,30,10,1,10,Friendships,2,625,49,2021-04-01 14:05:07,2021-04-01 18:08:20.136212
1970,2221,4,2221,18,630,18,6,1,6,Life - School Balance,2,630,57,2021-04-01 14:05:08,2021-04-01 14:06:28.105558
1971,2222,6,2222,20,630,20,7,1,7,Discrimination,2,630,57,2021-04-01 14:05:08,2021-04-01 14:06:28.105558
1972,2223,2,2223,23,630,23,8,1,8,Financial Pressure,2,630,57,2021-04-01 14:05:08,2021-04-01 14:06:28.105558
1973,2224,5,2224,27,630,27,9,1,9,Faculty & Staff Support,2,630,57,2021-04-01 14:05:08,2021-04-01 14:06:28.105558
1974,2225,5,2225,32,630,32,10,1,10,Friendships,2,630,57,2021-04-01 14:05:08,2021-04-01 14:06:28.105558
1975,2231,4,2231,18,632,18,6,1,6,Life - School Balance,2,632,60,2021-04-01 14:05:08,2021-04-01 15:32:21.902847
1976,2232,1,2232,21,632,21,7,1,7,Discrimination,2,632,60,2021-04-01 14:05:08,2021-04-01 15:32:21.902847
1977,2233,5,2233,25,632,25,8,0,8,Financial Pressure,2,632,60,2021-04-01 14:05:08,2021-04-01 15:32:21.902847
1978,2234,4,2234,26,632,26,9,1,9,Faculty & Staff Support,2,632,60,2021-04-01 14:05:08,2021-04-01 15:32:21.902847
1979,2235,4,2235,32,632,32,10,1,10,Friendships,2,632,60,2021-04-01 14:05:08,2021-04-01 15:32:21.902847
1980,2251,4,2251,18,636,18,6,1,6,Life - School Balance,2,636,65,2021-04-01 14:05:09,2021-04-01 14:07:31.034940
1981,2252,5,2252,21,636,21,7,1,7,Discrimination,2,636,65,2021-04-01 14:05:09,2021-04-01 14:07:31.034940
1982,2253,4,2253,22,636,22,8,1,8,Financial Pressure,2,636,65,2021-04-01 14:05:09,2021-04-01 14:07:31.034940
1983,2254,5,2254,26,636,26,9,1,9,Faculty & Staff Support,2,636,65,2021-04-01 14:05:09,2021-04-01 14:07:31.034940
1984,2255,5,2255,32,636,32,10,1,10,Friendships,2,636,65,2021-04-01 14:05:09,2021-04-01 14:07:31.034940
1985,2271,4,2271,18,640,18,6,1,6,Life - School Balance,2,640,69,2021-04-01 14:05:09,2021-04-01 14:47:35.194542
1986,2272,4,2272,20,640,20,7,1,7,Discrimination,2,640,69,2021-04-01 14:05:09,2021-04-01 14:47:35.194542
1987,2273,4,2273,24,640,24,8,1,8,Financial Pressure,2,640,69,2021-04-01 14:05:09,2021-04-01 14:47:35.194542
1988,2274,4,2274,26,640,26,9,1,9,Faculty & Staff Support,2,640,69,2021-04-01 14:05:09,2021-04-01 14:47:35.194542
1989,2275,4,2275,31,640,31,10,1,10,Friendships,2,640,69,2021-04-01 14:05:09,2021-04-01 14:47:35.194542
1990,2281,4,2281,18,642,18,6,1,6,Life - School Balance,2,642,71,2021-04-01 14:05:10,2021-04-01 23:21:56.840620
1991,2282,6,2282,19,642,19,7,0,7,Discrimination,2,642,71,2021-04-01 14:05:10,2021-04-01 23:21:56.840620
1992,2283,4,2283,22,642,22,8,1,8,Financial Pressure,2,642,71,2021-04-01 14:05:10,2021-04-01 23:21:56.840620
1993,2284,4,2284,28,642,28,9,1,9,Faculty & Staff Support,2,642,71,2021-04-01 14:05:10,2021-04-01 23:21:56.840620
1994,2285,4,2285,30,642,30,10,1,10,Friendships,2,642,71,2021-04-01 14:05:10,2021-04-01 23:21:56.840620
1995,2296,4,2296,18,645,18,6,1,6,Life - School Balance,2,645,74,2021-04-01 14:05:10,2021-04-01 14:19:49.658793
1996,2297,6,2297,20,645,20,7,1,7,Discrimination,2,645,74,2021-04-01 14:05:10,2021-04-01 14:19:49.658793
1997,2298,4,2298,22,645,22,8,1,8,Financial Pressure,2,645,74,2021-04-01 14:05:10,2021-04-01 14:19:49.658793
1998,2299,6,2299,29,645,29,9,0,9,Faculty & Staff Support,2,645,74,2021-04-01 14:05:10,2021-04-01 14:19:49.658793
1999,2300,6,2300,30,645,30,10,1,10,Friendships,2,645,74,2021-04-01 14:05:10,2021-04-01 14:19:49.658793
2000,2301,4,2301,18,646,18,6,1,6,Life - School Balance,2,646,75,2021-04-01 14:05:10,2021-04-01 15:29:24.700739
2001,2302,6,2302,20,646,20,7,1,7,Discrimination,2,646,75,2021-04-01 14:05:10,2021-04-01 15:29:24.700739
2002,2303,2,2303,23,646,23,8,1,8,Financial Pressure,2,646,75,2021-04-01 14:05:10,2021-04-01 15:29:24.700739
2003,2304,6,2304,27,646,27,9,1,9,Faculty & Staff Support,2,646,75,2021-04-01 14:05:10,2021-04-01 15:29:24.700739
2004,2305,6,2305,33,646,33,10,0,10,Friendships,2,646,75,2021-04-01 14:05:10,2021-04-01 15:29:24.700739
2005,2356,4,2356,18,657,18,6,1,6,Life - School Balance,2,657,90,2021-04-01 14:05:12,2021-04-01 14:06:58.470057
2006,2357,6,2357,21,657,21,7,1,7,Discrimination,2,657,90,2021-04-01 14:05:12,2021-04-01 14:06:58.470057
2007,2358,6,2358,22,657,22,8,1,8,Financial Pressure,2,657,90,2021-04-01 14:05:12,2021-04-01 14:06:58.470057
2008,2359,6,2359,28,657,28,9,1,9,Faculty & Staff Support,2,657,90,2021-04-01 14:05:12,2021-04-01 14:06:58.470057
2009,2360,5,2360,33,657,33,10,0,10,Friendships,2,657,90,2021-04-01 14:05:12,2021-04-01 14:06:58.470057
2010,2381,4,2381,18,662,18,6,1,6,Life - School Balance,2,662,96,2021-04-01 14:05:13,2021-04-01 17:53:58.546305
2011,2382,5,2382,19,662,19,7,0,7,Discrimination,2,662,96,2021-04-01 14:05:13,2021-04-01 17:53:58.546305
2012,2383,6,2383,24,662,24,8,1,8,Financial Pressure,2,662,96,2021-04-01 14:05:13,2021-04-01 17:53:58.546305
2013,2384,4,2384,26,662,26,9,1,9,Faculty & Staff Support,2,662,96,2021-04-01 14:05:13,2021-04-01 17:53:58.546305
2014,2385,5,2385,32,662,32,10,1,10,Friendships,2,662,96,2021-04-01 14:05:13,2021-04-01 17:53:58.546305
2015,2396,4,2396,18,665,18,6,1,6,Life - School Balance,2,665,100,2021-04-01 14:05:14,2021-04-01 14:34:08.608699
2016,2397,6,2397,19,665,19,7,0,7,Discrimination,2,665,100,2021-04-01 14:05:14,2021-04-01 14:34:08.608699
2017,2398,5,2398,24,665,24,8,1,8,Financial Pressure,2,665,100,2021-04-01 14:05:14,2021-04-01 14:34:08.608699
2018,2399,5,2399,27,665,27,9,1,9,Faculty & Staff Support,2,665,100,2021-04-01 14:05:14,2021-04-01 14:34:08.608699
2019,2400,5,2400,32,665,32,10,1,10,Friendships,2,665,100,2021-04-01 14:05:14,2021-04-01 14:34:08.608699
2020,2411,4,2411,18,668,18,6,1,6,Life - School Balance,2,668,104,2021-04-01 14:05:14,2021-04-01 14:08:24.150768
2021,2412,6,2412,19,668,19,7,0,7,Discrimination,2,668,104,2021-04-01 14:05:14,2021-04-01 14:08:24.150768
2022,2413,2,2413,23,668,23,8,1,8,Financial Pressure,2,668,104,2021-04-01 14:05:14,2021-04-01 14:08:24.150768
2023,2414,4,2414,28,668,28,9,1,9,Faculty & Staff Support,2,668,104,2021-04-01 14:05:14,2021-04-01 14:08:24.150768
2024,2415,6,2415,30,668,30,10,1,10,Friendships,2,668,104,2021-04-01 14:05:14,2021-04-01 14:08:24.150768
2025,2446,5,2446,18,675,18,6,1,6,Life - School Balance,2,675,6,2021-04-06 19:05:01,2021-04-06 19:06:05.607526
2026,2447,6,2447,21,675,21,7,1,7,Discrimination,2,675,6,2021-04-06 19:05:01,2021-04-06 19:06:05.607526
2027,2448,5,2448,25,675,25,8,0,8,Financial Pressure,2,675,6,2021-04-06 19:05:01,2021-04-06 19:06:05.607526
2028,2449,5,2449,29,675,29,9,0,9,Faculty & Staff Support,2,675,6,2021-04-06 19:05:01,2021-04-06 19:06:05.607526
2029,2450,5,2450,32,675,32,10,1,10,Friendships,2,675,6,2021-04-06 19:05:01,2021-04-06 19:06:05.607526
2030,2456,3,2456,18,677,18,6,1,6,Life - School Balance,2,677,10,2021-04-06 19:05:02,2021-04-07 00:14:28.568528
2031,2457,6,2457,19,677,19,7,0,7,Discrimination,2,677,10,2021-04-06 19:05:02,2021-04-07 00:14:28.568528
2032,2458,4,2458,22,677,22,8,1,8,Financial Pressure,2,677,10,2021-04-06 19:05:02,2021-04-07 00:14:28.568528
2033,2459,5,2459,28,677,28,9,1,9,Faculty & Staff Support,2,677,10,2021-04-06 19:05:02,2021-04-07 00:14:28.568528
2034,2460,3,2460,32,677,32,10,1,10,Friendships,2,677,10,2021-04-06 19:05:02,2021-04-07 00:14:28.568528
2035,2486,5,2486,18,683,18,6,1,6,Life - School Balance,2,683,19,2021-04-06 19:05:03,2021-04-06 19:34:08.632614
2036,2487,4,2487,21,683,21,7,1,7,Discrimination,2,683,19,2021-04-06 19:05:03,2021-04-06 19:34:08.632614
2037,2488,5,2488,24,683,24,8,1,8,Financial Pressure,2,683,19,2021-04-06 19:05:03,2021-04-06 19:34:08.632614
2038,2489,5,2489,27,683,27,9,1,9,Faculty & Staff Support,2,683,19,2021-04-06 19:05:03,2021-04-06 19:34:08.632614
2039,2490,5,2490,31,683,31,10,1,10,Friendships,2,683,19,2021-04-06 19:05:03,2021-04-06 19:34:08.632614
2040,2491,4,2491,18,684,18,6,1,6,Life - School Balance,2,684,20,2021-04-06 19:05:03,2021-04-07 12:34:28.137410
2041,2492,4,2492,21,684,21,7,1,7,Discrimination,2,684,20,2021-04-06 19:05:03,2021-04-07 12:34:28.137410
2042,2493,5,2493,22,684,22,8,1,8,Financial Pressure,2,684,20,2021-04-06 19:05:03,2021-04-07 12:34:28.137410
2043,2494,5,2494,27,684,27,9,1,9,Faculty & Staff Support,2,684,20,2021-04-06 19:05:03,2021-04-07 12:34:28.137410
2044,2495,4,2495,30,684,30,10,1,10,Friendships,2,684,20,2021-04-06 19:05:03,2021-04-07 12:34:28.137410
2045,2521,2,2521,18,690,18,6,1,6,Life - School Balance,2,690,30,2021-04-06 19:05:04,2021-04-06 19:06:39.056654
2046,2522,6,2522,19,690,19,7,0,7,Discrimination,2,690,30,2021-04-06 19:05:04,2021-04-06 19:06:39.056654
2047,2523,3,2523,22,690,22,8,1,8,Financial Pressure,2,690,30,2021-04-06 19:05:04,2021-04-06 19:06:39.056654
2048,2524,5,2524,29,690,29,9,0,9,Faculty & Staff Support,2,690,30,2021-04-06 19:05:04,2021-04-06 19:06:39.056654
2049,2525,6,2525,32,690,32,10,1,10,Friendships,2,690,30,2021-04-06 19:05:04,2021-04-06 19:06:39.056654
2050,2531,4,2531,18,692,18,6,1,6,Life - School Balance,2,692,32,2021-04-06 19:05:04,2021-04-07 14:05:24.542432
2051,2532,6,2532,21,692,21,7,1,7,Discrimination,2,692,32,2021-04-06 19:05:04,2021-04-07 14:05:24.542432
2052,2533,6,2533,24,692,24,8,1,8,Financial Pressure,2,692,32,2021-04-06 19:05:04,2021-04-07 14:05:24.542432
2053,2534,4,2534,26,692,26,9,1,9,Faculty & Staff Support,2,692,32,2021-04-06 19:05:04,2021-04-07 14:05:24.542432
2054,2535,4,2535,33,692,33,10,0,10,Friendships,2,692,32,2021-04-06 19:05:04,2021-04-07 14:05:24.542432
2055,2536,4,2536,18,693,18,6,1,6,Life - School Balance,2,693,34,2021-04-06 19:05:04,2021-04-06 19:13:38.552028
2056,2537,4,2537,20,693,20,7,1,7,Discrimination,2,693,34,2021-04-06 19:05:04,2021-04-06 19:13:38.552028
2057,2538,3,2538,24,693,24,8,1,8,Financial Pressure,2,693,34,2021-04-06 19:05:04,2021-04-06 19:13:38.552028
2058,2539,4,2539,29,693,29,9,0,9,Faculty & Staff Support,2,693,34,2021-04-06 19:05:04,2021-04-06 19:13:38.552028
2059,2540,4,2540,31,693,31,10,1,10,Friendships,2,693,34,2021-04-06 19:05:04,2021-04-06 19:13:38.552028
2060,2561,5,2561,18,698,18,6,1,6,Life - School Balance,2,698,42,2021-04-06 19:05:05,2021-04-06 19:05:56.758273
2061,2562,5,2562,20,698,20,7,1,7,Discrimination,2,698,42,2021-04-06 19:05:05,2021-04-06 19:05:56.758273
2062,2563,3,2563,24,698,24,8,1,8,Financial Pressure,2,698,42,2021-04-06 19:05:05,2021-04-06 19:05:56.758273
2063,2564,5,2564,27,698,27,9,1,9,Faculty & Staff Support,2,698,42,2021-04-06 19:05:05,2021-04-06 19:05:56.758273
2064,2565,5,2565,30,698,30,10,1,10,Friendships,2,698,42,2021-04-06 19:05:05,2021-04-06 19:05:56.758273
2065,2566,4,2566,18,699,18,6,1,6,Life - School Balance,2,699,44,2021-04-06 19:05:06,2021-04-06 19:15:04.670261
2066,2567,3,2567,20,699,20,7,1,7,Discrimination,2,699,44,2021-04-06 19:05:06,2021-04-06 19:15:04.670261
2067,2568,3,2568,25,699,25,8,0,8,Financial Pressure,2,699,44,2021-04-06 19:05:06,2021-04-06 19:15:04.670261
2068,2569,5,2569,27,699,27,9,1,9,Faculty & Staff Support,2,699,44,2021-04-06 19:05:06,2021-04-06 19:15:04.670261
2069,2570,5,2570,30,699,30,10,1,10,Friendships,2,699,44,2021-04-06 19:05:06,2021-04-06 19:15:04.670261
2070,2596,4,2596,18,705,18,6,1,6,Life - School Balance,2,705,50,2021-04-06 19:05:07,2021-04-06 20:18:33.723166
2071,2597,4,2597,20,705,20,7,1,7,Discrimination,2,705,50,2021-04-06 19:05:07,2021-04-06 20:18:33.723166
2072,2598,6,2598,24,705,24,8,1,8,Financial Pressure,2,705,50,2021-04-06 19:05:07,2021-04-06 20:18:33.723166
2073,2599,4,2599,26,705,26,9,1,9,Faculty & Staff Support,2,705,50,2021-04-06 19:05:07,2021-04-06 20:18:33.723166
2074,2600,4,2600,32,705,32,10,1,10,Friendships,2,705,50,2021-04-06 19:05:07,2021-04-06 20:18:33.723166
2075,2626,4,2626,18,711,18,6,1,6,Life - School Balance,2,711,60,2021-04-06 19:05:08,2021-04-06 19:08:34.623341
2076,2627,4,2627,21,711,21,7,1,7,Discrimination,2,711,60,2021-04-06 19:05:08,2021-04-06 19:08:34.623341
2077,2628,4,2628,23,711,23,8,1,8,Financial Pressure,2,711,60,2021-04-06 19:05:08,2021-04-06 19:08:34.623341
2078,2629,4,2629,28,711,28,9,1,9,Faculty & Staff Support,2,711,60,2021-04-06 19:05:08,2021-04-06 19:08:34.623341
2079,2630,4,2630,31,711,31,10,1,10,Friendships,2,711,60,2021-04-06 19:05:08,2021-04-06 19:08:34.623341
2080,2646,5,2646,18,715,18,6,1,6,Life - School Balance,2,715,65,2021-04-06 19:05:09,2021-04-07 12:29:13.680780
2081,2647,4,2647,19,715,19,7,0,7,Discrimination,2,715,65,2021-04-06 19:05:09,2021-04-07 12:29:13.680780
2082,2648,3,2648,23,715,23,8,1,8,Financial Pressure,2,715,65,2021-04-06 19:05:09,2021-04-07 12:29:13.680780
2083,2649,5,2649,26,715,26,9,1,9,Faculty & Staff Support,2,715,65,2021-04-06 19:05:09,2021-04-07 12:29:13.680780
2084,2650,4,2650,32,715,32,10,1,10,Friendships,2,715,65,2021-04-06 19:05:09,2021-04-07 12:29:13.680780
2085,2661,3,2661,18,718,18,6,1,6,Life - School Balance,2,718,68,2021-04-06 19:05:09,2021-04-06 19:06:38.525677
2086,2662,4,2662,21,718,21,7,1,7,Discrimination,2,718,68,2021-04-06 19:05:09,2021-04-06 19:06:38.525677
2087,2663,3,2663,22,718,22,8,1,8,Financial Pressure,2,718,68,2021-04-06 19:05:09,2021-04-06 19:06:38.525677
2088,2664,3,2664,28,718,28,9,1,9,Faculty & Staff Support,2,718,68,2021-04-06 19:05:09,2021-04-06 19:06:38.525677
2089,2665,2,2665,31,718,31,10,1,10,Friendships,2,718,68,2021-04-06 19:05:09,2021-04-06 19:06:38.525677
2090,2666,3,2666,18,719,18,6,1,6,Life - School Balance,2,719,69,2021-04-06 19:05:09,2021-04-06 19:06:13.376115
2091,2667,4,2667,21,719,21,7,1,7,Discrimination,2,719,69,2021-04-06 19:05:09,2021-04-06 19:06:13.376115
2092,2668,4,2668,22,719,22,8,1,8,Financial Pressure,2,719,69,2021-04-06 19:05:09,2021-04-06 19:06:13.376115
2093,2669,4,2669,28,719,28,9,1,9,Faculty & Staff Support,2,719,69,2021-04-06 19:05:09,2021-04-06 19:06:13.376115
2094,2670,4,2670,33,719,33,10,0,10,Friendships,2,719,69,2021-04-06 19:05:09,2021-04-06 19:06:13.376115
2095,2676,5,2676,18,721,18,6,1,6,Life - School Balance,2,721,71,2021-04-06 19:05:10,2021-04-06 21:11:38.486946
2096,2677,6,2677,21,721,21,7,1,7,Discrimination,2,721,71,2021-04-06 19:05:10,2021-04-06 21:11:38.486946
2097,2678,3,2678,25,721,25,8,0,8,Financial Pressure,2,721,71,2021-04-06 19:05:10,2021-04-06 21:11:38.486946
2098,2679,5,2679,26,721,26,9,1,9,Faculty & Staff Support,2,721,71,2021-04-06 19:05:10,2021-04-06 21:11:38.486946
2099,2680,5,2680,30,721,30,10,1,10,Friendships,2,721,71,2021-04-06 19:05:10,2021-04-06 21:11:38.486946
2100,2681,4,2681,18,722,18,6,1,6,Life - School Balance,2,722,72,2021-04-06 19:05:10,2021-04-07 13:14:05.058511
2101,2682,4,2682,19,722,19,7,0,7,Discrimination,2,722,72,2021-04-06 19:05:10,2021-04-07 13:14:05.058511
2102,2683,3,2683,23,722,23,8,1,8,Financial Pressure,2,722,72,2021-04-06 19:05:10,2021-04-07 13:14:05.058511
2103,2684,4,2684,26,722,26,9,1,9,Faculty & Staff Support,2,722,72,2021-04-06 19:05:10,2021-04-07 13:14:05.058511
2104,2685,5,2685,30,722,30,10,1,10,Friendships,2,722,72,2021-04-06 19:05:10,2021-04-07 13:14:05.058511
2105,2711,2,2711,18,728,18,6,1,6,Life - School Balance,2,728,78,2021-04-06 19:05:11,2021-04-07 01:17:19.808810
2106,2712,6,2712,19,728,19,7,0,7,Discrimination,2,728,78,2021-04-06 19:05:11,2021-04-07 01:17:19.808810
2107,2713,2,2713,22,728,22,8,1,8,Financial Pressure,2,728,78,2021-04-06 19:05:11,2021-04-07 01:17:19.808810
2108,2714,5,2714,27,728,27,9,1,9,Faculty & Staff Support,2,728,78,2021-04-06 19:05:11,2021-04-07 01:17:19.808810
2109,2715,6,2715,33,728,33,10,0,10,Friendships,2,728,78,2021-04-06 19:05:11,2021-04-07 01:17:19.808810
2110,2716,3,2716,18,729,18,6,1,6,Life - School Balance,2,729,79,2021-04-06 19:05:11,2021-04-06 19:37:01.911303
2111,2717,4,2717,21,729,21,7,1,7,Discrimination,2,729,79,2021-04-06 19:05:11,2021-04-06 19:37:01.911303
2112,2718,4,2718,22,729,22,8,1,8,Financial Pressure,2,729,79,2021-04-06 19:05:11,2021-04-06 19:37:01.911303
2113,2719,6,2719,26,729,26,9,1,9,Faculty & Staff Support,2,729,79,2021-04-06 19:05:11,2021-04-06 19:37:01.911303
2114,2720,4,2720,32,729,32,10,1,10,Friendships,2,729,79,2021-04-06 19:05:11,2021-04-06 19:37:01.911303
2115,2746,6,2746,18,735,18,6,1,6,Life - School Balance,2,735,89,2021-04-06 19:05:12,2021-04-06 19:07:01.486022
2116,2747,5,2747,21,735,21,7,1,7,Discrimination,2,735,89,2021-04-06 19:05:12,2021-04-06 19:07:01.486022
2117,2748,4,2748,24,735,24,8,1,8,Financial Pressure,2,735,89,2021-04-06 19:05:12,2021-04-06 19:07:01.486022
2118,2749,6,2749,28,735,28,9,1,9,Faculty & Staff Support,2,735,89,2021-04-06 19:05:12,2021-04-06 19:07:01.486022
2119,2750,6,2750,30,735,30,10,1,10,Friendships,2,735,89,2021-04-06 19:05:12,2021-04-06 19:07:01.486022
2120,2781,5,2781,18,742,18,6,1,6,Life - School Balance,2,742,98,2021-04-06 19:05:13,2021-04-06 19:17:51.959235
2121,2782,2,2782,20,742,20,7,1,7,Discrimination,2,742,98,2021-04-06 19:05:13,2021-04-06 19:17:51.959235
2122,2783,2,2783,22,742,22,8,1,8,Financial Pressure,2,742,98,2021-04-06 19:05:13,2021-04-06 19:17:51.959235
2123,2784,5,2784,29,742,29,9,0,9,Faculty & Staff Support,2,742,98,2021-04-06 19:05:13,2021-04-06 19:17:51.959235
2124,2785,4,2785,31,742,31,10,1,10,Friendships,2,742,98,2021-04-06 19:05:13,2021-04-06 19:17:51.959235
2125,2786,5,2786,18,743,18,6,1,6,Life - School Balance,2,743,99,2021-04-06 19:05:13,2021-04-06 19:57:29.476813
2126,2787,6,2787,20,743,20,7,1,7,Discrimination,2,743,99,2021-04-06 19:05:13,2021-04-06 19:57:29.476813
2127,2788,1,2788,22,743,22,8,1,8,Financial Pressure,2,743,99,2021-04-06 19:05:13,2021-04-06 19:57:29.476813
2128,2789,6,2789,26,743,26,9,1,9,Faculty & Staff Support,2,743,99,2021-04-06 19:05:13,2021-04-06 19:57:29.476813
2129,2790,6,2790,32,743,32,10,1,10,Friendships,2,743,99,2021-04-06 19:05:13,2021-04-06 19:57:29.476813
2130,2796,4,2796,18,745,18,6,1,6,Life - School Balance,2,745,101,2021-04-06 19:05:14,2021-04-06 19:13:09.457584
2131,2797,6,2797,19,745,19,7,0,7,Discrimination,2,745,101,2021-04-06 19:05:14,2021-04-06 19:13:09.457584
2132,2798,5,2798,23,745,23,8,1,8,Financial Pressure,2,745,101,2021-04-06 19:05:14,2021-04-06 19:13:09.457584
2133,2799,5,2799,29,745,29,9,0,9,Faculty & Staff Support,2,745,101,2021-04-06 19:05:14,2021-04-06 19:13:09.457584
2134,2800,5,2800,32,745,32,10,1,10,Friendships,2,745,101,2021-04-06 19:05:14,2021-04-06 19:13:09.457584
2135,2801,5,2801,18,746,18,6,1,6,Life - School Balance,2,746,103,2021-04-06 19:05:14,2021-04-06 19:06:43.458719
2136,2802,2,2802,21,746,21,7,1,7,Discrimination,2,746,103,2021-04-06 19:05:14,2021-04-06 19:06:43.458719
2137,2803,2,2803,24,746,24,8,1,8,Financial Pressure,2,746,103,2021-04-06 19:05:14,2021-04-06 19:06:43.458719
2138,2804,6,2804,28,746,28,9,1,9,Faculty & Staff Support,2,746,103,2021-04-06 19:05:14,2021-04-06 19:06:43.458719
2139,2805,2,2805,30,746,30,10,1,10,Friendships,2,746,103,2021-04-06 19:05:14,2021-04-06 19:06:43.458719
2140,2841,4,2841,18,754,18,6,1,6,Life - School Balance,2,754,6,2021-04-08 14:05:02,2021-04-08 14:46:03.039139
2141,2842,5,2842,19,754,19,7,0,7,Discrimination,2,754,6,2021-04-08 14:05:02,2021-04-08 14:46:03.039139
2142,2843,6,2843,22,754,22,8,1,8,Financial Pressure,2,754,6,2021-04-08 14:05:02,2021-04-08 14:46:03.039139
2143,2844,5,2844,28,754,28,9,1,9,Faculty & Staff Support,2,754,6,2021-04-08 14:05:02,2021-04-08 14:46:03.039139
2144,2845,5,2845,33,754,33,10,0,10,Friendships,2,754,6,2021-04-08 14:05:02,2021-04-08 14:46:03.039139
2145,2891,2,2891,18,764,18,6,1,6,Life - School Balance,2,764,22,2021-04-08 14:05:04,2021-04-08 20:59:23.000916
2146,2892,6,2892,19,764,19,7,0,7,Discrimination,2,764,22,2021-04-08 14:05:04,2021-04-08 20:59:23.000916
2147,2893,6,2893,25,764,25,8,0,8,Financial Pressure,2,764,22,2021-04-08 14:05:04,2021-04-08 20:59:23.000916
2148,2894,4,2894,28,764,28,9,1,9,Faculty & Staff Support,2,764,22,2021-04-08 14:05:04,2021-04-08 20:59:23.000916
2149,2895,3,2895,33,764,33,10,0,10,Friendships,2,764,22,2021-04-08 14:05:04,2021-04-08 20:59:23.000916
2150,2896,3,2896,18,765,18,6,1,6,Life - School Balance,2,765,23,2021-04-08 14:05:04,2021-04-08 14:36:26.201175
2151,2897,5,2897,19,765,19,7,0,7,Discrimination,2,765,23,2021-04-08 14:05:04,2021-04-08 14:36:26.201175
2152,2898,6,2898,22,765,22,8,1,8,Financial Pressure,2,765,23,2021-04-08 14:05:04,2021-04-08 14:36:26.201175
2153,2899,6,2899,26,765,26,9,1,9,Faculty & Staff Support,2,765,23,2021-04-08 14:05:04,2021-04-08 14:36:26.201175
2154,2900,3,2900,31,765,31,10,1,10,Friendships,2,765,23,2021-04-08 14:05:04,2021-04-08 14:36:26.201175
2155,2901,3,2901,18,766,18,6,1,6,Life - School Balance,2,766,26,2021-04-08 14:05:04,2021-04-08 14:42:54.691594
2156,2902,5,2902,20,766,20,7,1,7,Discrimination,2,766,26,2021-04-08 14:05:04,2021-04-08 14:42:54.691594
2157,2903,4,2903,22,766,22,8,1,8,Financial Pressure,2,766,26,2021-04-08 14:05:04,2021-04-08 14:42:54.691594
2158,2904,6,2904,29,766,29,9,0,9,Faculty & Staff Support,2,766,26,2021-04-08 14:05:04,2021-04-08 14:42:54.691594
2159,2905,5,2905,31,766,31,10,1,10,Friendships,2,766,26,2021-04-08 14:05:04,2021-04-08 14:42:54.691594
2160,2931,4,2931,18,772,18,6,1,6,Life - School Balance,2,772,34,2021-04-08 14:05:05,2021-04-08 14:17:54.512791
2161,2932,4,2932,21,772,21,7,1,7,Discrimination,2,772,34,2021-04-08 14:05:05,2021-04-08 14:17:54.512791
2162,2933,3,2933,25,772,25,8,0,8,Financial Pressure,2,772,34,2021-04-08 14:05:05,2021-04-08 14:17:54.512791
2163,2934,4,2934,26,772,26,9,1,9,Faculty & Staff Support,2,772,34,2021-04-08 14:05:05,2021-04-08 14:17:54.512791
2164,2935,4,2935,31,772,31,10,1,10,Friendships,2,772,34,2021-04-08 14:05:05,2021-04-08 14:17:54.512791
2165,2956,5,2956,18,777,18,6,1,6,Life - School Balance,2,777,42,2021-04-08 14:05:06,2021-04-08 19:29:59.641909
2166,2957,5,2957,21,777,21,7,1,7,Discrimination,2,777,42,2021-04-08 14:05:06,2021-04-08 19:29:59.641909
2167,2958,4,2958,23,777,23,8,1,8,Financial Pressure,2,777,42,2021-04-08 14:05:06,2021-04-08 19:29:59.641909
2168,2959,5,2959,29,777,29,9,0,9,Faculty & Staff Support,2,777,42,2021-04-08 14:05:06,2021-04-08 19:29:59.641909
2169,2960,5,2960,30,777,30,10,1,10,Friendships,2,777,42,2021-04-08 14:05:06,2021-04-08 19:29:59.641909
2170,2971,5,2971,18,780,18,6,1,6,Life - School Balance,2,780,46,2021-04-08 14:05:07,2021-04-08 18:42:22.129969
2171,2972,5,2972,21,780,21,7,1,7,Discrimination,2,780,46,2021-04-08 14:05:07,2021-04-08 18:42:22.129969
2172,2973,2,2973,23,780,23,8,1,8,Financial Pressure,2,780,46,2021-04-08 14:05:07,2021-04-08 18:42:22.129969
2173,2974,5,2974,28,780,28,9,1,9,Faculty & Staff Support,2,780,46,2021-04-08 14:05:07,2021-04-08 18:42:22.129969
2174,2975,5,2975,32,780,32,10,1,10,Friendships,2,780,46,2021-04-08 14:05:07,2021-04-08 18:42:22.129969
2175,2981,3,2981,18,782,18,6,1,6,Life - School Balance,2,782,48,2021-04-08 14:05:07,2021-04-08 21:36:32.176494
2176,2982,5,2982,20,782,20,7,1,7,Discrimination,2,782,48,2021-04-08 14:05:07,2021-04-08 21:36:32.176494
2177,2983,4,2983,24,782,24,8,1,8,Financial Pressure,2,782,48,2021-04-08 14:05:07,2021-04-08 21:36:32.176494
2178,2984,5,2984,28,782,28,9,1,9,Faculty & Staff Support,2,782,48,2021-04-08 14:05:07,2021-04-08 21:36:32.176494
2179,2985,5,2985,30,782,30,10,1,10,Friendships,2,782,48,2021-04-08 14:05:07,2021-04-08 21:36:32.176494
2180,2986,4,2986,18,783,18,6,1,6,Life - School Balance,2,783,49,2021-04-08 14:05:07,2021-04-08 22:52:53.062788
2181,2987,4,2987,20,783,20,7,1,7,Discrimination,2,783,49,2021-04-08 14:05:07,2021-04-08 22:52:53.062788
2182,2988,4,2988,22,783,22,8,1,8,Financial Pressure,2,783,49,2021-04-08 14:05:07,2021-04-08 22:52:53.062788
2183,2989,5,2989,29,783,29,9,0,9,Faculty & Staff Support,2,783,49,2021-04-08 14:05:07,2021-04-08 22:52:53.062788
2184,2990,4,2990,31,783,31,10,1,10,Friendships,2,783,49,2021-04-08 14:05:07,2021-04-08 22:52:53.062788
2185,2991,4,2991,18,784,18,6,1,6,Life - School Balance,2,784,50,2021-04-08 14:05:07,2021-04-08 14:37:43.014684
2186,2992,4,2992,20,784,20,7,1,7,Discrimination,2,784,50,2021-04-08 14:05:07,2021-04-08 14:37:43.014684
2187,2993,6,2993,22,784,22,8,1,8,Financial Pressure,2,784,50,2021-04-08 14:05:07,2021-04-08 14:37:43.014684
2188,2994,4,2994,28,784,28,9,1,9,Faculty & Staff Support,2,784,50,2021-04-08 14:05:07,2021-04-08 14:37:43.014684
2189,2995,4,2995,32,784,32,10,1,10,Friendships,2,784,50,2021-04-08 14:05:07,2021-04-08 14:37:43.014684
2190,3011,4,3011,18,788,18,6,1,6,Life - School Balance,2,788,57,2021-04-08 14:05:08,2021-04-08 14:29:29.407051
2191,3012,6,3012,19,788,19,7,0,7,Discrimination,2,788,57,2021-04-08 14:05:08,2021-04-08 14:29:29.407051
2192,3013,3,3013,24,788,24,8,1,8,Financial Pressure,2,788,57,2021-04-08 14:05:08,2021-04-08 14:29:29.407051
2193,3014,6,3014,29,788,29,9,0,9,Faculty & Staff Support,2,788,57,2021-04-08 14:05:08,2021-04-08 14:29:29.407051
2194,3015,6,3015,30,788,30,10,1,10,Friendships,2,788,57,2021-04-08 14:05:08,2021-04-08 14:29:29.407051
2195,3046,5,3046,18,795,18,6,1,6,Life - School Balance,2,795,66,2021-04-08 14:05:09,2021-04-08 14:07:15.844068
2196,3047,4,3047,21,795,21,7,1,7,Discrimination,2,795,66,2021-04-08 14:05:09,2021-04-08 14:07:15.844068
2197,3048,4,3048,22,795,22,8,1,8,Financial Pressure,2,795,66,2021-04-08 14:05:09,2021-04-08 14:07:15.844068
2198,3049,5,3049,26,795,26,9,1,9,Faculty & Staff Support,2,795,66,2021-04-08 14:05:09,2021-04-08 14:07:15.844068
2199,3050,5,3050,30,795,30,10,1,10,Friendships,2,795,66,2021-04-08 14:05:09,2021-04-08 14:07:15.844068
2200,3061,4,3061,18,798,18,6,1,6,Life - School Balance,2,798,69,2021-04-08 14:05:10,2021-04-08 16:36:04.512441
2201,3062,4,3062,20,798,20,7,1,7,Discrimination,2,798,69,2021-04-08 14:05:10,2021-04-08 16:36:04.512441
2202,3063,4,3063,23,798,23,8,1,8,Financial Pressure,2,798,69,2021-04-08 14:05:10,2021-04-08 16:36:04.512441
2203,3064,4,3064,29,798,29,9,0,9,Faculty & Staff Support,2,798,69,2021-04-08 14:05:10,2021-04-08 16:36:04.512441
2204,3065,4,3065,32,798,32,10,1,10,Friendships,2,798,69,2021-04-08 14:05:10,2021-04-08 16:36:04.512441
2205,3086,4,3086,18,803,18,6,1,6,Life - School Balance,2,803,74,2021-04-08 14:05:12,2021-04-08 14:53:45.272848
2206,3087,6,3087,19,803,19,7,0,7,Discrimination,2,803,74,2021-04-08 14:05:12,2021-04-08 14:53:45.272848
2207,3088,5,3088,24,803,24,8,1,8,Financial Pressure,2,803,74,2021-04-08 14:05:12,2021-04-08 14:53:45.272848
2208,3089,6,3089,28,803,28,9,1,9,Faculty & Staff Support,2,803,74,2021-04-08 14:05:12,2021-04-08 14:53:45.272848
2209,3090,6,3090,30,803,30,10,1,10,Friendships,2,803,74,2021-04-08 14:05:12,2021-04-08 14:53:45.272848
2210,3091,4,3091,18,804,18,6,1,6,Life - School Balance,2,804,75,2021-04-08 14:05:12,2021-04-08 15:06:21.776223
2211,3092,6,3092,21,804,21,7,1,7,Discrimination,2,804,75,2021-04-08 14:05:12,2021-04-08 15:06:21.776223
2212,3093,2,3093,23,804,23,8,1,8,Financial Pressure,2,804,75,2021-04-08 14:05:12,2021-04-08 15:06:21.776223
2213,3094,6,3094,26,804,26,9,1,9,Faculty & Staff Support,2,804,75,2021-04-08 14:05:12,2021-04-08 15:06:21.776223
2214,3095,6,3095,32,804,32,10,1,10,Friendships,2,804,75,2021-04-08 14:05:12,2021-04-08 15:06:21.776223
2215,3106,2,3106,18,807,18,6,1,6,Life - School Balance,2,807,78,2021-04-08 14:05:12,2021-04-08 14:31:02.599790
2216,3107,5,3107,20,807,20,7,1,7,Discrimination,2,807,78,2021-04-08 14:05:12,2021-04-08 14:31:02.599790
2217,3108,2,3108,25,807,25,8,0,8,Financial Pressure,2,807,78,2021-04-08 14:05:12,2021-04-08 14:31:02.599790
2218,3109,5,3109,29,807,29,9,0,9,Faculty & Staff Support,2,807,78,2021-04-08 14:05:12,2021-04-08 14:31:02.599790
2219,3110,6,3110,32,807,32,10,1,10,Friendships,2,807,78,2021-04-08 14:05:12,2021-04-08 14:31:02.599790
2220,3111,4,3111,18,808,18,6,1,6,Life - School Balance,2,808,79,2021-04-08 14:05:12,2021-04-08 22:22:39.024306
2221,3112,5,3112,20,808,20,7,1,7,Discrimination,2,808,79,2021-04-08 14:05:12,2021-04-08 22:22:39.024306
2222,3113,3,3113,25,808,25,8,0,8,Financial Pressure,2,808,79,2021-04-08 14:05:12,2021-04-08 22:22:39.024306
2223,3114,6,3114,27,808,27,9,1,9,Faculty & Staff Support,2,808,79,2021-04-08 14:05:12,2021-04-08 22:22:39.024306
2224,3115,5,3115,32,808,32,10,1,10,Friendships,2,808,79,2021-04-08 14:05:12,2021-04-08 22:22:39.024306
2225,3116,4,3116,18,809,18,6,1,6,Life - School Balance,2,809,84,2021-04-08 14:05:13,2021-04-08 14:29:03.695399
2226,3117,5,3117,20,809,20,7,1,7,Discrimination,2,809,84,2021-04-08 14:05:13,2021-04-08 14:29:03.695399
2227,3118,5,3118,22,809,22,8,1,8,Financial Pressure,2,809,84,2021-04-08 14:05:13,2021-04-08 14:29:03.695399
2228,3119,4,3119,27,809,27,9,1,9,Faculty & Staff Support,2,809,84,2021-04-08 14:05:13,2021-04-08 14:29:03.695399
2229,3120,5,3120,32,809,32,10,1,10,Friendships,2,809,84,2021-04-08 14:05:13,2021-04-08 14:29:03.695399
2230,3126,4,3126,18,811,18,6,1,6,Life - School Balance,2,811,86,2021-04-08 14:05:13,2021-04-08 14:55:53.192216
2231,3127,5,3127,20,811,20,7,1,7,Discrimination,2,811,86,2021-04-08 14:05:13,2021-04-08 14:55:53.192216
2232,3128,4,3128,25,811,25,8,0,8,Financial Pressure,2,811,86,2021-04-08 14:05:13,2021-04-08 14:55:53.192216
2233,3129,5,3129,27,811,27,9,1,9,Faculty & Staff Support,2,811,86,2021-04-08 14:05:13,2021-04-08 14:55:53.192216
2234,3130,5,3130,32,811,32,10,1,10,Friendships,2,811,86,2021-04-08 14:05:13,2021-04-08 14:55:53.192216
2235,3141,6,3141,18,814,18,6,1,6,Life - School Balance,2,814,89,2021-04-08 14:05:13,2021-04-08 14:06:33.929678
2236,3142,5,3142,19,814,19,7,0,7,Discrimination,2,814,89,2021-04-08 14:05:13,2021-04-08 14:06:33.929678
2237,3143,4,3143,24,814,24,8,1,8,Financial Pressure,2,814,89,2021-04-08 14:05:13,2021-04-08 14:06:33.929678
2238,3144,6,3144,28,814,28,9,1,9,Faculty & Staff Support,2,814,89,2021-04-08 14:05:13,2021-04-08 14:06:33.929678
2239,3145,5,3145,33,814,33,10,0,10,Friendships,2,814,89,2021-04-08 14:05:13,2021-04-08 14:06:33.929678
2240,3231,3,3231,18,832,18,6,1,6,Life - School Balance,2,832,5,2021-04-13 19:05:01,2021-04-13 19:10:04.963608
2241,3232,6,3232,19,832,19,7,0,7,Discrimination,2,832,5,2021-04-13 19:05:01,2021-04-13 19:10:04.963608
2242,3233,4,3233,25,832,25,8,0,8,Financial Pressure,2,832,5,2021-04-13 19:05:01,2021-04-13 19:10:04.963608
2243,3234,4,3234,28,832,28,9,1,9,Faculty & Staff Support,2,832,5,2021-04-13 19:05:01,2021-04-13 19:10:04.963608
2244,3235,5,3235,30,832,30,10,1,10,Friendships,2,832,5,2021-04-13 19:05:01,2021-04-13 19:10:04.963608
2245,3271,4,3271,18,840,18,6,1,6,Life - School Balance,2,840,18,2021-04-13 19:05:02,2021-04-13 19:05:36.544873
2246,3272,4,3272,20,840,20,7,1,7,Discrimination,2,840,18,2021-04-13 19:05:02,2021-04-13 19:05:36.544873
2247,3273,6,3273,22,840,22,8,1,8,Financial Pressure,2,840,18,2021-04-13 19:05:02,2021-04-13 19:05:36.544873
2248,3274,5,3274,27,840,27,9,1,9,Faculty & Staff Support,2,840,18,2021-04-13 19:05:02,2021-04-13 19:05:36.544873
2249,3275,4,3275,32,840,32,10,1,10,Friendships,2,840,18,2021-04-13 19:05:02,2021-04-13 19:05:36.544873
2250,3301,3,3301,18,846,18,6,1,6,Life - School Balance,2,846,27,2021-04-13 19:05:03,2021-04-13 19:07:20.227016
2251,3302,5,3302,21,846,21,7,1,7,Discrimination,2,846,27,2021-04-13 19:05:03,2021-04-13 19:07:20.227016
2252,3303,4,3303,22,846,22,8,1,8,Financial Pressure,2,846,27,2021-04-13 19:05:03,2021-04-13 19:07:20.227016
2253,3304,5,3304,26,846,26,9,1,9,Faculty & Staff Support,2,846,27,2021-04-13 19:05:03,2021-04-13 19:07:20.227016
2254,3305,6,3305,31,846,31,10,1,10,Friendships,2,846,27,2021-04-13 19:05:03,2021-04-13 19:07:20.227016
2255,3321,3,3321,18,850,18,6,1,6,Life - School Balance,2,850,32,2021-04-13 19:05:04,2021-04-13 19:06:02.035864
2256,3322,6,3322,21,850,21,7,1,7,Discrimination,2,850,32,2021-04-13 19:05:04,2021-04-13 19:06:02.035864
2257,3323,6,3323,24,850,24,8,1,8,Financial Pressure,2,850,32,2021-04-13 19:05:04,2021-04-13 19:06:02.035864
2258,3324,4,3324,27,850,27,9,1,9,Faculty & Staff Support,2,850,32,2021-04-13 19:05:04,2021-04-13 19:06:02.035864
2259,3325,4,3325,31,850,31,10,1,10,Friendships,2,850,32,2021-04-13 19:05:04,2021-04-13 19:06:02.035864
2260,3336,2,3336,18,853,18,6,1,6,Life - School Balance,2,853,36,2021-04-13 19:05:04,2021-04-14 02:36:24.539007
2261,3337,3,3337,21,853,21,7,1,7,Discrimination,2,853,36,2021-04-13 19:05:04,2021-04-14 02:36:24.539007
2262,3338,5,3338,23,853,23,8,1,8,Financial Pressure,2,853,36,2021-04-13 19:05:04,2021-04-14 02:36:24.539007
2263,3339,4,3339,27,853,27,9,1,9,Faculty & Staff Support,2,853,36,2021-04-13 19:05:04,2021-04-14 02:36:24.539007
2264,3340,4,3340,32,853,32,10,1,10,Friendships,2,853,36,2021-04-13 19:05:04,2021-04-14 02:36:24.539007
2265,3356,4,3356,18,857,18,6,1,6,Life - School Balance,2,857,44,2021-04-13 19:05:05,2021-04-13 19:06:12.171162
2266,3357,5,3357,20,857,20,7,1,7,Discrimination,2,857,44,2021-04-13 19:05:05,2021-04-13 19:06:12.171162
2267,3358,4,3358,25,857,25,8,0,8,Financial Pressure,2,857,44,2021-04-13 19:05:05,2021-04-13 19:06:12.171162
2268,3359,5,3359,27,857,27,9,1,9,Faculty & Staff Support,2,857,44,2021-04-13 19:05:05,2021-04-13 19:06:12.171162
2269,3360,4,3360,31,857,31,10,1,10,Friendships,2,857,44,2021-04-13 19:05:05,2021-04-13 19:06:12.171162
2270,3371,4,3371,18,860,18,6,1,6,Life - School Balance,2,860,47,2021-04-13 19:05:05,2021-04-13 19:06:02.305370
2271,3372,6,3372,20,860,20,7,1,7,Discrimination,2,860,47,2021-04-13 19:05:05,2021-04-13 19:06:02.305370
2272,3373,4,3373,24,860,24,8,1,8,Financial Pressure,2,860,47,2021-04-13 19:05:05,2021-04-13 19:06:02.305370
2273,3374,5,3374,27,860,27,9,1,9,Faculty & Staff Support,2,860,47,2021-04-13 19:05:05,2021-04-13 19:06:02.305370
2274,3375,6,3375,31,860,31,10,1,10,Friendships,2,860,47,2021-04-13 19:05:05,2021-04-13 19:06:02.305370
2275,3386,4,3386,18,863,18,6,1,6,Life - School Balance,2,863,50,2021-04-13 19:05:06,2021-04-13 19:42:41.546836
2276,3387,4,3387,19,863,19,7,0,7,Discrimination,2,863,50,2021-04-13 19:05:06,2021-04-13 19:42:41.546836
2277,3388,5,3388,25,863,25,8,0,8,Financial Pressure,2,863,50,2021-04-13 19:05:06,2021-04-13 19:42:41.546836
2278,3389,4,3389,27,863,27,9,1,9,Faculty & Staff Support,2,863,50,2021-04-13 19:05:06,2021-04-13 19:42:41.546836
2279,3390,1,3390,31,863,31,10,1,10,Friendships,2,863,50,2021-04-13 19:05:06,2021-04-13 19:42:41.546836
2280,3431,4,3431,18,872,18,6,1,6,Life - School Balance,2,872,64,2021-04-13 19:05:07,2021-04-13 19:10:37.913770
2281,3432,4,3432,20,872,20,7,1,7,Discrimination,2,872,64,2021-04-13 19:05:07,2021-04-13 19:10:37.913770
2282,3433,3,3433,25,872,25,8,0,8,Financial Pressure,2,872,64,2021-04-13 19:05:07,2021-04-13 19:10:37.913770
2283,3434,4,3434,28,872,28,9,1,9,Faculty & Staff Support,2,872,64,2021-04-13 19:05:07,2021-04-13 19:10:37.913770
2284,3435,5,3435,32,872,32,10,1,10,Friendships,2,872,64,2021-04-13 19:05:07,2021-04-13 19:10:37.913770
2285,3441,5,3441,18,874,18,6,1,6,Life - School Balance,2,874,66,2021-04-13 19:05:08,2021-04-13 19:24:08.199557
2286,3442,5,3442,19,874,19,7,0,7,Discrimination,2,874,66,2021-04-13 19:05:08,2021-04-13 19:24:08.199557
2287,3443,3,3443,23,874,23,8,1,8,Financial Pressure,2,874,66,2021-04-13 19:05:08,2021-04-13 19:24:08.199557
2288,3444,3,3444,28,874,28,9,1,9,Faculty & Staff Support,2,874,66,2021-04-13 19:05:08,2021-04-13 19:24:08.199557
2289,3445,5,3445,32,874,32,10,1,10,Friendships,2,874,66,2021-04-13 19:05:08,2021-04-13 19:24:08.199557
2290,3446,4,3446,18,875,18,6,1,6,Life - School Balance,2,875,67,2021-04-13 19:05:08,2021-04-13 22:21:17.245173
2291,3447,3,3447,19,875,19,7,0,7,Discrimination,2,875,67,2021-04-13 19:05:08,2021-04-13 22:21:17.245173
2292,3448,6,3448,24,875,24,8,1,8,Financial Pressure,2,875,67,2021-04-13 19:05:08,2021-04-13 22:21:17.245173
2293,3449,4,3449,29,875,29,9,0,9,Faculty & Staff Support,2,875,67,2021-04-13 19:05:08,2021-04-13 22:21:17.245173
2294,3450,3,3450,33,875,33,10,0,10,Friendships,2,875,67,2021-04-13 19:05:08,2021-04-13 22:21:17.245173
2295,3461,3,3461,18,878,18,6,1,6,Life - School Balance,2,878,70,2021-04-13 19:05:08,2021-04-13 19:06:22.010988
2296,3462,5,3462,20,878,20,7,1,7,Discrimination,2,878,70,2021-04-13 19:05:08,2021-04-13 19:06:22.010988
2297,3463,3,3463,23,878,23,8,1,8,Financial Pressure,2,878,70,2021-04-13 19:05:08,2021-04-13 19:06:22.010988
2298,3464,3,3464,29,878,29,9,0,9,Faculty & Staff Support,2,878,70,2021-04-13 19:05:08,2021-04-13 19:06:22.010988
2299,3465,5,3465,33,878,33,10,0,10,Friendships,2,878,70,2021-04-13 19:05:08,2021-04-13 19:06:22.010988
2300,3471,4,3471,18,880,18,6,1,6,Life - School Balance,2,880,72,2021-04-13 19:05:08,2021-04-13 19:30:02.536772
2301,3472,4,3472,21,880,21,7,1,7,Discrimination,2,880,72,2021-04-13 19:05:08,2021-04-13 19:30:02.536772
2302,3473,3,3473,22,880,22,8,1,8,Financial Pressure,2,880,72,2021-04-13 19:05:08,2021-04-13 19:30:02.536772
2303,3474,5,3474,27,880,27,9,1,9,Faculty & Staff Support,2,880,72,2021-04-13 19:05:08,2021-04-13 19:30:02.536772
2304,3475,5,3475,33,880,33,10,0,10,Friendships,2,880,72,2021-04-13 19:05:08,2021-04-13 19:30:02.536772
2305,3476,6,3476,18,881,18,6,1,6,Life - School Balance,2,881,73,2021-04-13 19:05:09,2021-04-13 23:38:11.905433
2306,3477,6,3477,21,881,21,7,1,7,Discrimination,2,881,73,2021-04-13 19:05:09,2021-04-13 23:38:11.905433
2307,3478,1,3478,23,881,23,8,1,8,Financial Pressure,2,881,73,2021-04-13 19:05:09,2021-04-13 23:38:11.905433
2308,3479,6,3479,27,881,27,9,1,9,Faculty & Staff Support,2,881,73,2021-04-13 19:05:09,2021-04-13 23:38:11.905433
2309,3480,6,3480,33,881,33,10,0,10,Friendships,2,881,73,2021-04-13 19:05:09,2021-04-13 23:38:11.905433
2310,3496,3,3496,18,885,18,6,1,6,Life - School Balance,2,885,77,2021-04-13 19:05:09,2021-04-13 19:19:34.366297
2311,3497,3,3497,21,885,21,7,1,7,Discrimination,2,885,77,2021-04-13 19:05:09,2021-04-13 19:19:34.366297
2312,3498,3,3498,23,885,23,8,1,8,Financial Pressure,2,885,77,2021-04-13 19:05:09,2021-04-13 19:19:34.366297
2313,3499,4,3499,29,885,29,9,0,9,Faculty & Staff Support,2,885,77,2021-04-13 19:05:09,2021-04-13 19:19:34.366297
2314,3500,3,3500,32,885,32,10,1,10,Friendships,2,885,77,2021-04-13 19:05:09,2021-04-13 19:19:34.366297
2315,3506,3,3506,18,887,18,6,1,6,Life - School Balance,2,887,79,2021-04-13 19:05:09,2021-04-13 20:07:00.191491
2316,3507,4,3507,20,887,20,7,1,7,Discrimination,2,887,79,2021-04-13 19:05:09,2021-04-13 20:07:00.191491
2317,3508,4,3508,23,887,23,8,1,8,Financial Pressure,2,887,79,2021-04-13 19:05:09,2021-04-13 20:07:00.191491
2318,3509,6,3509,29,887,29,9,0,9,Faculty & Staff Support,2,887,79,2021-04-13 19:05:09,2021-04-13 20:07:00.191491
2319,3510,6,3510,31,887,31,10,1,10,Friendships,2,887,79,2021-04-13 19:05:09,2021-04-13 20:07:00.191491
2320,3511,3,3511,18,888,18,6,1,6,Life - School Balance,2,888,84,2021-04-13 19:05:10,2021-04-13 19:27:33.971430
2321,3512,5,3512,20,888,20,7,1,7,Discrimination,2,888,84,2021-04-13 19:05:10,2021-04-13 19:27:33.971430
2322,3513,5,3513,22,888,22,8,1,8,Financial Pressure,2,888,84,2021-04-13 19:05:10,2021-04-13 19:27:33.971430
2323,3514,5,3514,29,888,29,9,0,9,Faculty & Staff Support,2,888,84,2021-04-13 19:05:10,2021-04-13 19:27:33.971430
2324,3515,4,3515,30,888,30,10,1,10,Friendships,2,888,84,2021-04-13 19:05:10,2021-04-13 19:27:33.971430
2325,3531,1,3531,18,892,18,6,1,6,Life - School Balance,2,892,88,2021-04-13 19:05:10,2021-04-13 23:16:33.568478
2326,3532,5,3532,20,892,20,7,1,7,Discrimination,2,892,88,2021-04-13 19:05:10,2021-04-13 23:16:33.568478
2327,3533,4,3533,24,892,24,8,1,8,Financial Pressure,2,892,88,2021-04-13 19:05:10,2021-04-13 23:16:33.568478
2328,3534,5,3534,29,892,29,9,0,9,Faculty & Staff Support,2,892,88,2021-04-13 19:05:10,2021-04-13 23:16:33.568478
2329,3535,5,3535,32,892,32,10,1,10,Friendships,2,892,88,2021-04-13 19:05:10,2021-04-13 23:16:33.568478
2330,3541,4,3541,18,894,18,6,1,6,Life - School Balance,2,894,90,2021-04-13 19:05:11,2021-04-13 19:27:42.865761
2331,3542,5,3542,20,894,20,7,1,7,Discrimination,2,894,90,2021-04-13 19:05:11,2021-04-13 19:27:42.865761
2332,3543,4,3543,25,894,25,8,0,8,Financial Pressure,2,894,90,2021-04-13 19:05:11,2021-04-13 19:27:42.865761
2333,3544,5,3544,27,894,27,9,1,9,Faculty & Staff Support,2,894,90,2021-04-13 19:05:11,2021-04-13 19:27:42.865761
2334,3545,5,3545,31,894,31,10,1,10,Friendships,2,894,90,2021-04-13 19:05:11,2021-04-13 19:27:42.865761
2335,3551,3,3551,18,896,18,6,1,6,Life - School Balance,2,896,93,2021-04-13 19:05:11,2021-04-14 00:27:07.770809
2336,3552,6,3552,21,896,21,7,1,7,Discrimination,2,896,93,2021-04-13 19:05:11,2021-04-14 00:27:07.770809
2337,3553,3,3553,23,896,23,8,1,8,Financial Pressure,2,896,93,2021-04-13 19:05:11,2021-04-14 00:27:07.770809
2338,3554,5,3554,29,896,29,9,0,9,Faculty & Staff Support,2,896,93,2021-04-13 19:05:11,2021-04-14 00:27:07.770809
2339,3555,3,3555,33,896,33,10,0,10,Friendships,2,896,93,2021-04-13 19:05:11,2021-04-14 00:27:07.770809
2340,3561,6,3561,18,898,18,6,1,6,Life - School Balance,2,898,95,2021-04-13 19:05:12,2021-04-13 19:14:59.999877
2341,3562,6,3562,21,898,21,7,1,7,Discrimination,2,898,95,2021-04-13 19:05:12,2021-04-13 19:14:59.999877
2342,3563,3,3563,24,898,24,8,1,8,Financial Pressure,2,898,95,2021-04-13 19:05:12,2021-04-13 19:14:59.999877
2343,3564,6,3564,28,898,28,9,1,9,Faculty & Staff Support,2,898,95,2021-04-13 19:05:12,2021-04-13 19:14:59.999877
2344,3565,3,3565,33,898,33,10,0,10,Friendships,2,898,95,2021-04-13 19:05:12,2021-04-13 19:14:59.999877
2345,3576,6,3576,18,901,18,6,1,6,Life - School Balance,2,901,99,2021-04-13 19:05:12,2021-04-13 19:11:51.789287
2346,3577,6,3577,20,901,20,7,1,7,Discrimination,2,901,99,2021-04-13 19:05:12,2021-04-13 19:11:51.789287
2347,3578,1,3578,23,901,23,8,1,8,Financial Pressure,2,901,99,2021-04-13 19:05:12,2021-04-13 19:11:51.789287
2348,3579,6,3579,26,901,26,9,1,9,Faculty & Staff Support,2,901,99,2021-04-13 19:05:12,2021-04-13 19:11:51.789287
2349,3580,6,3580,31,901,31,10,1,10,Friendships,2,901,99,2021-04-13 19:05:12,2021-04-13 19:11:51.789287
2350,3586,3,3586,18,903,18,6,1,6,Life - School Balance,2,903,101,2021-04-13 19:05:12,2021-04-13 19:06:50.758583
2351,3587,5,3587,21,903,21,7,1,7,Discrimination,2,903,101,2021-04-13 19:05:12,2021-04-13 19:06:50.758583
2352,3588,5,3588,25,903,25,8,0,8,Financial Pressure,2,903,101,2021-04-13 19:05:12,2021-04-13 19:06:50.758583
2353,3589,5,3589,27,903,27,9,1,9,Faculty & Staff Support,2,903,101,2021-04-13 19:05:12,2021-04-13 19:06:50.758583
2354,3590,6,3590,33,903,33,10,0,10,Friendships,2,903,101,2021-04-13 19:05:12,2021-04-13 19:06:50.758583
2355,3591,4,3591,18,904,18,6,1,6,Life - School Balance,2,904,103,2021-04-13 19:05:13,2021-04-13 19:06:34.499751
2356,3592,2,3592,20,904,20,7,1,7,Discrimination,2,904,103,2021-04-13 19:05:13,2021-04-13 19:06:34.499751
2357,3593,5,3593,24,904,24,8,1,8,Financial Pressure,2,904,103,2021-04-13 19:05:13,2021-04-13 19:06:34.499751
2358,3594,6,3594,27,904,27,9,1,9,Faculty & Staff Support,2,904,103,2021-04-13 19:05:13,2021-04-13 19:06:34.499751
2359,3595,2,3595,30,904,30,10,1,10,Friendships,2,904,103,2021-04-13 19:05:13,2021-04-13 19:06:34.499751
2360,3596,4,3596,18,905,18,6,1,6,Life - School Balance,2,905,104,2021-04-13 19:05:13,2021-04-13 19:07:05.103182
2361,3597,5,3597,21,905,21,7,1,7,Discrimination,2,905,104,2021-04-13 19:05:13,2021-04-13 19:07:05.103182
2362,3598,3,3598,23,905,23,8,1,8,Financial Pressure,2,905,104,2021-04-13 19:05:13,2021-04-13 19:07:05.103182
2363,3599,6,3599,26,905,26,9,1,9,Faculty & Staff Support,2,905,104,2021-04-13 19:05:13,2021-04-13 19:07:05.103182
2364,3600,3,3600,33,905,33,10,0,10,Friendships,2,905,104,2021-04-13 19:05:13,2021-04-13 19:07:05.103182
2365,3631,5,3631,18,912,18,6,1,6,Life - School Balance,2,912,6,2021-04-15 14:05:02,2021-04-15 14:18:48.477031
2366,3632,5,3632,20,912,20,7,1,7,Discrimination,2,912,6,2021-04-15 14:05:02,2021-04-15 14:18:48.477031
2367,3633,6,3633,24,912,24,8,1,8,Financial Pressure,2,912,6,2021-04-15 14:05:02,2021-04-15 14:18:48.477031
2368,3634,5,3634,26,912,26,9,1,9,Faculty & Staff Support,2,912,6,2021-04-15 14:05:02,2021-04-15 14:18:48.477031
2369,3635,5,3635,31,912,31,10,1,10,Friendships,2,912,6,2021-04-15 14:05:02,2021-04-15 14:18:48.477031
2370,3641,2,3641,18,914,18,6,1,6,Life - School Balance,2,914,10,2021-04-15 14:05:02,2021-04-15 14:05:53.215645
2371,3642,6,3642,19,914,19,7,0,7,Discrimination,2,914,10,2021-04-15 14:05:02,2021-04-15 14:05:53.215645
2372,3643,3,3643,22,914,22,8,1,8,Financial Pressure,2,914,10,2021-04-15 14:05:02,2021-04-15 14:05:53.215645
2373,3644,4,3644,29,914,29,9,0,9,Faculty & Staff Support,2,914,10,2021-04-15 14:05:02,2021-04-15 14:05:53.215645
2374,3645,4,3645,30,914,30,10,1,10,Friendships,2,914,10,2021-04-15 14:05:02,2021-04-15 14:05:53.215645
2375,3646,4,3646,18,915,18,6,1,6,Life - School Balance,2,915,13,2021-04-15 14:05:02,2021-04-15 16:38:25.627204
2376,3647,4,3647,19,915,19,7,0,7,Discrimination,2,915,13,2021-04-15 14:05:02,2021-04-15 16:38:25.627204
2377,3648,5,3648,25,915,25,8,0,8,Financial Pressure,2,915,13,2021-04-15 14:05:02,2021-04-15 16:38:25.627204
2378,3649,4,3649,26,915,26,9,1,9,Faculty & Staff Support,2,915,13,2021-04-15 14:05:02,2021-04-15 16:38:25.627204
2379,3650,5,3650,30,915,30,10,1,10,Friendships,2,915,13,2021-04-15 14:05:02,2021-04-15 16:38:25.627204
2380,3661,1,3661,18,918,18,6,1,6,Life - School Balance,2,918,17,2021-04-15 14:05:03,2021-04-15 16:50:44.676060
2381,3662,6,3662,19,918,19,7,0,7,Discrimination,2,918,17,2021-04-15 14:05:03,2021-04-15 16:50:44.676060
2382,3663,5,3663,23,918,23,8,1,8,Financial Pressure,2,918,17,2021-04-15 14:05:03,2021-04-15 16:50:44.676060
2383,3664,4,3664,29,918,29,9,0,9,Faculty & Staff Support,2,918,17,2021-04-15 14:05:03,2021-04-15 16:50:44.676060
2384,3665,5,3665,31,918,31,10,1,10,Friendships,2,918,17,2021-04-15 14:05:03,2021-04-15 16:50:44.676060
2385,3666,4,3666,18,919,18,6,1,6,Life - School Balance,2,919,18,2021-04-15 14:05:03,2021-04-15 14:05:45.683096
2386,3667,4,3667,20,919,20,7,1,7,Discrimination,2,919,18,2021-04-15 14:05:03,2021-04-15 14:05:45.683096
2387,3668,6,3668,25,919,25,8,0,8,Financial Pressure,2,919,18,2021-04-15 14:05:03,2021-04-15 14:05:45.683096
2388,3669,4,3669,26,919,26,9,1,9,Faculty & Staff Support,2,919,18,2021-04-15 14:05:03,2021-04-15 14:05:45.683096
2389,3670,4,3670,33,919,33,10,0,10,Friendships,2,919,18,2021-04-15 14:05:03,2021-04-15 14:05:45.683096
2390,3686,4,3686,18,923,18,6,1,6,Life - School Balance,2,923,23,2021-04-15 14:05:04,2021-04-15 17:06:00.009422
2391,3687,5,3687,19,923,19,7,0,7,Discrimination,2,923,23,2021-04-15 14:05:04,2021-04-15 17:06:00.009422
2392,3688,6,3688,23,923,23,8,1,8,Financial Pressure,2,923,23,2021-04-15 14:05:04,2021-04-15 17:06:00.009422
2393,3689,6,3689,29,923,29,9,0,9,Faculty & Staff Support,2,923,23,2021-04-15 14:05:04,2021-04-15 17:06:00.009422
2394,3690,4,3690,30,923,30,10,1,10,Friendships,2,923,23,2021-04-15 14:05:04,2021-04-15 17:06:00.009422
2395,3696,4,3696,18,925,18,6,1,6,Life - School Balance,2,925,27,2021-04-15 14:05:04,2021-04-15 14:23:40.112089
2396,3697,5,3697,20,925,20,7,1,7,Discrimination,2,925,27,2021-04-15 14:05:04,2021-04-15 14:23:40.112089
2397,3698,4,3698,22,925,22,8,1,8,Financial Pressure,2,925,27,2021-04-15 14:05:04,2021-04-15 14:23:40.112089
2398,3699,5,3699,28,925,28,9,1,9,Faculty & Staff Support,2,925,27,2021-04-15 14:05:04,2021-04-15 14:23:40.112089
2399,3700,5,3700,32,925,32,10,1,10,Friendships,2,925,27,2021-04-15 14:05:04,2021-04-15 14:23:40.112089
2400,3706,1,3706,18,927,18,6,1,6,Life - School Balance,2,927,30,2021-04-15 14:05:05,2021-04-15 14:16:29.251988
2401,3707,6,3707,19,927,19,7,0,7,Discrimination,2,927,30,2021-04-15 14:05:05,2021-04-15 14:16:29.251988
2402,3708,5,3708,25,927,25,8,0,8,Financial Pressure,2,927,30,2021-04-15 14:05:05,2021-04-15 14:16:29.251988
2403,3709,5,3709,27,927,27,9,1,9,Faculty & Staff Support,2,927,30,2021-04-15 14:05:05,2021-04-15 14:16:29.251988
2404,3710,6,3710,33,927,33,10,0,10,Friendships,2,927,30,2021-04-15 14:05:05,2021-04-15 14:16:29.251988
2405,3711,4,3711,18,928,18,6,1,6,Life - School Balance,2,928,31,2021-04-15 14:05:05,2021-04-15 14:05:58.955233
2406,3712,3,3712,20,928,20,7,1,7,Discrimination,2,928,31,2021-04-15 14:05:05,2021-04-15 14:05:58.955233
2407,3713,5,3713,23,928,23,8,1,8,Financial Pressure,2,928,31,2021-04-15 14:05:05,2021-04-15 14:05:58.955233
2408,3714,3,3714,26,928,26,9,1,9,Faculty & Staff Support,2,928,31,2021-04-15 14:05:05,2021-04-15 14:05:58.955233
2409,3715,3,3715,31,928,31,10,1,10,Friendships,2,928,31,2021-04-15 14:05:05,2021-04-15 14:05:58.955233
2410,3731,2,3731,18,932,18,6,1,6,Life - School Balance,2,932,36,2021-04-15 14:05:06,2021-04-15 16:10:40.410588
2411,3732,4,3732,20,932,20,7,1,7,Discrimination,2,932,36,2021-04-15 14:05:06,2021-04-15 16:10:40.410588
2412,3733,5,3733,22,932,22,8,1,8,Financial Pressure,2,932,36,2021-04-15 14:05:06,2021-04-15 16:10:40.410588
2413,3734,4,3734,29,932,29,9,0,9,Faculty & Staff Support,2,932,36,2021-04-15 14:05:06,2021-04-15 16:10:40.410588
2414,3735,4,3735,31,932,31,10,1,10,Friendships,2,932,36,2021-04-15 14:05:06,2021-04-15 16:10:40.410588
2415,3766,5,3766,18,939,18,6,1,6,Life - School Balance,2,939,47,2021-04-15 14:05:07,2021-04-15 14:35:20.389090
2416,3767,6,3767,20,939,20,7,1,7,Discrimination,2,939,47,2021-04-15 14:05:07,2021-04-15 14:35:20.389090
2417,3768,5,3768,24,939,24,8,1,8,Financial Pressure,2,939,47,2021-04-15 14:05:07,2021-04-15 14:35:20.389090
2418,3769,6,3769,26,939,26,9,1,9,Faculty & Staff Support,2,939,47,2021-04-15 14:05:07,2021-04-15 14:35:20.389090
2419,3770,5,3770,32,939,32,10,1,10,Friendships,2,939,47,2021-04-15 14:05:07,2021-04-15 14:35:20.389090
2420,3791,4,3791,18,944,18,6,1,6,Life - School Balance,2,944,54,2021-04-15 14:05:08,2021-04-15 14:45:52.994068
2421,3792,5,3792,19,944,19,7,0,7,Discrimination,2,944,54,2021-04-15 14:05:08,2021-04-15 14:45:52.994068
2422,3793,4,3793,22,944,22,8,1,8,Financial Pressure,2,944,54,2021-04-15 14:05:08,2021-04-15 14:45:52.994068
2423,3794,6,3794,27,944,27,9,1,9,Faculty & Staff Support,2,944,54,2021-04-15 14:05:08,2021-04-15 14:45:52.994068
2424,3795,5,3795,32,944,32,10,1,10,Friendships,2,944,54,2021-04-15 14:05:08,2021-04-15 14:45:52.994068
2425,3801,4,3801,18,946,18,6,1,6,Life - School Balance,2,946,57,2021-04-15 14:05:08,2021-04-15 14:18:53.838149
2426,3802,6,3802,19,946,19,7,0,7,Discrimination,2,946,57,2021-04-15 14:05:08,2021-04-15 14:18:53.838149
2427,3803,2,3803,23,946,23,8,1,8,Financial Pressure,2,946,57,2021-04-15 14:05:08,2021-04-15 14:18:53.838149
2428,3804,6,3804,29,946,29,9,0,9,Faculty & Staff Support,2,946,57,2021-04-15 14:05:08,2021-04-15 14:18:53.838149
2429,3805,6,3805,30,946,30,10,1,10,Friendships,2,946,57,2021-04-15 14:05:08,2021-04-15 14:18:53.838149
2430,3811,3,3811,18,948,18,6,1,6,Life - School Balance,2,948,60,2021-04-15 14:05:08,2021-04-15 16:23:55.420343
2431,3812,4,3812,20,948,20,7,1,7,Discrimination,2,948,60,2021-04-15 14:05:08,2021-04-15 16:23:55.420343
2432,3813,6,3813,22,948,22,8,1,8,Financial Pressure,2,948,60,2021-04-15 14:05:08,2021-04-15 16:23:55.420343
2433,3814,5,3814,27,948,27,9,1,9,Faculty & Staff Support,2,948,60,2021-04-15 14:05:08,2021-04-15 16:23:55.420343
2434,3815,4,3815,33,948,33,10,0,10,Friendships,2,948,60,2021-04-15 14:05:08,2021-04-15 16:23:55.420343
2435,3836,5,3836,18,953,18,6,1,6,Life - School Balance,2,953,66,2021-04-15 14:05:09,2021-04-15 14:35:37.506344
2436,3837,5,3837,21,953,21,7,1,7,Discrimination,2,953,66,2021-04-15 14:05:09,2021-04-15 14:35:37.506344
2437,3838,3,3838,24,953,24,8,1,8,Financial Pressure,2,953,66,2021-04-15 14:05:09,2021-04-15 14:35:37.506344
2438,3839,5,3839,26,953,26,9,1,9,Faculty & Staff Support,2,953,66,2021-04-15 14:05:09,2021-04-15 14:35:37.506344
2439,3840,5,3840,32,953,32,10,1,10,Friendships,2,953,66,2021-04-15 14:05:09,2021-04-15 14:35:37.506344
2440,3846,2,3846,18,955,18,6,1,6,Life - School Balance,2,955,68,2021-04-15 14:05:10,2021-04-15 14:07:11.986518
2441,3847,6,3847,19,955,19,7,0,7,Discrimination,2,955,68,2021-04-15 14:05:10,2021-04-15 14:07:11.986518
2442,3848,4,3848,24,955,24,8,1,8,Financial Pressure,2,955,68,2021-04-15 14:05:10,2021-04-15 14:07:11.986518
2443,3849,5,3849,26,955,26,9,1,9,Faculty & Staff Support,2,955,68,2021-04-15 14:05:10,2021-04-15 14:07:11.986518
2444,3850,4,3850,30,955,30,10,1,10,Friendships,2,955,68,2021-04-15 14:05:10,2021-04-15 14:07:11.986518
2445,3851,3,3851,18,956,18,6,1,6,Life - School Balance,2,956,69,2021-04-15 14:05:10,2021-04-15 14:06:16.607744
2446,3852,4,3852,19,956,19,7,0,7,Discrimination,2,956,69,2021-04-15 14:05:10,2021-04-15 14:06:16.607744
2447,3853,4,3853,23,956,23,8,1,8,Financial Pressure,2,956,69,2021-04-15 14:05:10,2021-04-15 14:06:16.607744
2448,3854,4,3854,29,956,29,9,0,9,Faculty & Staff Support,2,956,69,2021-04-15 14:05:10,2021-04-15 14:06:16.607744
2449,3855,4,3855,31,956,31,10,1,10,Friendships,2,956,69,2021-04-15 14:05:10,2021-04-15 14:06:16.607744
2450,3866,4,3866,18,959,18,6,1,6,Life - School Balance,2,959,72,2021-04-15 14:05:10,2021-04-15 18:47:50.334193
2451,3867,4,3867,19,959,19,7,0,7,Discrimination,2,959,72,2021-04-15 14:05:10,2021-04-15 18:47:50.334193
2452,3868,4,3868,24,959,24,8,1,8,Financial Pressure,2,959,72,2021-04-15 14:05:10,2021-04-15 18:47:50.334193
2453,3869,4,3869,29,959,29,9,0,9,Faculty & Staff Support,2,959,72,2021-04-15 14:05:10,2021-04-15 18:47:50.334193
2454,3870,5,3870,32,959,32,10,1,10,Friendships,2,959,72,2021-04-15 14:05:10,2021-04-15 18:47:50.334193
2455,3876,4,3876,18,961,18,6,1,6,Life - School Balance,2,961,74,2021-04-15 14:05:11,2021-04-15 16:38:20.438638
2456,3877,6,3877,21,961,21,7,1,7,Discrimination,2,961,74,2021-04-15 14:05:11,2021-04-15 16:38:20.438638
2457,3878,4,3878,22,961,22,8,1,8,Financial Pressure,2,961,74,2021-04-15 14:05:11,2021-04-15 16:38:20.438638
2458,3879,6,3879,27,961,27,9,1,9,Faculty & Staff Support,2,961,74,2021-04-15 14:05:11,2021-04-15 16:38:20.438638
2459,3880,6,3880,33,961,33,10,0,10,Friendships,2,961,74,2021-04-15 14:05:11,2021-04-15 16:38:20.438638
2460,3881,3,3881,18,962,18,6,1,6,Life - School Balance,2,962,75,2021-04-15 14:05:11,2021-04-15 14:53:02.906818
2461,3882,5,3882,19,962,19,7,0,7,Discrimination,2,962,75,2021-04-15 14:05:11,2021-04-15 14:53:02.906818
2462,3883,4,3883,25,962,25,8,0,8,Financial Pressure,2,962,75,2021-04-15 14:05:11,2021-04-15 14:53:02.906818
2463,3884,6,3884,29,962,29,9,0,9,Faculty & Staff Support,2,962,75,2021-04-15 14:05:11,2021-04-15 14:53:02.906818
2464,3885,6,3885,32,962,32,10,1,10,Friendships,2,962,75,2021-04-15 14:05:11,2021-04-15 14:53:02.906818
2465,3886,3,3886,18,963,18,6,1,6,Life - School Balance,2,963,76,2021-04-15 14:05:11,2021-04-15 17:05:17.737617
2466,3887,6,3887,19,963,19,7,0,7,Discrimination,2,963,76,2021-04-15 14:05:11,2021-04-15 17:05:17.737617
2467,3888,3,3888,24,963,24,8,1,8,Financial Pressure,2,963,76,2021-04-15 14:05:11,2021-04-15 17:05:17.737617
2468,3889,4,3889,26,963,26,9,1,9,Faculty & Staff Support,2,963,76,2021-04-15 14:05:11,2021-04-15 17:05:17.737617
2469,3890,4,3890,31,963,31,10,1,10,Friendships,2,963,76,2021-04-15 14:05:11,2021-04-15 17:05:17.737617
2470,3891,3,3891,18,964,18,6,1,6,Life - School Balance,2,964,77,2021-04-15 14:05:11,2021-04-15 16:54:07.802232
2471,3892,6,3892,19,964,19,7,0,7,Discrimination,2,964,77,2021-04-15 14:05:11,2021-04-15 16:54:07.802232
2472,3893,3,3893,22,964,22,8,1,8,Financial Pressure,2,964,77,2021-04-15 14:05:11,2021-04-15 16:54:07.802232
2473,3894,4,3894,28,964,28,9,1,9,Faculty & Staff Support,2,964,77,2021-04-15 14:05:11,2021-04-15 16:54:07.802232
2474,3895,4,3895,30,964,30,10,1,10,Friendships,2,964,77,2021-04-15 14:05:11,2021-04-15 16:54:07.802232
2475,3911,4,3911,18,968,18,6,1,6,Life - School Balance,2,968,85,2021-04-15 14:05:12,2021-04-15 14:08:09.712946
2476,3912,6,3912,21,968,21,7,1,7,Discrimination,2,968,85,2021-04-15 14:05:12,2021-04-15 14:08:09.712946
2477,3913,5,3913,22,968,22,8,1,8,Financial Pressure,2,968,85,2021-04-15 14:05:12,2021-04-15 14:08:09.712946
2478,3914,5,3914,29,968,29,9,0,9,Faculty & Staff Support,2,968,85,2021-04-15 14:05:12,2021-04-15 14:08:09.712946
2479,3915,6,3915,30,968,30,10,1,10,Friendships,2,968,85,2021-04-15 14:05:12,2021-04-15 14:08:09.712946
2480,3976,2,3976,18,981,18,6,1,6,Life - School Balance,2,981,100,2021-04-15 14:05:14,2021-04-15 14:24:51.311763
2481,3977,6,3977,21,981,21,7,1,7,Discrimination,2,981,100,2021-04-15 14:05:14,2021-04-15 14:24:51.311763
2482,3978,6,3978,24,981,24,8,1,8,Financial Pressure,2,981,100,2021-04-15 14:05:14,2021-04-15 14:24:51.311763
2483,3979,6,3979,27,981,27,9,1,9,Faculty & Staff Support,2,981,100,2021-04-15 14:05:14,2021-04-15 14:24:51.311763
2484,3980,4,3980,31,981,31,10,1,10,Friendships,2,981,100,2021-04-15 14:05:14,2021-04-15 14:24:51.311763
2485,4136,3,4136,18,1013,18,6,1,6,Life - School Balance,2,1013,18,2021-04-20 19:05:03,2021-04-20 19:05:53.589191
2486,4137,2,4137,19,1013,19,7,0,7,Discrimination,2,1013,18,2021-04-20 19:05:03,2021-04-20 19:05:53.589191
2487,4138,6,4138,22,1013,22,8,1,8,Financial Pressure,2,1013,18,2021-04-20 19:05:03,2021-04-20 19:05:53.589191
2488,4139,4,4139,27,1013,27,9,1,9,Faculty & Staff Support,2,1013,18,2021-04-20 19:05:03,2021-04-20 19:05:53.589191
2489,4140,4,4140,32,1013,32,10,1,10,Friendships,2,1013,18,2021-04-20 19:05:03,2021-04-20 19:05:53.589191
2490,4146,4,4146,18,1015,18,6,1,6,Life - School Balance,2,1015,20,2021-04-20 19:05:03,2021-04-20 19:43:52.572547
2491,4147,4,4147,20,1015,20,7,1,7,Discrimination,2,1015,20,2021-04-20 19:05:03,2021-04-20 19:43:52.572547
2492,4148,5,4148,25,1015,25,8,0,8,Financial Pressure,2,1015,20,2021-04-20 19:05:03,2021-04-20 19:43:52.572547
2493,4149,4,4149,27,1015,27,9,1,9,Faculty & Staff Support,2,1015,20,2021-04-20 19:05:03,2021-04-20 19:43:52.572547
2494,4150,4,4150,31,1015,31,10,1,10,Friendships,2,1015,20,2021-04-20 19:05:03,2021-04-20 19:43:52.572547
2495,4251,4,4251,18,1036,18,6,1,6,Life - School Balance,2,1036,50,2021-04-20 19:05:06,2021-04-20 20:35:53.219719
2496,4252,3,4252,19,1036,19,7,0,7,Discrimination,2,1036,50,2021-04-20 19:05:06,2021-04-20 20:35:53.219719
2497,4253,6,4253,24,1036,24,8,1,8,Financial Pressure,2,1036,50,2021-04-20 19:05:06,2021-04-20 20:35:53.219719
2498,4254,4,4254,26,1036,26,9,1,9,Faculty & Staff Support,2,1036,50,2021-04-20 19:05:06,2021-04-20 20:35:53.219719
2499,4255,6,4255,30,1036,30,10,1,10,Friendships,2,1036,50,2021-04-20 19:05:06,2021-04-20 20:35:53.219719
2500,4281,3,4281,18,1042,18,6,1,6,Life - School Balance,2,1042,60,2021-04-20 19:05:08,2021-04-20 20:53:57.562349
2501,4282,3,4282,21,1042,21,7,1,7,Discrimination,2,1042,60,2021-04-20 19:05:08,2021-04-20 20:53:57.562349
2502,4283,6,4283,22,1042,22,8,1,8,Financial Pressure,2,1042,60,2021-04-20 19:05:08,2021-04-20 20:53:57.562349
2503,4284,4,4284,27,1042,27,9,1,9,Faculty & Staff Support,2,1042,60,2021-04-20 19:05:08,2021-04-20 20:53:57.562349
2504,4285,4,4285,32,1042,32,10,1,10,Friendships,2,1042,60,2021-04-20 19:05:08,2021-04-20 20:53:57.562349
2505,4301,5,4301,18,1046,18,6,1,6,Life - School Balance,2,1046,65,2021-04-20 19:05:08,2021-04-20 21:23:50.802318
2506,4302,6,4302,19,1046,19,7,0,7,Discrimination,2,1046,65,2021-04-20 19:05:08,2021-04-20 21:23:50.802318
2507,4303,5,4303,25,1046,25,8,0,8,Financial Pressure,2,1046,65,2021-04-20 19:05:08,2021-04-20 21:23:50.802318
2508,4304,6,4304,27,1046,27,9,1,9,Faculty & Staff Support,2,1046,65,2021-04-20 19:05:08,2021-04-20 21:23:50.802318
2509,4305,5,4305,30,1046,30,10,1,10,Friendships,2,1046,65,2021-04-20 19:05:08,2021-04-20 21:23:50.802318
2510,4321,4,4321,18,1050,18,6,1,6,Life - School Balance,2,1050,69,2021-04-20 19:05:09,2021-04-20 19:48:05.359658
2511,4322,4,4322,20,1050,20,7,1,7,Discrimination,2,1050,69,2021-04-20 19:05:09,2021-04-20 19:48:05.359658
2512,4323,4,4323,23,1050,23,8,1,8,Financial Pressure,2,1050,69,2021-04-20 19:05:09,2021-04-20 19:48:05.359658
2513,4324,5,4324,27,1050,27,9,1,9,Faculty & Staff Support,2,1050,69,2021-04-20 19:05:09,2021-04-20 19:48:05.359658
2514,4325,4,4325,33,1050,33,10,0,10,Friendships,2,1050,69,2021-04-20 19:05:09,2021-04-20 19:48:05.359658
2515,4336,4,4336,18,1053,18,6,1,6,Life - School Balance,2,1053,72,2021-04-20 19:05:09,2021-04-20 19:11:56.207146
2516,4337,4,4337,21,1053,21,7,1,7,Discrimination,2,1053,72,2021-04-20 19:05:09,2021-04-20 19:11:56.207146
2517,4338,4,4338,22,1053,22,8,1,8,Financial Pressure,2,1053,72,2021-04-20 19:05:09,2021-04-20 19:11:56.207146
2518,4339,4,4339,26,1053,26,9,1,9,Faculty & Staff Support,2,1053,72,2021-04-20 19:05:09,2021-04-20 19:11:56.207146
2519,4340,5,4340,32,1053,32,10,1,10,Friendships,2,1053,72,2021-04-20 19:05:09,2021-04-20 19:11:56.207146
2520,4361,3,4361,18,1058,18,6,1,6,Life - School Balance,2,1058,77,2021-04-20 19:05:10,2021-04-20 19:54:46.149670
2521,4362,5,4362,19,1058,19,7,0,7,Discrimination,2,1058,77,2021-04-20 19:05:10,2021-04-20 19:54:46.149670
2522,4363,4,4363,24,1058,24,8,1,8,Financial Pressure,2,1058,77,2021-04-20 19:05:10,2021-04-20 19:54:46.149670
2523,4364,4,4364,29,1058,29,9,0,9,Faculty & Staff Support,2,1058,77,2021-04-20 19:05:10,2021-04-20 19:54:46.149670
2524,4365,3,4365,31,1058,31,10,1,10,Friendships,2,1058,77,2021-04-20 19:05:10,2021-04-20 19:54:46.149670
2525,4376,3,4376,18,1061,18,6,1,6,Life - School Balance,2,1061,84,2021-04-20 19:05:10,2021-04-20 19:22:23.526197
2526,4377,6,4377,19,1061,19,7,0,7,Discrimination,2,1061,84,2021-04-20 19:05:10,2021-04-20 19:22:23.526197
2527,4378,5,4378,25,1061,25,8,0,8,Financial Pressure,2,1061,84,2021-04-20 19:05:10,2021-04-20 19:22:23.526197
2528,4379,3,4379,28,1061,28,9,1,9,Faculty & Staff Support,2,1061,84,2021-04-20 19:05:10,2021-04-20 19:22:23.526197
2529,4380,5,4380,33,1061,33,10,0,10,Friendships,2,1061,84,2021-04-20 19:05:10,2021-04-20 19:22:23.526197
2530,4391,4,4391,18,1064,18,6,1,6,Life - School Balance,2,1064,87,2021-04-20 19:05:11,2021-04-20 19:06:40.413551
2531,4392,6,4392,19,1064,19,7,0,7,Discrimination,2,1064,87,2021-04-20 19:05:11,2021-04-20 19:06:40.413551
2532,4393,2,4393,23,1064,23,8,1,8,Financial Pressure,2,1064,87,2021-04-20 19:05:11,2021-04-20 19:06:40.413551
2533,4394,5,4394,26,1064,26,9,1,9,Faculty & Staff Support,2,1064,87,2021-04-20 19:05:11,2021-04-20 19:06:40.413551
2534,4395,4,4395,30,1064,30,10,1,10,Friendships,2,1064,87,2021-04-20 19:05:11,2021-04-20 19:06:40.413551
2535,4396,2,4396,18,1065,18,6,1,6,Life - School Balance,2,1065,88,2021-04-20 19:05:11,2021-04-20 19:33:18.427202
2536,4397,6,4397,21,1065,21,7,1,7,Discrimination,2,1065,88,2021-04-20 19:05:11,2021-04-20 19:33:18.427202
2537,4398,3,4398,25,1065,25,8,0,8,Financial Pressure,2,1065,88,2021-04-20 19:05:11,2021-04-20 19:33:18.427202
2538,4399,5,4399,28,1065,28,9,1,9,Faculty & Staff Support,2,1065,88,2021-04-20 19:05:11,2021-04-20 19:33:18.427202
2539,4400,6,4400,33,1065,33,10,0,10,Friendships,2,1065,88,2021-04-20 19:05:11,2021-04-20 19:33:18.427202
2540,4401,4,4401,18,1066,18,6,1,6,Life - School Balance,2,1066,89,2021-04-20 19:05:11,2021-04-20 19:50:52.242542
2541,4402,5,4402,21,1066,21,7,1,7,Discrimination,2,1066,89,2021-04-20 19:05:11,2021-04-20 19:50:52.242542
2542,4403,5,4403,22,1066,22,8,1,8,Financial Pressure,2,1066,89,2021-04-20 19:05:11,2021-04-20 19:50:52.242542
2543,4404,6,4404,27,1066,27,9,1,9,Faculty & Staff Support,2,1066,89,2021-04-20 19:05:11,2021-04-20 19:50:52.242542
2544,4405,6,4405,30,1066,30,10,1,10,Friendships,2,1066,89,2021-04-20 19:05:11,2021-04-20 19:50:52.242542
2545,4411,6,4411,18,1068,18,6,1,6,Life - School Balance,2,1068,91,2021-04-20 19:05:12,2021-04-20 19:30:24.516708
2546,4412,6,4412,21,1068,21,7,1,7,Discrimination,2,1068,91,2021-04-20 19:05:12,2021-04-20 19:30:24.516708
2547,4413,1,4413,25,1068,25,8,0,8,Financial Pressure,2,1068,91,2021-04-20 19:05:12,2021-04-20 19:30:24.516708
2548,4414,6,4414,27,1068,27,9,1,9,Faculty & Staff Support,2,1068,91,2021-04-20 19:05:12,2021-04-20 19:30:24.516708
2549,4415,6,4415,31,1068,31,10,1,10,Friendships,2,1068,91,2021-04-20 19:05:12,2021-04-20 19:30:24.516708
2550,4421,6,4421,18,1070,18,6,1,6,Life - School Balance,2,1070,94,2021-04-20 19:05:12,2021-04-20 19:08:57.653239
2551,4422,6,4422,21,1070,21,7,1,7,Discrimination,2,1070,94,2021-04-20 19:05:12,2021-04-20 19:08:57.653239
2552,4423,3,4423,23,1070,23,8,1,8,Financial Pressure,2,1070,94,2021-04-20 19:05:12,2021-04-20 19:08:57.653239
2553,4424,6,4424,27,1070,27,9,1,9,Faculty & Staff Support,2,1070,94,2021-04-20 19:05:12,2021-04-20 19:08:57.653239
2554,4425,6,4425,30,1070,30,10,1,10,Friendships,2,1070,94,2021-04-20 19:05:12,2021-04-20 19:08:57.653239
2555,4436,2,4436,18,1073,18,6,1,6,Life - School Balance,2,1073,98,2021-04-20 19:05:12,2021-04-20 19:23:02.972303
2556,4437,2,4437,21,1073,21,7,1,7,Discrimination,2,1073,98,2021-04-20 19:05:12,2021-04-20 19:23:02.972303
2557,4438,5,4438,24,1073,24,8,1,8,Financial Pressure,2,1073,98,2021-04-20 19:05:12,2021-04-20 19:23:02.972303
2558,4439,2,4439,29,1073,29,9,0,9,Faculty & Staff Support,2,1073,98,2021-04-20 19:05:12,2021-04-20 19:23:02.972303
2559,4440,1,4440,30,1073,30,10,1,10,Friendships,2,1073,98,2021-04-20 19:05:12,2021-04-20 19:23:02.972303
2560,4466,3,4466,18,1079,18,6,1,6,Life - School Balance,2,1079,105,2021-04-20 19:05:13,2021-04-21 04:55:47.598229
2561,4467,3,4467,19,1079,19,7,0,7,Discrimination,2,1079,105,2021-04-20 19:05:13,2021-04-21 04:55:47.598229
2562,4468,4,4468,23,1079,23,8,1,8,Financial Pressure,2,1079,105,2021-04-20 19:05:13,2021-04-21 04:55:47.598229
2563,4469,4,4469,29,1079,29,9,0,9,Faculty & Staff Support,2,1079,105,2021-04-20 19:05:13,2021-04-21 04:55:47.598229
2564,4470,4,4470,32,1079,32,10,1,10,Friendships,2,1079,105,2021-04-20 19:05:13,2021-04-21 04:55:47.598229
2565,4491,3,4491,18,1084,18,6,1,6,Life - School Balance,2,1084,5,2021-04-22 14:05:01,2021-04-22 16:15:17.335486
2566,4492,5,4492,20,1084,20,7,1,7,Discrimination,2,1084,5,2021-04-22 14:05:01,2021-04-22 16:15:17.335486
2567,4493,4,4493,24,1084,24,8,1,8,Financial Pressure,2,1084,5,2021-04-22 14:05:01,2021-04-22 16:15:17.335486
2568,4494,4,4494,27,1084,27,9,1,9,Faculty & Staff Support,2,1084,5,2021-04-22 14:05:01,2021-04-22 16:15:17.335486
2569,4495,5,4495,31,1084,31,10,1,10,Friendships,2,1084,5,2021-04-22 14:05:01,2021-04-22 16:15:17.335486
2570,4526,3,4526,18,1091,18,6,1,6,Life - School Balance,2,1091,17,2021-04-22 14:05:02,2021-04-22 15:03:34.405633
2571,4527,6,4527,19,1091,19,7,0,7,Discrimination,2,1091,17,2021-04-22 14:05:02,2021-04-22 15:03:34.405633
2572,4528,6,4528,24,1091,24,8,1,8,Financial Pressure,2,1091,17,2021-04-22 14:05:02,2021-04-22 15:03:34.405633
2573,4529,3,4529,29,1091,29,9,0,9,Faculty & Staff Support,2,1091,17,2021-04-22 14:05:02,2021-04-22 15:03:34.405633
2574,4530,5,4530,33,1091,33,10,0,10,Friendships,2,1091,17,2021-04-22 14:05:02,2021-04-22 15:03:34.405633
2575,4556,3,4556,18,1097,18,6,1,6,Life - School Balance,2,1097,26,2021-04-22 14:05:03,2021-04-22 14:44:14.210233
2576,4557,6,4557,19,1097,19,7,0,7,Discrimination,2,1097,26,2021-04-22 14:05:03,2021-04-22 14:44:14.210233
2577,4558,4,4558,23,1097,23,8,1,8,Financial Pressure,2,1097,26,2021-04-22 14:05:03,2021-04-22 14:44:14.210233
2578,4559,5,4559,28,1097,28,9,1,9,Faculty & Staff Support,2,1097,26,2021-04-22 14:05:03,2021-04-22 14:44:14.210233
2579,4560,5,4560,30,1097,30,10,1,10,Friendships,2,1097,26,2021-04-22 14:05:03,2021-04-22 14:44:14.210233
2580,4576,5,4576,18,1101,18,6,1,6,Life - School Balance,2,1101,31,2021-04-22 14:05:04,2021-04-22 14:11:42.581999
2581,4577,6,4577,21,1101,21,7,1,7,Discrimination,2,1101,31,2021-04-22 14:05:04,2021-04-22 14:11:42.581999
2582,4578,6,4578,22,1101,22,8,1,8,Financial Pressure,2,1101,31,2021-04-22 14:05:04,2021-04-22 14:11:42.581999
2583,4579,3,4579,27,1101,27,9,1,9,Faculty & Staff Support,2,1101,31,2021-04-22 14:05:04,2021-04-22 14:11:42.581999
2584,4580,3,4580,31,1101,31,10,1,10,Friendships,2,1101,31,2021-04-22 14:05:04,2021-04-22 14:11:42.581999
2585,4586,4,4586,18,1103,18,6,1,6,Life - School Balance,2,1103,34,2021-04-22 14:05:04,2021-04-22 14:16:17.843912
2586,4587,3,4587,20,1103,20,7,1,7,Discrimination,2,1103,34,2021-04-22 14:05:04,2021-04-22 14:16:17.843912
2587,4588,4,4588,23,1103,23,8,1,8,Financial Pressure,2,1103,34,2021-04-22 14:05:04,2021-04-22 14:16:17.843912
2588,4589,4,4589,26,1103,26,9,1,9,Faculty & Staff Support,2,1103,34,2021-04-22 14:05:04,2021-04-22 14:16:17.843912
2589,4590,4,4590,31,1103,31,10,1,10,Friendships,2,1103,34,2021-04-22 14:05:04,2021-04-22 14:16:17.843912
2590,4596,2,4596,18,1105,18,6,1,6,Life - School Balance,2,1105,36,2021-04-22 14:05:05,2021-04-22 17:04:07.349258
2591,4597,4,4597,20,1105,20,7,1,7,Discrimination,2,1105,36,2021-04-22 14:05:05,2021-04-22 17:04:07.349258
2592,4598,6,4598,22,1105,22,8,1,8,Financial Pressure,2,1105,36,2021-04-22 14:05:05,2021-04-22 17:04:07.349258
2593,4599,4,4599,28,1105,28,9,1,9,Faculty & Staff Support,2,1105,36,2021-04-22 14:05:05,2021-04-22 17:04:07.349258
2594,4600,4,4600,31,1105,31,10,1,10,Friendships,2,1105,36,2021-04-22 14:05:05,2021-04-22 17:04:07.349258
2595,4616,4,4616,18,1109,18,6,1,6,Life - School Balance,2,1109,44,2021-04-22 14:05:06,2021-04-22 14:24:46.768018
2596,4617,4,4617,19,1109,19,7,0,7,Discrimination,2,1109,44,2021-04-22 14:05:06,2021-04-22 14:24:46.768018
2597,4618,3,4618,25,1109,25,8,0,8,Financial Pressure,2,1109,44,2021-04-22 14:05:06,2021-04-22 14:24:46.768018
2598,4619,4,4619,26,1109,26,9,1,9,Faculty & Staff Support,2,1109,44,2021-04-22 14:05:06,2021-04-22 14:24:46.768018
2599,4620,3,4620,32,1109,32,10,1,10,Friendships,2,1109,44,2021-04-22 14:05:06,2021-04-22 14:24:46.768018
2600,4621,5,4621,18,1110,18,6,1,6,Life - School Balance,2,1110,45,2021-04-22 14:05:06,2021-04-22 14:05:48.099179
2601,4622,6,4622,20,1110,20,7,1,7,Discrimination,2,1110,45,2021-04-22 14:05:06,2021-04-22 14:05:48.099179
2602,4623,1,4623,22,1110,22,8,1,8,Financial Pressure,2,1110,45,2021-04-22 14:05:06,2021-04-22 14:05:48.099179
2603,4624,5,4624,26,1110,26,9,1,9,Faculty & Staff Support,2,1110,45,2021-04-22 14:05:06,2021-04-22 14:05:48.099179
2604,4625,4,4625,30,1110,30,10,1,10,Friendships,2,1110,45,2021-04-22 14:05:06,2021-04-22 14:05:48.099179
2605,4631,4,4631,18,1112,18,6,1,6,Life - School Balance,2,1112,47,2021-04-22 14:05:06,2021-04-22 17:34:39.379378
2606,4632,5,4632,20,1112,20,7,1,7,Discrimination,2,1112,47,2021-04-22 14:05:06,2021-04-22 17:34:39.379378
2607,4633,3,4633,25,1112,25,8,0,8,Financial Pressure,2,1112,47,2021-04-22 14:05:06,2021-04-22 17:34:39.379378
2608,4634,6,4634,27,1112,27,9,1,9,Faculty & Staff Support,2,1112,47,2021-04-22 14:05:06,2021-04-22 17:34:39.379378
2609,4635,5,4635,33,1112,33,10,0,10,Friendships,2,1112,47,2021-04-22 14:05:06,2021-04-22 17:34:39.379378
2610,4651,3,4651,18,1116,18,6,1,6,Life - School Balance,2,1116,52,2021-04-22 14:05:07,2021-04-23 11:40:50.791173
2611,4652,2,4652,19,1116,19,7,0,7,Discrimination,2,1116,52,2021-04-22 14:05:07,2021-04-23 11:40:50.791173
2612,4653,6,4653,22,1116,22,8,1,8,Financial Pressure,2,1116,52,2021-04-22 14:05:07,2021-04-23 11:40:50.791173
2613,4654,6,4654,29,1116,29,9,0,9,Faculty & Staff Support,2,1116,52,2021-04-22 14:05:07,2021-04-23 11:40:50.791173
2614,4655,2,4655,32,1116,32,10,1,10,Friendships,2,1116,52,2021-04-22 14:05:07,2021-04-23 11:40:50.791173
2615,4666,5,4666,18,1119,18,6,1,6,Life - School Balance,2,1119,57,2021-04-22 14:05:07,2021-04-22 14:09:32.787035
2616,4667,5,4667,20,1119,20,7,1,7,Discrimination,2,1119,57,2021-04-22 14:05:07,2021-04-22 14:09:32.787035
2617,4668,3,4668,24,1119,24,8,1,8,Financial Pressure,2,1119,57,2021-04-22 14:05:07,2021-04-22 14:09:32.787035
2618,4669,5,4669,28,1119,28,9,1,9,Faculty & Staff Support,2,1119,57,2021-04-22 14:05:07,2021-04-22 14:09:32.787035
2619,4670,6,4670,32,1119,32,10,1,10,Friendships,2,1119,57,2021-04-22 14:05:07,2021-04-22 14:09:32.787035
2620,4676,3,4676,18,1121,18,6,1,6,Life - School Balance,2,1121,60,2021-04-22 14:05:07,2021-04-22 14:06:06.411355
2621,4677,3,4677,21,1121,21,7,1,7,Discrimination,2,1121,60,2021-04-22 14:05:07,2021-04-22 14:06:06.411355
2622,4678,6,4678,22,1121,22,8,1,8,Financial Pressure,2,1121,60,2021-04-22 14:05:07,2021-04-22 14:06:06.411355
2623,4679,4,4679,26,1121,26,9,1,9,Faculty & Staff Support,2,1121,60,2021-04-22 14:05:07,2021-04-22 14:06:06.411355
2624,4680,3,4680,33,1121,33,10,0,10,Friendships,2,1121,60,2021-04-22 14:05:07,2021-04-22 14:06:06.411355
2625,4691,4,4691,18,1124,18,6,1,6,Life - School Balance,2,1124,64,2021-04-22 14:05:08,2021-04-22 14:09:58.478962
2626,4692,4,4692,20,1124,20,7,1,7,Discrimination,2,1124,64,2021-04-22 14:05:08,2021-04-22 14:09:58.478962
2627,4693,3,4693,25,1124,25,8,0,8,Financial Pressure,2,1124,64,2021-04-22 14:05:08,2021-04-22 14:09:58.478962
2628,4694,4,4694,27,1124,27,9,1,9,Faculty & Staff Support,2,1124,64,2021-04-22 14:05:08,2021-04-22 14:09:58.478962
2629,4695,4,4695,30,1124,30,10,1,10,Friendships,2,1124,64,2021-04-22 14:05:08,2021-04-22 14:09:58.478962
2630,4706,4,4706,18,1127,18,6,1,6,Life - School Balance,2,1127,67,2021-04-22 14:05:08,2021-04-22 14:46:58.452017
2631,4707,4,4707,21,1127,21,7,1,7,Discrimination,2,1127,67,2021-04-22 14:05:08,2021-04-22 14:46:58.452017
2632,4708,6,4708,23,1127,23,8,1,8,Financial Pressure,2,1127,67,2021-04-22 14:05:08,2021-04-22 14:46:58.452017
2633,4709,5,4709,26,1127,26,9,1,9,Faculty & Staff Support,2,1127,67,2021-04-22 14:05:08,2021-04-22 14:46:58.452017
2634,4710,3,4710,33,1127,33,10,0,10,Friendships,2,1127,67,2021-04-22 14:05:08,2021-04-22 14:46:58.452017
2635,4711,1,4711,18,1128,18,6,1,6,Life - School Balance,2,1128,68,2021-04-22 14:05:09,2021-04-22 14:57:49.169633
2636,4712,5,4712,20,1128,20,7,1,7,Discrimination,2,1128,68,2021-04-22 14:05:09,2021-04-22 14:57:49.169633
2637,4713,3,4713,25,1128,25,8,0,8,Financial Pressure,2,1128,68,2021-04-22 14:05:09,2021-04-22 14:57:49.169633
2638,4714,5,4714,26,1128,26,9,1,9,Faculty & Staff Support,2,1128,68,2021-04-22 14:05:09,2021-04-22 14:57:49.169633
2639,4715,3,4715,32,1128,32,10,1,10,Friendships,2,1128,68,2021-04-22 14:05:09,2021-04-22 14:57:49.169633
2640,4721,3,4721,18,1130,18,6,1,6,Life - School Balance,2,1130,70,2021-04-22 14:05:09,2021-04-22 14:27:07.867592
2641,4722,4,4722,21,1130,21,7,1,7,Discrimination,2,1130,70,2021-04-22 14:05:09,2021-04-22 14:27:07.867592
2642,4723,3,4723,22,1130,22,8,1,8,Financial Pressure,2,1130,70,2021-04-22 14:05:09,2021-04-22 14:27:07.867592
2643,4724,4,4724,26,1130,26,9,1,9,Faculty & Staff Support,2,1130,70,2021-04-22 14:05:09,2021-04-22 14:27:07.867592
2644,4725,5,4725,31,1130,31,10,1,10,Friendships,2,1130,70,2021-04-22 14:05:09,2021-04-22 14:27:07.867592
2645,4746,4,4746,18,1135,18,6,1,6,Life - School Balance,2,1135,75,2021-04-22 14:05:10,2021-04-22 14:56:52.703836
2646,4747,6,4747,20,1135,20,7,1,7,Discrimination,2,1135,75,2021-04-22 14:05:10,2021-04-22 14:56:52.703836
2647,4748,4,4748,25,1135,25,8,0,8,Financial Pressure,2,1135,75,2021-04-22 14:05:10,2021-04-22 14:56:52.703836
2648,4749,6,4749,28,1135,28,9,1,9,Faculty & Staff Support,2,1135,75,2021-04-22 14:05:10,2021-04-22 14:56:52.703836
2649,4750,6,4750,33,1135,33,10,0,10,Friendships,2,1135,75,2021-04-22 14:05:10,2021-04-22 14:56:52.703836
2650,4761,2,4761,18,1138,18,6,1,6,Life - School Balance,2,1138,78,2021-04-22 14:05:10,2021-04-22 16:35:35.887255
2651,4762,5,4762,20,1138,20,7,1,7,Discrimination,2,1138,78,2021-04-22 14:05:10,2021-04-22 16:35:35.887255
2652,4763,3,4763,22,1138,22,8,1,8,Financial Pressure,2,1138,78,2021-04-22 14:05:10,2021-04-22 16:35:35.887255
2653,4764,5,4764,26,1138,26,9,1,9,Faculty & Staff Support,2,1138,78,2021-04-22 14:05:10,2021-04-22 16:35:35.887255
2654,4765,6,4765,31,1138,31,10,1,10,Friendships,2,1138,78,2021-04-22 14:05:10,2021-04-22 16:35:35.887255
2655,4766,3,4766,18,1139,18,6,1,6,Life - School Balance,2,1139,79,2021-04-22 14:05:10,2021-04-22 14:07:29.763761
2656,4767,6,4767,19,1139,19,7,0,7,Discrimination,2,1139,79,2021-04-22 14:05:10,2021-04-22 14:07:29.763761
2657,4768,4,4768,23,1139,23,8,1,8,Financial Pressure,2,1139,79,2021-04-22 14:05:10,2021-04-22 14:07:29.763761
2658,4769,6,4769,29,1139,29,9,0,9,Faculty & Staff Support,2,1139,79,2021-04-22 14:05:10,2021-04-22 14:07:29.763761
2659,4770,6,4770,31,1139,31,10,1,10,Friendships,2,1139,79,2021-04-22 14:05:10,2021-04-22 14:07:29.763761
2660,4771,4,4771,18,1140,18,6,1,6,Life - School Balance,2,1140,84,2021-04-22 14:05:11,2021-04-22 14:45:30.618408
2661,4772,6,4772,19,1140,19,7,0,7,Discrimination,2,1140,84,2021-04-22 14:05:11,2021-04-22 14:45:30.618408
2662,4773,4,4773,22,1140,22,8,1,8,Financial Pressure,2,1140,84,2021-04-22 14:05:11,2021-04-22 14:45:30.618408
2663,4774,3,4774,28,1140,28,9,1,9,Faculty & Staff Support,2,1140,84,2021-04-22 14:05:11,2021-04-22 14:45:30.618408
2664,4775,4,4775,32,1140,32,10,1,10,Friendships,2,1140,84,2021-04-22 14:05:11,2021-04-22 14:45:30.618408
2665,4776,2,4776,18,1141,18,6,1,6,Life - School Balance,2,1141,85,2021-04-22 14:05:11,2021-04-22 16:40:10.149442
2666,4777,6,4777,20,1141,20,7,1,7,Discrimination,2,1141,85,2021-04-22 14:05:11,2021-04-22 16:40:10.149442
2667,4778,3,4778,24,1141,24,8,1,8,Financial Pressure,2,1141,85,2021-04-22 14:05:11,2021-04-22 16:40:10.149442
2668,4779,5,4779,27,1141,27,9,1,9,Faculty & Staff Support,2,1141,85,2021-04-22 14:05:11,2021-04-22 16:40:10.149442
2669,4780,6,4780,33,1141,33,10,0,10,Friendships,2,1141,85,2021-04-22 14:05:11,2021-04-22 16:40:10.149442
2670,4801,3,4801,18,1146,18,6,1,6,Life - School Balance,2,1146,90,2021-04-22 14:05:12,2021-04-22 14:47:34.425634
2671,4802,5,4802,21,1146,21,7,1,7,Discrimination,2,1146,90,2021-04-22 14:05:12,2021-04-22 14:47:34.425634
2672,4803,4,4803,22,1146,22,8,1,8,Financial Pressure,2,1146,90,2021-04-22 14:05:12,2021-04-22 14:47:34.425634
2673,4804,6,4804,27,1146,27,9,1,9,Faculty & Staff Support,2,1146,90,2021-04-22 14:05:12,2021-04-22 14:47:34.425634
2674,4805,5,4805,31,1146,31,10,1,10,Friendships,2,1146,90,2021-04-22 14:05:12,2021-04-22 14:47:34.425634
2675,4836,6,4836,18,1153,18,6,1,6,Life - School Balance,2,1153,99,2021-04-22 14:05:13,2021-04-22 19:52:14.610316
2676,4837,6,4837,19,1153,19,7,0,7,Discrimination,2,1153,99,2021-04-22 14:05:13,2021-04-22 19:52:14.610316
2677,4838,1,4838,22,1153,22,8,1,8,Financial Pressure,2,1153,99,2021-04-22 14:05:13,2021-04-22 19:52:14.610316
2678,4839,6,4839,27,1153,27,9,1,9,Faculty & Staff Support,2,1153,99,2021-04-22 14:05:13,2021-04-22 19:52:14.610316
2679,4840,6,4840,30,1153,30,10,1,10,Friendships,2,1153,99,2021-04-22 14:05:13,2021-04-22 19:52:14.610316
2680,4861,3,4861,18,1158,18,6,1,6,Life - School Balance,2,1158,105,2021-04-22 14:05:14,2021-04-22 22:06:53.278046
2681,4862,3,4862,20,1158,20,7,1,7,Discrimination,2,1158,105,2021-04-22 14:05:14,2021-04-22 22:06:53.278046
2682,4863,4,4863,23,1158,23,8,1,8,Financial Pressure,2,1158,105,2021-04-22 14:05:14,2021-04-22 22:06:53.278046
2683,4864,4,4864,27,1158,27,9,1,9,Faculty & Staff Support,2,1158,105,2021-04-22 14:05:14,2021-04-22 22:06:53.278046
2684,4865,4,4865,30,1158,30,10,1,10,Friendships,2,1158,105,2021-04-22 14:05:14,2021-04-22 22:06:53.278046
2685,20081,3,20081,18,2016,18,6,1,6,Life - School Balance,2,2016,5,2021-04-27 19:05:02,2021-04-28 17:55:21.149851
2686,20082,5,20082,20,2016,20,7,1,7,Discrimination,2,2016,5,2021-04-27 19:05:02,2021-04-28 17:55:21.149851
2687,20083,4,20083,23,2016,23,8,1,8,Financial Pressure,2,2016,5,2021-04-27 19:05:02,2021-04-28 17:55:21.149851
2688,20084,5,20084,28,2016,28,9,1,9,Faculty & Staff Support,2,2016,5,2021-04-27 19:05:02,2021-04-28 17:55:21.149851
2689,20085,5,20085,31,2016,31,10,1,10,Friendships,2,2016,5,2021-04-27 19:05:02,2021-04-28 17:55:21.149851
2690,20126,5,20126,18,2025,18,6,1,6,Life - School Balance,2,2025,19,2021-04-27 19:05:03,2021-04-27 21:41:57.511726
2691,20127,5,20127,20,2025,20,7,1,7,Discrimination,2,2025,19,2021-04-27 19:05:03,2021-04-27 21:41:57.511726
2692,20128,3,20128,25,2025,25,8,0,8,Financial Pressure,2,2025,19,2021-04-27 19:05:03,2021-04-27 21:41:57.511726
2693,20129,5,20129,27,2025,27,9,1,9,Faculty & Staff Support,2,2025,19,2021-04-27 19:05:03,2021-04-27 21:41:57.511726
2694,20130,4,20130,30,2025,30,10,1,10,Friendships,2,2025,19,2021-04-27 19:05:03,2021-04-27 21:41:57.511726
2695,20131,4,20131,18,2026,18,6,1,6,Life - School Balance,2,2026,20,2021-04-27 19:05:04,2021-04-27 22:26:43.780572
2696,20132,4,20132,21,2026,21,7,1,7,Discrimination,2,2026,20,2021-04-27 19:05:04,2021-04-27 22:26:43.780572
2697,20133,6,20133,22,2026,22,8,1,8,Financial Pressure,2,2026,20,2021-04-27 19:05:04,2021-04-27 22:26:43.780572
2698,20134,5,20134,27,2026,27,9,1,9,Faculty & Staff Support,2,2026,20,2021-04-27 19:05:04,2021-04-27 22:26:43.780572
2699,20135,4,20135,32,2026,32,10,1,10,Friendships,2,2026,20,2021-04-27 19:05:04,2021-04-27 22:26:43.780572
2700,20176,3,20176,18,2035,18,6,1,6,Life - School Balance,2,2035,34,2021-04-27 19:05:05,2021-04-27 19:11:15.466148
2701,20177,5,20177,20,2035,20,7,1,7,Discrimination,2,2035,34,2021-04-27 19:05:05,2021-04-27 19:11:15.466148
2702,20178,3,20178,24,2035,24,8,1,8,Financial Pressure,2,2035,34,2021-04-27 19:05:05,2021-04-27 19:11:15.466148
2703,20179,5,20179,28,2035,28,9,1,9,Faculty & Staff Support,2,2035,34,2021-04-27 19:05:05,2021-04-27 19:11:15.466148
2704,20180,5,20180,33,2035,33,10,0,10,Friendships,2,2035,34,2021-04-27 19:05:05,2021-04-27 19:11:15.466148
2705,20191,3,20191,18,2038,18,6,1,6,Life - School Balance,2,2038,40,2021-04-27 19:05:06,2021-04-27 19:08:54.776057
2706,20192,3,20192,21,2038,21,7,1,7,Discrimination,2,2038,40,2021-04-27 19:05:06,2021-04-27 19:08:54.776057
2707,20193,5,20193,22,2038,22,8,1,8,Financial Pressure,2,2038,40,2021-04-27 19:05:06,2021-04-27 19:08:54.776057
2708,20194,4,20194,26,2038,26,9,1,9,Faculty & Staff Support,2,2038,40,2021-04-27 19:05:06,2021-04-27 19:08:54.776057
2709,20195,5,20195,32,2038,32,10,1,10,Friendships,2,2038,40,2021-04-27 19:05:06,2021-04-27 19:08:54.776057
2710,20221,4,20221,18,2044,18,6,1,6,Life - School Balance,2,2044,47,2021-04-27 19:05:07,2021-04-28 02:10:35.379514
2711,20222,5,20222,19,2044,19,7,0,7,Discrimination,2,2044,47,2021-04-27 19:05:07,2021-04-28 02:10:35.379514
2712,20223,6,20223,24,2044,24,8,1,8,Financial Pressure,2,2044,47,2021-04-27 19:05:07,2021-04-28 02:10:35.379514
2713,20224,5,20224,28,2044,28,9,1,9,Faculty & Staff Support,2,2044,47,2021-04-27 19:05:07,2021-04-28 02:10:35.379514
2714,20225,5,20225,33,2044,33,10,0,10,Friendships,2,2044,47,2021-04-27 19:05:07,2021-04-28 02:10:35.379514
2715,20231,4,20231,18,2046,18,6,1,6,Life - School Balance,2,2046,49,2021-04-27 19:05:07,2021-04-28 14:10:08.857927
2716,20232,4,20232,20,2046,20,7,1,7,Discrimination,2,2046,49,2021-04-27 19:05:07,2021-04-28 14:10:08.857927
2717,20233,5,20233,25,2046,25,8,0,8,Financial Pressure,2,2046,49,2021-04-27 19:05:07,2021-04-28 14:10:08.857927
2718,20234,4,20234,26,2046,26,9,1,9,Faculty & Staff Support,2,2046,49,2021-04-27 19:05:07,2021-04-28 14:10:08.857927
2719,20235,4,20235,30,2046,30,10,1,10,Friendships,2,2046,49,2021-04-27 19:05:07,2021-04-28 14:10:08.857927
2720,20286,5,20286,18,2057,18,6,1,6,Life - School Balance,2,2057,65,2021-04-27 19:05:09,2021-04-27 19:28:39.246878
2721,20287,5,20287,21,2057,21,7,1,7,Discrimination,2,2057,65,2021-04-27 19:05:09,2021-04-27 19:28:39.246878
2722,20288,1,20288,25,2057,25,8,0,8,Financial Pressure,2,2057,65,2021-04-27 19:05:09,2021-04-27 19:28:39.246878
2723,20289,6,20289,29,2057,29,9,0,9,Faculty & Staff Support,2,2057,65,2021-04-27 19:05:09,2021-04-27 19:28:39.246878
2724,20290,4,20290,33,2057,33,10,0,10,Friendships,2,2057,65,2021-04-27 19:05:09,2021-04-27 19:28:39.246878
2725,20301,2,20301,18,2060,18,6,1,6,Life - School Balance,2,2060,68,2021-04-27 19:05:09,2021-04-27 19:14:07.006981
2726,20302,4,20302,20,2060,20,7,1,7,Discrimination,2,2060,68,2021-04-27 19:05:09,2021-04-27 19:14:07.006981
2727,20303,5,20303,23,2060,23,8,1,8,Financial Pressure,2,2060,68,2021-04-27 19:05:09,2021-04-27 19:14:07.006981
2728,20304,6,20304,26,2060,26,9,1,9,Faculty & Staff Support,2,2060,68,2021-04-27 19:05:09,2021-04-27 19:14:07.006981
2729,20305,3,20305,30,2060,30,10,1,10,Friendships,2,2060,68,2021-04-27 19:05:09,2021-04-27 19:14:07.006981
2730,20311,3,20311,18,2062,18,6,1,6,Life - School Balance,2,2062,70,2021-04-27 19:05:10,2021-04-27 19:06:24.604388
2731,20312,6,20312,19,2062,19,7,0,7,Discrimination,2,2062,70,2021-04-27 19:05:10,2021-04-27 19:06:24.604388
2732,20313,3,20313,23,2062,23,8,1,8,Financial Pressure,2,2062,70,2021-04-27 19:05:10,2021-04-27 19:06:24.604388
2733,20314,4,20314,26,2062,26,9,1,9,Faculty & Staff Support,2,2062,70,2021-04-27 19:05:10,2021-04-27 19:06:24.604388
2734,20315,5,20315,33,2062,33,10,0,10,Friendships,2,2062,70,2021-04-27 19:05:10,2021-04-27 19:06:24.604388
2735,20316,4,20316,18,2063,18,6,1,6,Life - School Balance,2,2063,71,2021-04-27 19:05:10,2021-04-27 19:06:19.761605
2736,20317,6,20317,21,2063,21,7,1,7,Discrimination,2,2063,71,2021-04-27 19:05:10,2021-04-27 19:06:19.761605
2737,20318,3,20318,25,2063,25,8,0,8,Financial Pressure,2,2063,71,2021-04-27 19:05:10,2021-04-27 19:06:19.761605
2738,20319,5,20319,27,2063,27,9,1,9,Faculty & Staff Support,2,2063,71,2021-04-27 19:05:10,2021-04-27 19:06:19.761605
2739,20320,4,20320,33,2063,33,10,0,10,Friendships,2,2063,71,2021-04-27 19:05:10,2021-04-27 19:06:19.761605
2740,20346,3,20346,18,2069,18,6,1,6,Life - School Balance,2,2069,77,2021-04-27 19:05:11,2021-04-27 19:06:31.676783
2741,20347,5,20347,21,2069,21,7,1,7,Discrimination,2,2069,77,2021-04-27 19:05:11,2021-04-27 19:06:31.676783
2742,20348,4,20348,22,2069,22,8,1,8,Financial Pressure,2,2069,77,2021-04-27 19:05:11,2021-04-27 19:06:31.676783
2743,20349,4,20349,28,2069,28,9,1,9,Faculty & Staff Support,2,2069,77,2021-04-27 19:05:11,2021-04-27 19:06:31.676783
2744,20350,3,20350,32,2069,32,10,1,10,Friendships,2,2069,77,2021-04-27 19:05:11,2021-04-27 19:06:31.676783
2745,20351,2,20351,18,2070,18,6,1,6,Life - School Balance,2,2070,78,2021-04-27 19:05:11,2021-04-28 18:40:14.628299
2746,20352,5,20352,19,2070,19,7,0,7,Discrimination,2,2070,78,2021-04-27 19:05:11,2021-04-28 18:40:14.628299
2747,20353,3,20353,25,2070,25,8,0,8,Financial Pressure,2,2070,78,2021-04-27 19:05:11,2021-04-28 18:40:14.628299
2748,20354,5,20354,29,2070,29,9,0,9,Faculty & Staff Support,2,2070,78,2021-04-27 19:05:11,2021-04-28 18:40:14.628299
2749,20355,6,20355,32,2070,32,10,1,10,Friendships,2,2070,78,2021-04-27 19:05:11,2021-04-28 18:40:14.628299
2750,20366,4,20366,18,2073,18,6,1,6,Life - School Balance,2,2073,85,2021-04-27 19:05:11,2021-04-28 13:56:50.101026
2751,20367,6,20367,19,2073,19,7,0,7,Discrimination,2,2073,85,2021-04-27 19:05:11,2021-04-28 13:56:50.101026
2752,20368,2,20368,24,2073,24,8,1,8,Financial Pressure,2,2073,85,2021-04-27 19:05:11,2021-04-28 13:56:50.101026
2753,20369,4,20369,26,2073,26,9,1,9,Faculty & Staff Support,2,2073,85,2021-04-27 19:05:11,2021-04-28 13:56:50.101026
2754,20370,6,20370,30,2073,30,10,1,10,Friendships,2,2073,85,2021-04-27 19:05:11,2021-04-28 13:56:50.101026
2755,20371,5,20371,18,2074,18,6,1,6,Life - School Balance,2,2074,86,2021-04-27 19:05:12,2021-04-27 19:16:05.663123
2756,20372,5,20372,21,2074,21,7,1,7,Discrimination,2,2074,86,2021-04-27 19:05:12,2021-04-27 19:16:05.663123
2757,20373,4,20373,25,2074,25,8,0,8,Financial Pressure,2,2074,86,2021-04-27 19:05:12,2021-04-27 19:16:05.663123
2758,20374,6,20374,29,2074,29,9,0,9,Faculty & Staff Support,2,2074,86,2021-04-27 19:05:12,2021-04-27 19:16:05.663123
2759,20375,5,20375,30,2074,30,10,1,10,Friendships,2,2074,86,2021-04-27 19:05:12,2021-04-27 19:16:05.663123
2760,20391,3,20391,18,2078,18,6,1,6,Life - School Balance,2,2078,90,2021-04-27 19:05:12,2021-04-27 19:07:12.945559
2761,20392,5,20392,21,2078,21,7,1,7,Discrimination,2,2078,90,2021-04-27 19:05:12,2021-04-27 19:07:12.945559
2762,20393,5,20393,24,2078,24,8,1,8,Financial Pressure,2,2078,90,2021-04-27 19:05:12,2021-04-27 19:07:12.945559
2763,20394,5,20394,27,2078,27,9,1,9,Faculty & Staff Support,2,2078,90,2021-04-27 19:05:12,2021-04-27 19:07:12.945559
2764,20395,5,20395,30,2078,30,10,1,10,Friendships,2,2078,90,2021-04-27 19:05:12,2021-04-27 19:07:12.945559
2765,20396,6,20396,18,2079,18,6,1,6,Life - School Balance,2,2079,91,2021-04-27 19:05:12,2021-04-27 20:32:03.712602
2766,20397,6,20397,20,2079,20,7,1,7,Discrimination,2,2079,91,2021-04-27 19:05:12,2021-04-27 20:32:03.712602
2767,20398,2,20398,22,2079,22,8,1,8,Financial Pressure,2,2079,91,2021-04-27 19:05:12,2021-04-27 20:32:03.712602
2768,20399,6,20399,27,2079,27,9,1,9,Faculty & Staff Support,2,2079,91,2021-04-27 19:05:12,2021-04-27 20:32:03.712602
2769,20400,6,20400,32,2079,32,10,1,10,Friendships,2,2079,91,2021-04-27 19:05:12,2021-04-27 20:32:03.712602
2770,20411,6,20411,18,2082,18,6,1,6,Life - School Balance,2,2082,95,2021-04-27 19:05:13,2021-04-27 19:42:21.462611
2771,20412,6,20412,21,2082,21,7,1,7,Discrimination,2,2082,95,2021-04-27 19:05:13,2021-04-27 19:42:21.462611
2772,20413,3,20413,23,2082,23,8,1,8,Financial Pressure,2,2082,95,2021-04-27 19:05:13,2021-04-27 19:42:21.462611
2773,20414,6,20414,29,2082,29,9,0,9,Faculty & Staff Support,2,2082,95,2021-04-27 19:05:13,2021-04-27 19:42:21.462611
2774,20415,6,20415,32,2082,32,10,1,10,Friendships,2,2082,95,2021-04-27 19:05:13,2021-04-27 19:42:21.462611
2775,20426,4,20426,18,2085,18,6,1,6,Life - School Balance,2,2085,99,2021-04-27 19:05:13,2021-04-27 19:42:37.125205
2776,20427,6,20427,19,2085,19,7,0,7,Discrimination,2,2085,99,2021-04-27 19:05:13,2021-04-27 19:42:37.125205
2777,20428,1,20428,25,2085,25,8,0,8,Financial Pressure,2,2085,99,2021-04-27 19:05:13,2021-04-27 19:42:37.125205
2778,20429,6,20429,28,2085,28,9,1,9,Faculty & Staff Support,2,2085,99,2021-04-27 19:05:13,2021-04-27 19:42:37.125205
2779,20430,6,20430,33,2085,33,10,0,10,Friendships,2,2085,99,2021-04-27 19:05:13,2021-04-27 19:42:37.125205
2780,20431,3,20431,18,2086,18,6,1,6,Life - School Balance,2,2086,100,2021-04-27 19:05:13,2021-04-27 19:06:32.110081
2781,20432,5,20432,19,2086,19,7,0,7,Discrimination,2,2086,100,2021-04-27 19:05:13,2021-04-27 19:06:32.110081
2782,20433,5,20433,24,2086,24,8,1,8,Financial Pressure,2,2086,100,2021-04-27 19:05:13,2021-04-27 19:06:32.110081
2783,20434,5,20434,28,2086,28,9,1,9,Faculty & Staff Support,2,2086,100,2021-04-27 19:05:13,2021-04-27 19:06:32.110081
2784,20435,5,20435,33,2086,33,10,0,10,Friendships,2,2086,100,2021-04-27 19:05:13,2021-04-27 19:06:32.110081
2785,20436,2,20436,18,2087,18,6,1,6,Life - School Balance,2,2087,101,2021-04-27 19:05:14,2021-04-27 19:11:28.460651
2786,20437,6,20437,19,2087,19,7,0,7,Discrimination,2,2087,101,2021-04-27 19:05:14,2021-04-27 19:11:28.460651
2787,20438,5,20438,25,2087,25,8,0,8,Financial Pressure,2,2087,101,2021-04-27 19:05:14,2021-04-27 19:11:28.460651
2788,20439,5,20439,29,2087,29,9,0,9,Faculty & Staff Support,2,2087,101,2021-04-27 19:05:14,2021-04-27 19:11:28.460651
2789,20440,6,20440,30,2087,30,10,1,10,Friendships,2,2087,101,2021-04-27 19:05:14,2021-04-27 19:11:28.460651
2790,20535,5,20535,18,2105,18,6,1,6,Life - School Balance,2,2105,13,2021-04-29 15:03:22,2021-04-29 15:04:52.316412
2791,20536,4,20536,19,2105,19,7,0,7,Discrimination,2,2105,13,2021-04-29 15:03:22,2021-04-29 15:04:52.316412
2792,20537,3,20537,23,2105,23,8,1,8,Financial Pressure,2,2105,13,2021-04-29 15:03:22,2021-04-29 15:04:52.316412
2793,20538,4,20538,26,2105,26,9,1,9,Faculty & Staff Support,2,2105,13,2021-04-29 15:03:22,2021-04-29 15:04:52.316412
2794,20539,4,20539,33,2105,33,10,0,10,Friendships,2,2105,13,2021-04-29 15:03:22,2021-04-29 15:04:52.316412
2795,20550,2,20550,18,2108,18,6,1,6,Life - School Balance,2,2108,17,2021-04-29 15:03:23,2021-04-29 15:13:01.861195
2796,20551,5,20551,20,2108,20,7,1,7,Discrimination,2,2108,17,2021-04-29 15:03:23,2021-04-29 15:13:01.861195
2797,20552,5,20552,23,2108,23,8,1,8,Financial Pressure,2,2108,17,2021-04-29 15:03:23,2021-04-29 15:13:01.861195
2798,20553,3,20553,27,2108,27,9,1,9,Faculty & Staff Support,2,2108,17,2021-04-29 15:03:23,2021-04-29 15:13:01.861195
2799,20554,4,20554,31,2108,31,10,1,10,Friendships,2,2108,17,2021-04-29 15:03:23,2021-04-29 15:13:01.861195
2800,20555,4,20555,18,2109,18,6,1,6,Life - School Balance,2,2109,18,2021-04-29 15:03:23,2021-04-29 15:05:10.689636
2801,20556,4,20556,20,2109,20,7,1,7,Discrimination,2,2109,18,2021-04-29 15:03:23,2021-04-29 15:05:10.689636
2802,20557,6,20557,23,2109,23,8,1,8,Financial Pressure,2,2109,18,2021-04-29 15:03:23,2021-04-29 15:05:10.689636
2803,20558,4,20558,29,2109,29,9,0,9,Faculty & Staff Support,2,2109,18,2021-04-29 15:03:23,2021-04-29 15:05:10.689636
2804,20559,3,20559,33,2109,33,10,0,10,Friendships,2,2109,18,2021-04-29 15:03:23,2021-04-29 15:05:10.689636
2805,20560,5,20560,18,2110,18,6,1,6,Life - School Balance,2,2110,19,2021-04-29 15:03:23,2021-04-30 04:15:02.925673
2806,20561,5,20561,19,2110,19,7,0,7,Discrimination,2,2110,19,2021-04-29 15:03:23,2021-04-30 04:15:02.925673
2807,20562,5,20562,24,2110,24,8,1,8,Financial Pressure,2,2110,19,2021-04-29 15:03:23,2021-04-30 04:15:02.925673
2808,20563,5,20563,29,2110,29,9,0,9,Faculty & Staff Support,2,2110,19,2021-04-29 15:03:23,2021-04-30 04:15:02.925673
2809,20564,5,20564,33,2110,33,10,0,10,Friendships,2,2110,19,2021-04-29 15:03:23,2021-04-30 04:15:02.925673
2810,20575,4,20575,18,2113,18,6,1,6,Life - School Balance,2,2113,23,2021-04-29 15:03:23,2021-04-29 15:04:45.280836
2811,20576,5,20576,19,2113,19,7,0,7,Discrimination,2,2113,23,2021-04-29 15:03:23,2021-04-29 15:04:45.280836
2812,20577,6,20577,25,2113,25,8,0,8,Financial Pressure,2,2113,23,2021-04-29 15:03:23,2021-04-29 15:04:45.280836
2813,20578,5,20578,28,2113,28,9,1,9,Faculty & Staff Support,2,2113,23,2021-04-29 15:03:23,2021-04-29 15:04:45.280836
2814,20579,4,20579,32,2113,32,10,1,10,Friendships,2,2113,23,2021-04-29 15:03:23,2021-04-29 15:04:45.280836
2815,20610,3,20610,18,2120,18,6,1,6,Life - School Balance,2,2120,34,2021-04-29 15:03:25,2021-04-29 15:05:41.268358
2816,20611,4,20611,19,2120,19,7,0,7,Discrimination,2,2120,34,2021-04-29 15:03:25,2021-04-29 15:05:41.268358
2817,20612,3,20612,22,2120,22,8,1,8,Financial Pressure,2,2120,34,2021-04-29 15:03:25,2021-04-29 15:05:41.268358
2818,20613,4,20613,26,2120,26,9,1,9,Faculty & Staff Support,2,2120,34,2021-04-29 15:03:25,2021-04-29 15:05:41.268358
2819,20614,4,20614,30,2120,30,10,1,10,Friendships,2,2120,34,2021-04-29 15:03:25,2021-04-29 15:05:41.268358
2820,20640,4,20640,18,2126,18,6,1,6,Life - School Balance,2,2126,44,2021-04-29 15:03:26,2021-04-29 16:32:50.686824
2821,20641,4,20641,21,2126,21,7,1,7,Discrimination,2,2126,44,2021-04-29 15:03:26,2021-04-29 16:32:50.686824
2822,20642,3,20642,25,2126,25,8,0,8,Financial Pressure,2,2126,44,2021-04-29 15:03:26,2021-04-29 16:32:50.686824
2823,20643,4,20643,29,2126,29,9,0,9,Faculty & Staff Support,2,2126,44,2021-04-29 15:03:26,2021-04-29 16:32:50.686824
2824,20644,4,20644,32,2126,32,10,1,10,Friendships,2,2126,44,2021-04-29 15:03:26,2021-04-29 16:32:50.686824
2825,20645,5,20645,18,2127,18,6,1,6,Life - School Balance,2,2127,45,2021-04-29 15:03:26,2021-04-29 15:17:49.939180
2826,20646,6,20646,19,2127,19,7,0,7,Discrimination,2,2127,45,2021-04-29 15:03:26,2021-04-29 15:17:49.939180
2827,20647,1,20647,23,2127,23,8,1,8,Financial Pressure,2,2127,45,2021-04-29 15:03:26,2021-04-29 15:17:49.939180
2828,20648,5,20648,26,2127,26,9,1,9,Faculty & Staff Support,2,2127,45,2021-04-29 15:03:26,2021-04-29 15:17:49.939180
2829,20649,6,20649,33,2127,33,10,0,10,Friendships,2,2127,45,2021-04-29 15:03:26,2021-04-29 15:17:49.939180
2830,20650,4,20650,18,2128,18,6,1,6,Life - School Balance,2,2128,46,2021-04-29 15:03:26,2021-04-29 18:51:06.222811
2831,20651,4,20651,20,2128,20,7,1,7,Discrimination,2,2128,46,2021-04-29 15:03:26,2021-04-29 18:51:06.222811
2832,20652,5,20652,22,2128,22,8,1,8,Financial Pressure,2,2128,46,2021-04-29 15:03:26,2021-04-29 18:51:06.222811
2833,20653,4,20653,27,2128,27,9,1,9,Faculty & Staff Support,2,2128,46,2021-04-29 15:03:26,2021-04-29 18:51:06.222811
2834,20654,5,20654,31,2128,31,10,1,10,Friendships,2,2128,46,2021-04-29 15:03:26,2021-04-29 18:51:06.222811
2835,20655,5,20655,18,2129,18,6,1,6,Life - School Balance,2,2129,47,2021-04-29 15:03:26,2021-04-29 16:26:51.575712
2836,20656,6,20656,20,2129,20,7,1,7,Discrimination,2,2129,47,2021-04-29 15:03:26,2021-04-29 16:26:51.575712
2837,20657,4,20657,24,2129,24,8,1,8,Financial Pressure,2,2129,47,2021-04-29 15:03:26,2021-04-29 16:26:51.575712
2838,20658,5,20658,28,2129,28,9,1,9,Faculty & Staff Support,2,2129,47,2021-04-29 15:03:26,2021-04-29 16:26:51.575712
2839,20659,5,20659,33,2129,33,10,0,10,Friendships,2,2129,47,2021-04-29 15:03:26,2021-04-29 16:26:51.575712
2840,20675,2,20675,18,2133,18,6,1,6,Life - School Balance,2,2133,52,2021-04-29 15:03:27,2021-04-29 21:16:44.172686
2841,20676,2,20676,20,2133,20,7,1,7,Discrimination,2,2133,52,2021-04-29 15:03:27,2021-04-29 21:16:44.172686
2842,20677,6,20677,23,2133,23,8,1,8,Financial Pressure,2,2133,52,2021-04-29 15:03:27,2021-04-29 21:16:44.172686
2843,20678,6,20678,26,2133,26,9,1,9,Faculty & Staff Support,2,2133,52,2021-04-29 15:03:27,2021-04-29 21:16:44.172686
2844,20679,5,20679,31,2133,31,10,1,10,Friendships,2,2133,52,2021-04-29 15:03:27,2021-04-29 21:16:44.172686
2845,20695,3,20695,18,2137,18,6,1,6,Life - School Balance,2,2137,58,2021-04-29 15:03:28,2021-04-29 16:26:23.234765
2846,20696,4,20696,20,2137,20,7,1,7,Discrimination,2,2137,58,2021-04-29 15:03:28,2021-04-29 16:26:23.234765
2847,20697,1,20697,25,2137,25,8,0,8,Financial Pressure,2,2137,58,2021-04-29 15:03:28,2021-04-29 16:26:23.234765
2848,20698,6,20698,27,2137,27,9,1,9,Faculty & Staff Support,2,2137,58,2021-04-29 15:03:28,2021-04-29 16:26:23.234765
2849,20699,4,20699,32,2137,32,10,1,10,Friendships,2,2137,58,2021-04-29 15:03:28,2021-04-29 16:26:23.234765
2850,20715,4,20715,18,2141,18,6,1,6,Life - School Balance,2,2141,64,2021-04-29 15:03:28,2021-04-29 15:44:08.612902
2851,20716,4,20716,20,2141,20,7,1,7,Discrimination,2,2141,64,2021-04-29 15:03:28,2021-04-29 15:44:08.612902
2852,20717,4,20717,24,2141,24,8,1,8,Financial Pressure,2,2141,64,2021-04-29 15:03:28,2021-04-29 15:44:08.612902
2853,20718,4,20718,27,2141,27,9,1,9,Faculty & Staff Support,2,2141,64,2021-04-29 15:03:28,2021-04-29 15:44:08.612902
2854,20719,4,20719,30,2141,30,10,1,10,Friendships,2,2141,64,2021-04-29 15:03:28,2021-04-29 15:44:08.612902
2855,20720,4,20720,18,2142,18,6,1,6,Life - School Balance,2,2142,65,2021-04-29 15:03:29,2021-04-29 16:37:10.887521
2856,20721,5,20721,19,2142,19,7,0,7,Discrimination,2,2142,65,2021-04-29 15:03:29,2021-04-29 16:37:10.887521
2857,20722,3,20722,23,2142,23,8,1,8,Financial Pressure,2,2142,65,2021-04-29 15:03:29,2021-04-29 16:37:10.887521
2858,20723,5,20723,28,2142,28,9,1,9,Faculty & Staff Support,2,2142,65,2021-04-29 15:03:29,2021-04-29 16:37:10.887521
2859,20724,5,20724,30,2142,30,10,1,10,Friendships,2,2142,65,2021-04-29 15:03:29,2021-04-29 16:37:10.887521
2860,20725,5,20725,18,2143,18,6,1,6,Life - School Balance,2,2143,66,2021-04-29 15:03:29,2021-04-29 15:16:23.344409
2861,20726,5,20726,20,2143,20,7,1,7,Discrimination,2,2143,66,2021-04-29 15:03:29,2021-04-29 15:16:23.344409
2862,20727,3,20727,22,2143,22,8,1,8,Financial Pressure,2,2143,66,2021-04-29 15:03:29,2021-04-29 15:16:23.344409
2863,20728,5,20728,28,2143,28,9,1,9,Faculty & Staff Support,2,2143,66,2021-04-29 15:03:29,2021-04-29 15:16:23.344409
2864,20729,5,20729,31,2143,31,10,1,10,Friendships,2,2143,66,2021-04-29 15:03:29,2021-04-29 15:16:23.344409
2865,20740,4,20740,18,2146,18,6,1,6,Life - School Balance,2,2146,69,2021-04-29 15:03:29,2021-04-29 15:04:50.337000
2866,20741,4,20741,19,2146,19,7,0,7,Discrimination,2,2146,69,2021-04-29 15:03:29,2021-04-29 15:04:50.337000
2867,20742,5,20742,22,2146,22,8,1,8,Financial Pressure,2,2146,69,2021-04-29 15:03:29,2021-04-29 15:04:50.337000
2868,20743,4,20743,26,2146,26,9,1,9,Faculty & Staff Support,2,2146,69,2021-04-29 15:03:29,2021-04-29 15:04:50.337000
2869,20744,4,20744,30,2146,30,10,1,10,Friendships,2,2146,69,2021-04-29 15:03:29,2021-04-29 15:04:50.337000
2870,20745,3,20745,18,2147,18,6,1,6,Life - School Balance,2,2147,70,2021-04-29 15:03:29,2021-04-29 15:16:01.702973
2871,20746,5,20746,20,2147,20,7,1,7,Discrimination,2,2147,70,2021-04-29 15:03:29,2021-04-29 15:16:01.702973
2872,20747,3,20747,22,2147,22,8,1,8,Financial Pressure,2,2147,70,2021-04-29 15:03:29,2021-04-29 15:16:01.702973
2873,20748,4,20748,26,2147,26,9,1,9,Faculty & Staff Support,2,2147,70,2021-04-29 15:03:29,2021-04-29 15:16:01.702973
2874,20749,4,20749,30,2147,30,10,1,10,Friendships,2,2147,70,2021-04-29 15:03:29,2021-04-29 15:16:01.702973
2875,20770,4,20770,18,2152,18,6,1,6,Life - School Balance,2,2152,75,2021-04-29 15:03:30,2021-04-29 15:12:11.157143
2876,20771,5,20771,19,2152,19,7,0,7,Discrimination,2,2152,75,2021-04-29 15:03:30,2021-04-29 15:12:11.157143
2877,20772,4,20772,25,2152,25,8,0,8,Financial Pressure,2,2152,75,2021-04-29 15:03:30,2021-04-29 15:12:11.157143
2878,20773,6,20773,28,2152,28,9,1,9,Faculty & Staff Support,2,2152,75,2021-04-29 15:03:30,2021-04-29 15:12:11.157143
2879,20774,6,20774,33,2152,33,10,0,10,Friendships,2,2152,75,2021-04-29 15:03:30,2021-04-29 15:12:11.157143
2880,20815,4,20815,18,2161,18,6,1,6,Life - School Balance,2,2161,88,2021-04-29 15:03:32,2021-04-29 15:33:02.684764
2881,20816,6,20816,19,2161,19,7,0,7,Discrimination,2,2161,88,2021-04-29 15:03:32,2021-04-29 15:33:02.684764
2882,20817,5,20817,24,2161,24,8,1,8,Financial Pressure,2,2161,88,2021-04-29 15:03:32,2021-04-29 15:33:02.684764
2883,20818,5,20818,27,2161,27,9,1,9,Faculty & Staff Support,2,2161,88,2021-04-29 15:03:32,2021-04-29 15:33:02.684764
2884,20819,6,20819,33,2161,33,10,0,10,Friendships,2,2161,88,2021-04-29 15:03:32,2021-04-29 15:33:02.684764
2885,20820,5,20820,18,2162,18,6,1,6,Life - School Balance,2,2162,89,2021-04-29 15:03:32,2021-04-29 15:17:24.792327
2886,20821,5,20821,21,2162,21,7,1,7,Discrimination,2,2162,89,2021-04-29 15:03:32,2021-04-29 15:17:24.792327
2887,20822,4,20822,22,2162,22,8,1,8,Financial Pressure,2,2162,89,2021-04-29 15:03:32,2021-04-29 15:17:24.792327
2888,20823,6,20823,28,2162,28,9,1,9,Faculty & Staff Support,2,2162,89,2021-04-29 15:03:32,2021-04-29 15:17:24.792327
2889,20824,4,20824,33,2162,33,10,0,10,Friendships,2,2162,89,2021-04-29 15:03:32,2021-04-29 15:17:24.792327
2890,20825,3,20825,18,2163,18,6,1,6,Life - School Balance,2,2163,90,2021-04-29 15:03:32,2021-04-29 16:10:11.054556
2891,20826,5,20826,20,2163,20,7,1,7,Discrimination,2,2163,90,2021-04-29 15:03:32,2021-04-29 16:10:11.054556
2892,20827,4,20827,23,2163,23,8,1,8,Financial Pressure,2,2163,90,2021-04-29 15:03:32,2021-04-29 16:10:11.054556
2893,20828,4,20828,27,2163,27,9,1,9,Faculty & Staff Support,2,2163,90,2021-04-29 15:03:32,2021-04-29 16:10:11.054556
2894,20829,6,20829,32,2163,32,10,1,10,Friendships,2,2163,90,2021-04-29 15:03:32,2021-04-29 16:10:11.054556
2895,20855,2,20855,18,2169,18,6,1,6,Life - School Balance,2,2169,98,2021-04-29 15:03:33,2021-04-29 15:05:01.911176
2896,20856,1,20856,20,2169,20,7,1,7,Discrimination,2,2169,98,2021-04-29 15:03:33,2021-04-29 15:05:01.911176
2897,20857,5,20857,25,2169,25,8,0,8,Financial Pressure,2,2169,98,2021-04-29 15:03:33,2021-04-29 15:05:01.911176
2898,20858,5,20858,28,2169,28,9,1,9,Faculty & Staff Support,2,2169,98,2021-04-29 15:03:33,2021-04-29 15:05:01.911176
2899,20859,5,20859,32,2169,32,10,1,10,Friendships,2,2169,98,2021-04-29 15:03:33,2021-04-29 15:05:01.911176
2900,20860,6,20860,18,2170,18,6,1,6,Life - School Balance,2,2170,99,2021-04-29 15:03:34,2021-04-29 15:34:28.179711
2901,20861,1,20861,21,2170,21,7,1,7,Discrimination,2,2170,99,2021-04-29 15:03:34,2021-04-29 15:34:28.179711
2902,20862,1,20862,25,2170,25,8,0,8,Financial Pressure,2,2170,99,2021-04-29 15:03:34,2021-04-29 15:34:28.179711
2903,20863,6,20863,28,2170,28,9,1,9,Faculty & Staff Support,2,2170,99,2021-04-29 15:03:34,2021-04-29 15:34:28.179711
2904,20864,6,20864,30,2170,30,10,1,10,Friendships,2,2170,99,2021-04-29 15:03:34,2021-04-29 15:34:28.179711
2905,20865,4,20865,18,2171,18,6,1,6,Life - School Balance,2,2171,100,2021-04-29 15:03:34,2021-04-29 15:36:19.267192
2906,20866,5,20866,19,2171,19,7,0,7,Discrimination,2,2171,100,2021-04-29 15:03:34,2021-04-29 15:36:19.267192
2907,20867,5,20867,24,2171,24,8,1,8,Financial Pressure,2,2171,100,2021-04-29 15:03:34,2021-04-29 15:36:19.267192
2908,20868,5,20868,28,2171,28,9,1,9,Faculty & Staff Support,2,2171,100,2021-04-29 15:03:34,2021-04-29 15:36:19.267192
2909,20869,5,20869,33,2171,33,10,0,10,Friendships,2,2171,100,2021-04-29 15:03:34,2021-04-29 15:36:19.267192
2910,21080,4,21080,18,2214,18,6,1,6,Life - School Balance,2,2214,10,2021-05-04 19:05:02,2021-05-05 00:10:25.336723
2911,21081,6,21081,21,2214,21,7,1,7,Discrimination,2,2214,10,2021-05-04 19:05:02,2021-05-05 00:10:25.336723
2912,21082,4,21082,22,2214,22,8,1,8,Financial Pressure,2,2214,10,2021-05-04 19:05:02,2021-05-05 00:10:25.336723
2913,21083,5,21083,26,2214,26,9,1,9,Faculty & Staff Support,2,2214,10,2021-05-04 19:05:02,2021-05-05 00:10:25.336723
2914,21084,4,21084,30,2214,30,10,1,10,Friendships,2,2214,10,2021-05-04 19:05:02,2021-05-05 00:10:25.336723
2915,21085,4,21085,18,2215,18,6,1,6,Life - School Balance,2,2215,13,2021-05-04 19:05:02,2021-05-04 19:06:06.853300
2916,21086,5,21086,20,2215,20,7,1,7,Discrimination,2,2215,13,2021-05-04 19:05:02,2021-05-04 19:06:06.853300
2917,21087,3,21087,23,2215,23,8,1,8,Financial Pressure,2,2215,13,2021-05-04 19:05:02,2021-05-04 19:06:06.853300
2918,21088,4,21088,26,2215,26,9,1,9,Faculty & Staff Support,2,2215,13,2021-05-04 19:05:02,2021-05-04 19:06:06.853300
2919,21089,5,21089,30,2215,30,10,1,10,Friendships,2,2215,13,2021-05-04 19:05:02,2021-05-04 19:06:06.853300
2920,21100,1,21100,18,2218,18,6,1,6,Life - School Balance,2,2218,17,2021-05-04 19:05:02,2021-05-04 20:48:19.578894
2921,21101,5,21101,20,2218,20,7,1,7,Discrimination,2,2218,17,2021-05-04 19:05:02,2021-05-04 20:48:19.578894
2922,21102,6,21102,24,2218,24,8,1,8,Financial Pressure,2,2218,17,2021-05-04 19:05:02,2021-05-04 20:48:19.578894
2923,21103,4,21103,27,2218,27,9,1,9,Faculty & Staff Support,2,2218,17,2021-05-04 19:05:02,2021-05-04 20:48:19.578894
2924,21104,5,21104,31,2218,31,10,1,10,Friendships,2,2218,17,2021-05-04 19:05:02,2021-05-04 20:48:19.578894
2925,21170,2,21170,18,2232,18,6,1,6,Life - School Balance,2,2232,36,2021-05-04 19:05:05,2021-05-04 19:20:59.514804
2926,21171,3,21171,19,2232,19,7,0,7,Discrimination,2,2232,36,2021-05-04 19:05:05,2021-05-04 19:20:59.514804
2927,21172,5,21172,23,2232,23,8,1,8,Financial Pressure,2,2232,36,2021-05-04 19:05:05,2021-05-04 19:20:59.514804
2928,21173,4,21173,29,2232,29,9,0,9,Faculty & Staff Support,2,2232,36,2021-05-04 19:05:05,2021-05-04 19:20:59.514804
2929,21174,4,21174,33,2232,33,10,0,10,Friendships,2,2232,36,2021-05-04 19:05:05,2021-05-04 19:20:59.514804
2930,21180,5,21180,18,2234,18,6,1,6,Life - School Balance,2,2234,41,2021-05-04 19:05:05,2021-05-04 19:16:41.078425
2931,21181,5,21181,20,2234,20,7,1,7,Discrimination,2,2234,41,2021-05-04 19:05:05,2021-05-04 19:16:41.078425
2932,21182,4,21182,25,2234,25,8,0,8,Financial Pressure,2,2234,41,2021-05-04 19:05:05,2021-05-04 19:16:41.078425
2933,21183,6,21183,26,2234,26,9,1,9,Faculty & Staff Support,2,2234,41,2021-05-04 19:05:05,2021-05-04 19:16:41.078425
2934,21184,5,21184,32,2234,32,10,1,10,Friendships,2,2234,41,2021-05-04 19:05:05,2021-05-04 19:16:41.078425
2935,21220,4,21220,18,2242,18,6,1,6,Life - School Balance,2,2242,50,2021-05-04 19:05:06,2021-05-04 19:49:34.136258
2936,21221,3,21221,19,2242,19,7,0,7,Discrimination,2,2242,50,2021-05-04 19:05:06,2021-05-04 19:49:34.136258
2937,21222,6,21222,25,2242,25,8,0,8,Financial Pressure,2,2242,50,2021-05-04 19:05:06,2021-05-04 19:49:34.136258
2938,21223,4,21223,29,2242,29,9,0,9,Faculty & Staff Support,2,2242,50,2021-05-04 19:05:06,2021-05-04 19:49:34.136258
2939,21224,3,21224,33,2242,33,10,0,10,Friendships,2,2242,50,2021-05-04 19:05:06,2021-05-04 19:49:34.136258
2940,21225,3,21225,18,2243,18,6,1,6,Life - School Balance,2,2243,52,2021-05-04 19:05:06,2021-05-04 19:38:29.084044
2941,21226,3,21226,20,2243,20,7,1,7,Discrimination,2,2243,52,2021-05-04 19:05:06,2021-05-04 19:38:29.084044
2942,21227,6,21227,25,2243,25,8,0,8,Financial Pressure,2,2243,52,2021-05-04 19:05:06,2021-05-04 19:38:29.084044
2943,21228,5,21228,28,2243,28,9,1,9,Faculty & Staff Support,2,2243,52,2021-05-04 19:05:06,2021-05-04 19:38:29.084044
2944,21229,3,21229,30,2243,30,10,1,10,Friendships,2,2243,52,2021-05-04 19:05:06,2021-05-04 19:38:29.084044
2945,21275,6,21275,18,2253,18,6,1,6,Life - School Balance,2,2253,66,2021-05-04 19:05:08,2021-05-04 19:10:59.564734
2946,21276,5,21276,19,2253,19,7,0,7,Discrimination,2,2253,66,2021-05-04 19:05:08,2021-05-04 19:10:59.564734
2947,21277,5,21277,24,2253,24,8,1,8,Financial Pressure,2,2253,66,2021-05-04 19:05:08,2021-05-04 19:10:59.564734
2948,21278,6,21278,28,2253,28,9,1,9,Faculty & Staff Support,2,2253,66,2021-05-04 19:05:08,2021-05-04 19:10:59.564734
2949,21279,6,21279,31,2253,31,10,1,10,Friendships,2,2253,66,2021-05-04 19:05:08,2021-05-04 19:10:59.564734
2950,21300,5,21300,18,2258,18,6,1,6,Life - School Balance,2,2258,71,2021-05-04 19:05:09,2021-05-04 19:17:46.880192
2951,21301,5,21301,21,2258,21,7,1,7,Discrimination,2,2258,71,2021-05-04 19:05:09,2021-05-04 19:17:46.880192
2952,21302,3,21302,25,2258,25,8,0,8,Financial Pressure,2,2258,71,2021-05-04 19:05:09,2021-05-04 19:17:46.880192
2953,21303,5,21303,28,2258,28,9,1,9,Faculty & Staff Support,2,2258,71,2021-05-04 19:05:09,2021-05-04 19:17:46.880192
2954,21304,5,21304,30,2258,30,10,1,10,Friendships,2,2258,71,2021-05-04 19:05:09,2021-05-04 19:17:46.880192
2955,21305,5,21305,18,2259,18,6,1,6,Life - School Balance,2,2259,72,2021-05-04 19:05:09,2021-05-05 00:59:02.900263
2956,21306,5,21306,20,2259,20,7,1,7,Discrimination,2,2259,72,2021-05-04 19:05:09,2021-05-05 00:59:02.900263
2957,21307,4,21307,25,2259,25,8,0,8,Financial Pressure,2,2259,72,2021-05-04 19:05:09,2021-05-05 00:59:02.900263
2958,21308,5,21308,27,2259,27,9,1,9,Faculty & Staff Support,2,2259,72,2021-05-04 19:05:09,2021-05-05 00:59:02.900263
2959,21309,5,21309,33,2259,33,10,0,10,Friendships,2,2259,72,2021-05-04 19:05:09,2021-05-05 00:59:02.900263
2960,21315,4,21315,18,2261,18,6,1,6,Life - School Balance,2,2261,74,2021-05-04 19:05:09,2021-05-04 19:37:42.670100
2961,21316,6,21316,20,2261,20,7,1,7,Discrimination,2,2261,74,2021-05-04 19:05:09,2021-05-04 19:37:42.670100
2962,21317,4,21317,23,2261,23,8,1,8,Financial Pressure,2,2261,74,2021-05-04 19:05:09,2021-05-04 19:37:42.670100
2963,21318,6,21318,27,2261,27,9,1,9,Faculty & Staff Support,2,2261,74,2021-05-04 19:05:09,2021-05-04 19:37:42.670100
2964,21319,6,21319,30,2261,30,10,1,10,Friendships,2,2261,74,2021-05-04 19:05:09,2021-05-04 19:37:42.670100
2965,21320,4,21320,18,2262,18,6,1,6,Life - School Balance,2,2262,75,2021-05-04 19:05:09,2021-05-04 19:08:29.519248
2966,21321,5,21321,21,2262,21,7,1,7,Discrimination,2,2262,75,2021-05-04 19:05:09,2021-05-04 19:08:29.519248
2967,21322,4,21322,22,2262,22,8,1,8,Financial Pressure,2,2262,75,2021-05-04 19:05:09,2021-05-04 19:08:29.519248
2968,21323,6,21323,27,2262,27,9,1,9,Faculty & Staff Support,2,2262,75,2021-05-04 19:05:09,2021-05-04 19:08:29.519248
2969,21324,6,21324,31,2262,31,10,1,10,Friendships,2,2262,75,2021-05-04 19:05:09,2021-05-04 19:08:29.519248
2970,21340,2,21340,18,2266,18,6,1,6,Life - School Balance,2,2266,79,2021-05-04 19:05:10,2021-05-04 19:06:30.411859
2971,21341,5,21341,21,2266,21,7,1,7,Discrimination,2,2266,79,2021-05-04 19:05:10,2021-05-04 19:06:30.411859
2972,21342,4,21342,22,2266,22,8,1,8,Financial Pressure,2,2266,79,2021-05-04 19:05:10,2021-05-04 19:06:30.411859
2973,21343,6,21343,27,2266,27,9,1,9,Faculty & Staff Support,2,2266,79,2021-05-04 19:05:10,2021-05-04 19:06:30.411859
2974,21344,4,21344,30,2266,30,10,1,10,Friendships,2,2266,79,2021-05-04 19:05:10,2021-05-04 19:06:30.411859
2975,21345,2,21345,18,2267,18,6,1,6,Life - School Balance,2,2267,84,2021-05-04 19:05:10,2021-05-04 19:30:14.787997
2976,21346,5,21346,21,2267,21,7,1,7,Discrimination,2,2267,84,2021-05-04 19:05:10,2021-05-04 19:30:14.787997
2977,21347,3,21347,23,2267,23,8,1,8,Financial Pressure,2,2267,84,2021-05-04 19:05:10,2021-05-04 19:30:14.787997
2978,21348,4,21348,28,2267,28,9,1,9,Faculty & Staff Support,2,2267,84,2021-05-04 19:05:10,2021-05-04 19:30:14.787997
2979,21349,4,21349,30,2267,30,10,1,10,Friendships,2,2267,84,2021-05-04 19:05:10,2021-05-04 19:30:14.787997
2980,21365,2,21365,18,2271,18,6,1,6,Life - School Balance,2,2271,88,2021-05-04 19:05:11,2021-05-04 19:46:22.394310
2981,21366,5,21366,20,2271,20,7,1,7,Discrimination,2,2271,88,2021-05-04 19:05:11,2021-05-04 19:46:22.394310
2982,21367,3,21367,25,2271,25,8,0,8,Financial Pressure,2,2271,88,2021-05-04 19:05:11,2021-05-04 19:46:22.394310
2983,21368,5,21368,28,2271,28,9,1,9,Faculty & Staff Support,2,2271,88,2021-05-04 19:05:11,2021-05-04 19:46:22.394310
2984,21369,6,21369,31,2271,31,10,1,10,Friendships,2,2271,88,2021-05-04 19:05:11,2021-05-04 19:46:22.394310
2985,21380,5,21380,18,2274,18,6,1,6,Life - School Balance,2,2274,91,2021-05-04 19:05:11,2021-05-04 21:15:02.225114
2986,21381,6,21381,20,2274,20,7,1,7,Discrimination,2,2274,91,2021-05-04 19:05:11,2021-05-04 21:15:02.225114
2987,21382,2,21382,25,2274,25,8,0,8,Financial Pressure,2,2274,91,2021-05-04 19:05:11,2021-05-04 21:15:02.225114
2988,21383,5,21383,28,2274,28,9,1,9,Faculty & Staff Support,2,2274,91,2021-05-04 19:05:11,2021-05-04 21:15:02.225114
2989,21384,6,21384,31,2274,31,10,1,10,Friendships,2,2274,91,2021-05-04 19:05:11,2021-05-04 21:15:02.225114
2990,21415,1,21415,18,2281,18,6,1,6,Life - School Balance,2,2281,100,2021-05-04 19:05:12,2021-05-04 19:07:21.461883
2991,21416,6,21416,21,2281,21,7,1,7,Discrimination,2,2281,100,2021-05-04 19:05:12,2021-05-04 19:07:21.461883
2992,21417,2,21417,22,2281,22,8,1,8,Financial Pressure,2,2281,100,2021-05-04 19:05:12,2021-05-04 19:07:21.461883
2993,21418,5,21418,27,2281,27,9,1,9,Faculty & Staff Support,2,2281,100,2021-05-04 19:05:12,2021-05-04 19:07:21.461883
2994,21419,4,21419,31,2281,31,10,1,10,Friendships,2,2281,100,2021-05-04 19:05:12,2021-05-04 19:07:21.461883
2995,21559,3,21559,18,2308,18,6,1,6,Life - School Balance,2,2308,18,2021-05-06 14:05:03,2021-05-06 14:05:48.335699
2996,21560,2,21560,21,2308,21,7,1,7,Discrimination,2,2308,18,2021-05-06 14:05:03,2021-05-06 14:05:48.335699
2997,21561,6,21561,24,2308,24,8,1,8,Financial Pressure,2,2308,18,2021-05-06 14:05:03,2021-05-06 14:05:48.335699
2998,21562,4,21562,27,2308,27,9,1,9,Faculty & Staff Support,2,2308,18,2021-05-06 14:05:03,2021-05-06 14:05:48.335699
2999,21563,4,21563,30,2308,30,10,1,10,Friendships,2,2308,18,2021-05-06 14:05:03,2021-05-06 14:05:48.335699
3000,21564,5,21564,18,2309,18,6,1,6,Life - School Balance,2,2309,19,2021-05-06 14:05:03,2021-05-06 18:30:45.144416
3001,21565,5,21565,21,2309,21,7,1,7,Discrimination,2,2309,19,2021-05-06 14:05:03,2021-05-06 18:30:45.144416
3002,21566,3,21566,25,2309,25,8,0,8,Financial Pressure,2,2309,19,2021-05-06 14:05:03,2021-05-06 18:30:45.144416
3003,21567,5,21567,27,2309,27,9,1,9,Faculty & Staff Support,2,2309,19,2021-05-06 14:05:03,2021-05-06 18:30:45.144416
3004,21568,6,21568,32,2309,32,10,1,10,Friendships,2,2309,19,2021-05-06 14:05:03,2021-05-06 18:30:45.144416
3005,21569,4,21569,18,2310,18,6,1,6,Life - School Balance,2,2310,20,2021-05-06 14:05:04,2021-05-06 15:45:07.320945
3006,21570,3,21570,19,2310,19,7,0,7,Discrimination,2,2310,20,2021-05-06 14:05:04,2021-05-06 15:45:07.320945
3007,21571,5,21571,24,2310,24,8,1,8,Financial Pressure,2,2310,20,2021-05-06 14:05:04,2021-05-06 15:45:07.320945
3008,21572,4,21572,29,2310,29,9,0,9,Faculty & Staff Support,2,2310,20,2021-05-06 14:05:04,2021-05-06 15:45:07.320945
3009,21573,4,21573,32,2310,32,10,1,10,Friendships,2,2310,20,2021-05-06 14:05:04,2021-05-06 15:45:07.320945
3010,21584,4,21584,18,2313,18,6,1,6,Life - School Balance,2,2313,26,2021-05-06 14:05:04,2021-05-06 15:13:03.041164
3011,21585,6,21585,20,2313,20,7,1,7,Discrimination,2,2313,26,2021-05-06 14:05:04,2021-05-06 15:13:03.041164
3012,21586,4,21586,22,2313,22,8,1,8,Financial Pressure,2,2313,26,2021-05-06 14:05:04,2021-05-06 15:13:03.041164
3013,21587,5,21587,28,2313,28,9,1,9,Faculty & Staff Support,2,2313,26,2021-05-06 14:05:04,2021-05-06 15:13:03.041164
3014,21588,5,21588,33,2313,33,10,0,10,Friendships,2,2313,26,2021-05-06 14:05:04,2021-05-06 15:13:03.041164
3015,21589,2,21589,18,2314,18,6,1,6,Life - School Balance,2,2314,27,2021-05-06 14:05:04,2021-05-06 17:17:02.800137
3016,21590,6,21590,20,2314,20,7,1,7,Discrimination,2,2314,27,2021-05-06 14:05:04,2021-05-06 17:17:02.800137
3017,21591,3,21591,25,2314,25,8,0,8,Financial Pressure,2,2314,27,2021-05-06 14:05:04,2021-05-06 17:17:02.800137
3018,21592,5,21592,27,2314,27,9,1,9,Faculty & Staff Support,2,2314,27,2021-05-06 14:05:04,2021-05-06 17:17:02.800137
3019,21593,5,21593,33,2314,33,10,0,10,Friendships,2,2314,27,2021-05-06 14:05:04,2021-05-06 17:17:02.800137
3020,21599,2,21599,18,2316,18,6,1,6,Life - School Balance,2,2316,30,2021-05-06 14:05:05,2021-05-06 14:10:46.782365
3021,21600,6,21600,20,2316,20,7,1,7,Discrimination,2,2316,30,2021-05-06 14:05:05,2021-05-06 14:10:46.782365
3022,21601,4,21601,25,2316,25,8,0,8,Financial Pressure,2,2316,30,2021-05-06 14:05:05,2021-05-06 14:10:46.782365
3023,21602,4,21602,26,2316,26,9,1,9,Faculty & Staff Support,2,2316,30,2021-05-06 14:05:05,2021-05-06 14:10:46.782365
3024,21603,5,21603,33,2316,33,10,0,10,Friendships,2,2316,30,2021-05-06 14:05:05,2021-05-06 14:10:46.782365
3025,21644,4,21644,18,2325,18,6,1,6,Life - School Balance,2,2325,44,2021-05-06 14:05:06,2021-05-06 15:29:02.819668
3026,21645,5,21645,21,2325,21,7,1,7,Discrimination,2,2325,44,2021-05-06 14:05:06,2021-05-06 15:29:02.819668
3027,21646,4,21646,22,2325,22,8,1,8,Financial Pressure,2,2325,44,2021-05-06 14:05:06,2021-05-06 15:29:02.819668
3028,21647,4,21647,29,2325,29,9,0,9,Faculty & Staff Support,2,2325,44,2021-05-06 14:05:06,2021-05-06 15:29:02.819668
3029,21648,5,21648,32,2325,32,10,1,10,Friendships,2,2325,44,2021-05-06 14:05:06,2021-05-06 15:29:02.819668
3030,21679,4,21679,18,2332,18,6,1,6,Life - School Balance,2,2332,52,2021-05-06 14:05:07,2021-05-06 23:41:23.648223
3031,21680,1,21680,21,2332,21,7,1,7,Discrimination,2,2332,52,2021-05-06 14:05:07,2021-05-06 23:41:23.648223
3032,21681,6,21681,24,2332,24,8,1,8,Financial Pressure,2,2332,52,2021-05-06 14:05:07,2021-05-06 23:41:23.648223
3033,21682,5,21682,28,2332,28,9,1,9,Faculty & Staff Support,2,2332,52,2021-05-06 14:05:07,2021-05-06 23:41:23.648223
3034,21683,4,21683,30,2332,30,10,1,10,Friendships,2,2332,52,2021-05-06 14:05:07,2021-05-06 23:41:23.648223
3035,21729,6,21729,18,2342,18,6,1,6,Life - School Balance,2,2342,66,2021-05-06 14:05:09,2021-05-06 14:06:10.297789
3036,21730,5,21730,19,2342,19,7,0,7,Discrimination,2,2342,66,2021-05-06 14:05:09,2021-05-06 14:06:10.297789
3037,21731,3,21731,23,2342,23,8,1,8,Financial Pressure,2,2342,66,2021-05-06 14:05:09,2021-05-06 14:06:10.297789
3038,21732,6,21732,27,2342,27,9,1,9,Faculty & Staff Support,2,2342,66,2021-05-06 14:05:09,2021-05-06 14:06:10.297789
3039,21733,5,21733,33,2342,33,10,0,10,Friendships,2,2342,66,2021-05-06 14:05:09,2021-05-06 14:06:10.297789
3040,21734,4,21734,18,2343,18,6,1,6,Life - School Balance,2,2343,67,2021-05-06 14:05:09,2021-05-06 18:14:01.331087
3041,21735,4,21735,20,2343,20,7,1,7,Discrimination,2,2343,67,2021-05-06 14:05:09,2021-05-06 18:14:01.331087
3042,21736,6,21736,24,2343,24,8,1,8,Financial Pressure,2,2343,67,2021-05-06 14:05:09,2021-05-06 18:14:01.331087
3043,21737,4,21737,28,2343,28,9,1,9,Faculty & Staff Support,2,2343,67,2021-05-06 14:05:09,2021-05-06 18:14:01.331087
3044,21738,4,21738,31,2343,31,10,1,10,Friendships,2,2343,67,2021-05-06 14:05:09,2021-05-06 18:14:01.331087
3045,21779,4,21779,18,2352,18,6,1,6,Life - School Balance,2,2352,76,2021-05-06 14:05:11,2021-05-06 14:19:03.441687
3046,21780,4,21780,21,2352,21,7,1,7,Discrimination,2,2352,76,2021-05-06 14:05:11,2021-05-06 14:19:03.441687
3047,21781,3,21781,24,2352,24,8,1,8,Financial Pressure,2,2352,76,2021-05-06 14:05:11,2021-05-06 14:19:03.441687
3048,21782,5,21782,26,2352,26,9,1,9,Faculty & Staff Support,2,2352,76,2021-05-06 14:05:11,2021-05-06 14:19:03.441687
3049,21783,4,21783,30,2352,30,10,1,10,Friendships,2,2352,76,2021-05-06 14:05:11,2021-05-06 14:19:03.441687
3050,21784,2,21784,18,2353,18,6,1,6,Life - School Balance,2,2353,77,2021-05-06 14:05:11,2021-05-06 14:28:59.112824
3051,21785,5,21785,19,2353,19,7,0,7,Discrimination,2,2353,77,2021-05-06 14:05:11,2021-05-06 14:28:59.112824
3052,21786,4,21786,23,2353,23,8,1,8,Financial Pressure,2,2353,77,2021-05-06 14:05:11,2021-05-06 14:28:59.112824
3053,21787,4,21787,29,2353,29,9,0,9,Faculty & Staff Support,2,2353,77,2021-05-06 14:05:11,2021-05-06 14:28:59.112824
3054,21788,3,21788,31,2353,31,10,1,10,Friendships,2,2353,77,2021-05-06 14:05:11,2021-05-06 14:28:59.112824
3055,21809,5,21809,18,2358,18,6,1,6,Life - School Balance,2,2358,86,2021-05-06 14:05:12,2021-05-06 14:08:11.615785
3056,21810,5,21810,21,2358,21,7,1,7,Discrimination,2,2358,86,2021-05-06 14:05:12,2021-05-06 14:08:11.615785
3057,21811,3,21811,24,2358,24,8,1,8,Financial Pressure,2,2358,86,2021-05-06 14:05:12,2021-05-06 14:08:11.615785
3058,21812,5,21812,28,2358,28,9,1,9,Faculty & Staff Support,2,2358,86,2021-05-06 14:05:12,2021-05-06 14:08:11.615785
3059,21813,5,21813,31,2358,31,10,1,10,Friendships,2,2358,86,2021-05-06 14:05:12,2021-05-06 14:08:11.615785
3060,21829,3,21829,18,2362,18,6,1,6,Life - School Balance,2,2362,90,2021-05-06 14:05:12,2021-05-06 14:08:22.364451
3061,21830,4,21830,19,2362,19,7,0,7,Discrimination,2,2362,90,2021-05-06 14:05:12,2021-05-06 14:08:22.364451
3062,21831,4,21831,23,2362,23,8,1,8,Financial Pressure,2,2362,90,2021-05-06 14:05:12,2021-05-06 14:08:22.364451
3063,21832,5,21832,27,2362,27,9,1,9,Faculty & Staff Support,2,2362,90,2021-05-06 14:05:12,2021-05-06 14:08:22.364451
3064,21833,6,21833,32,2362,32,10,1,10,Friendships,2,2362,90,2021-05-06 14:05:12,2021-05-06 14:08:22.364451
3065,21834,5,21834,18,2363,18,6,1,6,Life - School Balance,2,2363,91,2021-05-06 14:05:12,2021-05-06 14:06:41.400791
3066,21835,6,21835,19,2363,19,7,0,7,Discrimination,2,2363,91,2021-05-06 14:05:12,2021-05-06 14:06:41.400791
3067,21836,2,21836,24,2363,24,8,1,8,Financial Pressure,2,2363,91,2021-05-06 14:05:12,2021-05-06 14:06:41.400791
3068,21837,6,21837,28,2363,28,9,1,9,Faculty & Staff Support,2,2363,91,2021-05-06 14:05:12,2021-05-06 14:06:41.400791
3069,21838,6,21838,33,2363,33,10,0,10,Friendships,2,2363,91,2021-05-06 14:05:12,2021-05-06 14:06:41.400791
3070,21844,6,21844,18,2365,18,6,1,6,Life - School Balance,2,2365,94,2021-05-06 14:05:13,2021-05-06 14:20:47.097600
3071,21845,6,21845,19,2365,19,7,0,7,Discrimination,2,2365,94,2021-05-06 14:05:13,2021-05-06 14:20:47.097600
3072,21846,3,21846,23,2365,23,8,1,8,Financial Pressure,2,2365,94,2021-05-06 14:05:13,2021-05-06 14:20:47.097600
3073,21847,6,21847,29,2365,29,9,0,9,Faculty & Staff Support,2,2365,94,2021-05-06 14:05:13,2021-05-06 14:20:47.097600
3074,21848,6,21848,30,2365,30,10,1,10,Friendships,2,2365,94,2021-05-06 14:05:13,2021-05-06 14:20:47.097600
3075,21874,2,21874,18,2371,18,6,1,6,Life - School Balance,2,2371,101,2021-05-06 14:05:13,2021-05-06 14:31:43.353191
3076,21875,6,21875,19,2371,19,7,0,7,Discrimination,2,2371,101,2021-05-06 14:05:13,2021-05-06 14:31:43.353191
3077,21876,5,21876,25,2371,25,8,0,8,Financial Pressure,2,2371,101,2021-05-06 14:05:13,2021-05-06 14:31:43.353191
3078,21877,5,21877,28,2371,28,9,1,9,Faculty & Staff Support,2,2371,101,2021-05-06 14:05:13,2021-05-06 14:31:43.353191
3079,21878,5,21878,32,2371,32,10,1,10,Friendships,2,2371,101,2021-05-06 14:05:13,2021-05-06 14:31:43.353191
3080,31,4,31,16,146,16,6,1,6,Life - School Balance,2,146,10,2021-03-16 17:05:02,2021-03-16 17:33:42.231423
3081,32,4,32,20,146,20,7,1,7,Discrimination,2,146,10,2021-03-16 17:05:02,2021-03-16 17:33:42.231423
3082,33,6,33,24,146,24,8,1,8,Financial Pressure,2,146,10,2021-03-16 17:05:02,2021-03-16 17:33:42.231423
3083,286,1,286,16,197,16,6,1,6,Life - School Balance,2,197,78,2021-03-16 17:05:12,2021-03-16 20:14:21.823101
3084,287,5,287,20,197,20,7,1,7,Discrimination,2,197,78,2021-03-16 17:05:12,2021-03-16 20:14:21.823101
3085,288,5,288,24,197,24,8,1,8,Financial Pressure,2,197,78,2021-03-16 17:05:12,2021-03-16 20:14:21.823101
3086,289,2,289,28,197,28,9,1,9,Faculty & Staff Support,2,197,78,2021-03-16 17:05:12,2021-03-16 20:14:21.823101
3087,290,6,290,33,197,33,10,0,10,Friendships,2,197,78,2021-03-16 17:05:12,2021-03-16 20:14:21.823101
3088,321,4,321,16,204,16,6,1,6,Life - School Balance,2,204,9,2021-03-16 19:05:02,2021-03-17 15:08:21.850990
3089,322,6,322,19,204,19,7,0,7,Discrimination,2,204,9,2021-03-16 19:05:02,2021-03-17 15:08:21.850990
3090,323,4,323,22,204,22,8,1,8,Financial Pressure,2,204,9,2021-03-16 19:05:02,2021-03-17 15:08:21.850990
3091,324,5,324,28,204,28,9,1,9,Faculty & Staff Support,2,204,9,2021-03-16 19:05:02,2021-03-17 15:08:21.850990
3092,325,6,325,31,204,31,10,1,10,Friendships,2,204,9,2021-03-16 19:05:02,2021-03-17 15:08:21.850990
3093,376,3,376,16,215,16,6,1,6,Life - School Balance,2,215,26,2021-03-16 19:05:04,2021-03-16 19:27:16.983411
3094,377,6,377,19,215,19,7,0,7,Discrimination,2,215,26,2021-03-16 19:05:04,2021-03-16 19:27:16.983411
3095,378,5,378,24,215,24,8,1,8,Financial Pressure,2,215,26,2021-03-16 19:05:04,2021-03-16 19:27:16.983411
3096,379,6,379,27,215,27,9,1,9,Faculty & Staff Support,2,215,26,2021-03-16 19:05:04,2021-03-16 19:27:16.983411
3097,380,5,380,31,215,31,10,1,10,Friendships,2,215,26,2021-03-16 19:05:04,2021-03-16 19:27:16.983411
3098,386,2,386,16,217,16,6,1,6,Life - School Balance,2,217,28,2021-03-16 19:05:04,2021-03-16 21:34:57.608333
3099,387,4,387,21,217,21,7,1,7,Discrimination,2,217,28,2021-03-16 19:05:04,2021-03-16 21:34:57.608333
3100,388,5,388,25,217,25,8,0,8,Financial Pressure,2,217,28,2021-03-16 19:05:04,2021-03-16 21:34:57.608333
3101,389,6,389,29,217,29,9,0,9,Faculty & Staff Support,2,217,28,2021-03-16 19:05:04,2021-03-16 21:34:57.608333
3102,390,6,390,32,217,32,10,1,10,Friendships,2,217,28,2021-03-16 19:05:04,2021-03-16 21:34:57.608333
3103,456,3,456,16,231,16,6,1,6,Life - School Balance,2,231,48,2021-03-16 19:05:07,2021-03-17 04:18:15.720492
3104,457,5,457,21,231,21,7,1,7,Discrimination,2,231,48,2021-03-16 19:05:07,2021-03-17 04:18:15.720492
3105,458,4,458,23,231,23,8,1,8,Financial Pressure,2,231,48,2021-03-16 19:05:07,2021-03-17 04:18:15.720492
3106,459,5,459,27,231,27,9,1,9,Faculty & Staff Support,2,231,48,2021-03-16 19:05:07,2021-03-17 04:18:15.720492
3107,460,6,460,30,231,30,10,1,10,Friendships,2,231,48,2021-03-16 19:05:07,2021-03-17 04:18:15.720492
3108,496,4,496,16,239,16,6,1,6,Life - School Balance,2,239,60,2021-03-16 19:05:08,2021-03-16 20:25:16.222908
3109,497,3,497,21,239,21,7,1,7,Discrimination,2,239,60,2021-03-16 19:05:08,2021-03-16 20:25:16.222908
3110,498,6,498,24,239,24,8,1,8,Financial Pressure,2,239,60,2021-03-16 19:05:08,2021-03-16 20:25:16.222908
3111,499,6,499,27,239,27,9,1,9,Faculty & Staff Support,2,239,60,2021-03-16 19:05:08,2021-03-16 20:25:16.222908
3112,500,6,500,31,239,31,10,1,10,Friendships,2,239,60,2021-03-16 19:05:08,2021-03-16 20:25:16.222908
3113,586,4,586,16,257,16,6,1,6,Life - School Balance,2,257,79,2021-03-16 19:05:11,2021-03-16 22:18:06.434276
3114,587,6,587,19,257,19,7,0,7,Discrimination,2,257,79,2021-03-16 19:05:11,2021-03-16 22:18:06.434276
3115,588,4,588,23,257,23,8,1,8,Financial Pressure,2,257,79,2021-03-16 19:05:11,2021-03-16 22:18:06.434276
3116,589,6,589,28,257,28,9,1,9,Faculty & Staff Support,2,257,79,2021-03-16 19:05:11,2021-03-16 22:18:06.434276
3117,590,6,590,33,257,33,10,0,10,Friendships,2,257,79,2021-03-16 19:05:11,2021-03-16 22:18:06.434276
3118,626,3,626,16,265,16,6,1,6,Life - School Balance,2,265,13,2021-03-18 14:05:02,2021-03-18 14:47:02.890217
3119,627,5,627,20,265,20,7,1,7,Discrimination,2,265,13,2021-03-18 14:05:02,2021-03-18 14:47:02.890217
3120,628,5,628,25,265,25,8,0,8,Financial Pressure,2,265,13,2021-03-18 14:05:02,2021-03-18 14:47:02.890217
3121,629,5,629,29,265,29,9,0,9,Faculty & Staff Support,2,265,13,2021-03-18 14:05:02,2021-03-18 14:47:02.890217
3122,630,5,630,32,265,32,10,1,10,Friendships,2,265,13,2021-03-18 14:05:02,2021-03-18 14:47:02.890217
3123,651,4,651,16,270,16,6,1,6,Life - School Balance,2,270,19,2021-03-18 14:05:03,2021-03-18 14:41:06.115883
3124,652,5,652,21,270,21,7,1,7,Discrimination,2,270,19,2021-03-18 14:05:03,2021-03-18 14:41:06.115883
3125,653,5,653,23,270,23,8,1,8,Financial Pressure,2,270,19,2021-03-18 14:05:03,2021-03-18 14:41:06.115883
3126,654,5,654,29,270,29,9,0,9,Faculty & Staff Support,2,270,19,2021-03-18 14:05:03,2021-03-18 14:41:06.115883
3127,655,5,655,32,270,32,10,1,10,Friendships,2,270,19,2021-03-18 14:05:03,2021-03-18 14:41:06.115883
3128,661,2,661,16,272,16,6,1,6,Life - School Balance,2,272,22,2021-03-18 14:05:03,2021-03-18 14:37:13.665350
3129,662,4,662,21,272,21,7,1,7,Discrimination,2,272,22,2021-03-18 14:05:03,2021-03-18 14:37:13.665350
3130,663,6,663,23,272,23,8,1,8,Financial Pressure,2,272,22,2021-03-18 14:05:03,2021-03-18 14:37:13.665350
3131,664,5,664,26,272,26,9,1,9,Faculty & Staff Support,2,272,22,2021-03-18 14:05:03,2021-03-18 14:37:13.665350
3132,665,3,665,33,272,33,10,0,10,Friendships,2,272,22,2021-03-18 14:05:03,2021-03-18 14:37:13.665350
3133,666,2,666,16,273,16,6,1,6,Life - School Balance,2,273,23,2021-03-18 14:05:04,2021-03-18 16:48:27.450574
3134,667,5,667,19,273,19,7,0,7,Discrimination,2,273,23,2021-03-18 14:05:04,2021-03-18 16:48:27.450574
3135,668,6,668,22,273,22,8,1,8,Financial Pressure,2,273,23,2021-03-18 14:05:04,2021-03-18 16:48:27.450574
3136,669,6,669,29,273,29,9,0,9,Faculty & Staff Support,2,273,23,2021-03-18 14:05:04,2021-03-18 16:48:27.450574
3137,670,3,670,33,273,33,10,0,10,Friendships,2,273,23,2021-03-18 14:05:04,2021-03-18 16:48:27.450574
3138,676,2,676,16,275,16,6,1,6,Life - School Balance,2,275,27,2021-03-18 14:05:04,2021-03-18 14:31:59.411593
3139,677,5,677,19,275,19,7,0,7,Discrimination,2,275,27,2021-03-18 14:05:04,2021-03-18 14:31:59.411593
3140,678,4,678,25,275,25,8,0,8,Financial Pressure,2,275,27,2021-03-18 14:05:04,2021-03-18 14:31:59.411593
3141,679,5,679,27,275,27,9,1,9,Faculty & Staff Support,2,275,27,2021-03-18 14:05:04,2021-03-18 14:31:59.411593
3142,680,6,680,31,275,31,10,1,10,Friendships,2,275,27,2021-03-18 14:05:04,2021-03-18 14:31:59.411593
3143,691,4,691,16,278,16,6,1,6,Life - School Balance,2,278,31,2021-03-18 14:05:04,2021-03-18 14:06:28.164217
3144,692,6,692,21,278,21,7,1,7,Discrimination,2,278,31,2021-03-18 14:05:04,2021-03-18 14:06:28.164217
3145,693,6,693,24,278,24,8,1,8,Financial Pressure,2,278,31,2021-03-18 14:05:04,2021-03-18 14:06:28.164217
3146,694,4,694,29,278,29,9,0,9,Faculty & Staff Support,2,278,31,2021-03-18 14:05:04,2021-03-18 14:06:28.164217
3147,695,4,695,33,278,33,10,0,10,Friendships,2,278,31,2021-03-18 14:05:04,2021-03-18 14:06:28.164217
3148,711,4,711,16,282,16,6,1,6,Life - School Balance,2,282,36,2021-03-18 14:05:05,2021-03-18 16:02:26.679955
3149,712,3,712,19,282,19,7,0,7,Discrimination,2,282,36,2021-03-18 14:05:05,2021-03-18 16:02:26.679955
3150,713,5,713,25,282,25,8,0,8,Financial Pressure,2,282,36,2021-03-18 14:05:05,2021-03-18 16:02:26.679955
3151,714,4,714,29,282,29,9,0,9,Faculty & Staff Support,2,282,36,2021-03-18 14:05:05,2021-03-18 16:02:26.679955
3152,715,5,715,33,282,33,10,0,10,Friendships,2,282,36,2021-03-18 14:05:05,2021-03-18 16:02:26.679955
3153,786,3,786,16,297,16,6,1,6,Life - School Balance,2,297,58,2021-03-18 14:05:08,2021-03-18 14:19:03.802495
3154,787,4,787,21,297,21,7,1,7,Discrimination,2,297,58,2021-03-18 14:05:08,2021-03-18 14:19:03.802495
3155,788,2,788,24,297,24,8,1,8,Financial Pressure,2,297,58,2021-03-18 14:05:08,2021-03-18 14:19:03.802495
3156,789,5,789,28,297,28,9,1,9,Faculty & Staff Support,2,297,58,2021-03-18 14:05:08,2021-03-18 14:19:03.802495
3157,790,5,790,32,297,32,10,1,10,Friendships,2,297,58,2021-03-18 14:05:08,2021-03-18 14:19:03.802495
3158,796,4,796,16,299,16,6,1,6,Life - School Balance,2,299,61,2021-03-18 14:05:08,2021-03-18 19:42:41.160074
3159,797,4,797,20,299,20,7,1,7,Discrimination,2,299,61,2021-03-18 14:05:08,2021-03-18 19:42:41.160074
3160,798,4,798,23,299,23,8,1,8,Financial Pressure,2,299,61,2021-03-18 14:05:08,2021-03-18 19:42:41.160074
3161,799,4,799,28,299,28,9,1,9,Faculty & Staff Support,2,299,61,2021-03-18 14:05:08,2021-03-18 19:42:41.160074
3162,800,4,800,31,299,31,10,1,10,Friendships,2,299,61,2021-03-18 14:05:08,2021-03-18 19:42:41.160074
3163,801,4,801,16,300,16,6,1,6,Life - School Balance,2,300,62,2021-03-18 14:05:08,2021-03-18 14:06:15.965259
3164,802,1,802,21,300,21,7,1,7,Discrimination,2,300,62,2021-03-18 14:05:08,2021-03-18 14:06:15.965259
3165,803,4,803,23,300,23,8,1,8,Financial Pressure,2,300,62,2021-03-18 14:05:08,2021-03-18 14:06:15.965259
3166,804,4,804,28,300,28,9,1,9,Faculty & Staff Support,2,300,62,2021-03-18 14:05:08,2021-03-18 14:06:15.965259
3167,805,6,805,31,300,31,10,1,10,Friendships,2,300,62,2021-03-18 14:05:08,2021-03-18 14:06:15.965259
3168,816,5,816,16,303,16,6,1,6,Life - School Balance,2,303,66,2021-03-18 14:05:09,2021-03-18 14:23:39.404446
3169,817,5,817,20,303,20,7,1,7,Discrimination,2,303,66,2021-03-18 14:05:09,2021-03-18 14:23:39.404446
3170,818,5,818,24,303,24,8,1,8,Financial Pressure,2,303,66,2021-03-18 14:05:09,2021-03-18 14:23:39.404446
3171,819,5,819,26,303,26,9,1,9,Faculty & Staff Support,2,303,66,2021-03-18 14:05:09,2021-03-18 14:23:39.404446
3172,820,4,820,31,303,31,10,1,10,Friendships,2,303,66,2021-03-18 14:05:09,2021-03-18 14:23:39.404446
3173,831,5,831,16,306,16,6,1,6,Life - School Balance,2,306,69,2021-03-18 14:05:09,2021-03-18 14:37:03.234633
3174,832,5,832,19,306,19,7,0,7,Discrimination,2,306,69,2021-03-18 14:05:09,2021-03-18 14:37:03.234633
3175,833,4,833,25,306,25,8,0,8,Financial Pressure,2,306,69,2021-03-18 14:05:09,2021-03-18 14:37:03.234633
3176,834,4,834,28,306,28,9,1,9,Faculty & Staff Support,2,306,69,2021-03-18 14:05:09,2021-03-18 14:37:03.234633
3177,835,4,835,30,306,30,10,1,10,Friendships,2,306,69,2021-03-18 14:05:09,2021-03-18 14:37:03.234633
3178,866,2,866,16,313,16,6,1,6,Life - School Balance,2,313,76,2021-03-18 14:05:10,2021-03-18 14:07:27.839661
3179,867,4,867,20,313,20,7,1,7,Discrimination,2,313,76,2021-03-18 14:05:10,2021-03-18 14:07:27.839661
3180,868,2,868,24,313,24,8,1,8,Financial Pressure,2,313,76,2021-03-18 14:05:10,2021-03-18 14:07:27.839661
3181,869,5,869,28,313,28,9,1,9,Faculty & Staff Support,2,313,76,2021-03-18 14:05:10,2021-03-18 14:07:27.839661
3182,870,4,870,30,313,30,10,1,10,Friendships,2,313,76,2021-03-18 14:05:10,2021-03-18 14:07:27.839661
3183,871,3,871,16,314,16,6,1,6,Life - School Balance,2,314,77,2021-03-18 14:05:10,2021-03-18 15:15:42.548930
3184,872,5,872,21,314,21,7,1,7,Discrimination,2,314,77,2021-03-18 14:05:10,2021-03-18 15:15:42.548930
3185,873,4,873,22,314,22,8,1,8,Financial Pressure,2,314,77,2021-03-18 14:05:10,2021-03-18 15:15:42.548930
3186,874,5,874,27,314,27,9,1,9,Faculty & Staff Support,2,314,77,2021-03-18 14:05:10,2021-03-18 15:15:42.548930
3187,875,4,875,30,314,30,10,1,10,Friendships,2,314,77,2021-03-18 14:05:10,2021-03-18 15:15:42.548930
3188,876,1,876,16,315,16,6,1,6,Life - School Balance,2,315,78,2021-03-18 14:05:10,2021-03-18 17:45:35.377160
3189,877,6,877,20,315,20,7,1,7,Discrimination,2,315,78,2021-03-18 14:05:10,2021-03-18 17:45:35.377160
3190,878,2,878,25,315,25,8,0,8,Financial Pressure,2,315,78,2021-03-18 14:05:10,2021-03-18 17:45:35.377160
3191,879,5,879,27,315,27,9,1,9,Faculty & Staff Support,2,315,78,2021-03-18 14:05:10,2021-03-18 17:45:35.377160
3192,880,6,880,31,315,31,10,1,10,Friendships,2,315,78,2021-03-18 14:05:10,2021-03-18 17:45:35.377160
3193,881,3,881,16,316,16,6,1,6,Life - School Balance,2,316,79,2021-03-18 14:05:11,2021-03-18 14:07:16.055632
3194,882,2,882,21,316,21,7,1,7,Discrimination,2,316,79,2021-03-18 14:05:11,2021-03-18 14:07:16.055632
3195,883,4,883,25,316,25,8,0,8,Financial Pressure,2,316,79,2021-03-18 14:05:11,2021-03-18 14:07:16.055632
3196,884,6,884,26,316,26,9,1,9,Faculty & Staff Support,2,316,79,2021-03-18 14:05:11,2021-03-18 14:07:16.055632
3197,885,4,885,32,316,32,10,1,10,Friendships,2,316,79,2021-03-18 14:05:11,2021-03-18 14:07:16.055632
3198,921,4,921,16,350,16,6,1,6,Life - School Balance,2,350,13,2021-03-23 19:05:02,2021-03-24 14:37:59.970229
3199,922,4,922,19,350,19,7,0,7,Discrimination,2,350,13,2021-03-23 19:05:02,2021-03-24 14:37:59.970229
3200,923,3,923,24,350,24,8,1,8,Financial Pressure,2,350,13,2021-03-23 19:05:02,2021-03-24 14:37:59.970229
3201,924,5,924,27,350,27,9,1,9,Faculty & Staff Support,2,350,13,2021-03-23 19:05:02,2021-03-24 14:37:59.970229
3202,925,5,925,32,350,32,10,1,10,Friendships,2,350,13,2021-03-23 19:05:02,2021-03-24 14:37:59.970229
3203,951,4,951,16,356,16,6,1,6,Life - School Balance,2,356,20,2021-03-23 19:05:03,2021-03-24 04:13:44.588230
3204,952,3,952,19,356,19,7,0,7,Discrimination,2,356,20,2021-03-23 19:05:03,2021-03-24 04:13:44.588230
3205,953,5,953,25,356,25,8,0,8,Financial Pressure,2,356,20,2021-03-23 19:05:03,2021-03-24 04:13:44.588230
3206,954,4,954,28,356,28,9,1,9,Faculty & Staff Support,2,356,20,2021-03-23 19:05:03,2021-03-24 04:13:44.588230
3207,955,4,955,32,356,32,10,1,10,Friendships,2,356,20,2021-03-23 19:05:03,2021-03-24 04:13:44.588230
3208,956,2,956,16,357,16,6,1,6,Life - School Balance,2,357,22,2021-03-23 19:05:03,2021-03-23 19:15:11.563920
3209,957,5,957,19,357,19,7,0,7,Discrimination,2,357,22,2021-03-23 19:05:03,2021-03-23 19:15:11.563920
3210,958,6,958,22,357,22,8,1,8,Financial Pressure,2,357,22,2021-03-23 19:05:03,2021-03-23 19:15:11.563920
3211,959,5,959,28,357,28,9,1,9,Faculty & Staff Support,2,357,22,2021-03-23 19:05:03,2021-03-23 19:15:11.563920
3212,960,6,960,31,357,31,10,1,10,Friendships,2,357,22,2021-03-23 19:05:03,2021-03-23 19:15:11.563920
3213,961,2,961,16,358,16,6,1,6,Life - School Balance,2,358,23,2021-03-23 19:05:03,2021-03-23 19:11:51.164337
3214,962,6,962,19,358,19,7,0,7,Discrimination,2,358,23,2021-03-23 19:05:03,2021-03-23 19:11:51.164337
3215,963,6,963,23,358,23,8,1,8,Financial Pressure,2,358,23,2021-03-23 19:05:03,2021-03-23 19:11:51.164337
3216,964,4,964,28,358,28,9,1,9,Faculty & Staff Support,2,358,23,2021-03-23 19:05:03,2021-03-23 19:11:51.164337
3217,965,3,965,33,358,33,10,0,10,Friendships,2,358,23,2021-03-23 19:05:03,2021-03-23 19:11:51.164337
3218,966,3,966,16,359,16,6,1,6,Life - School Balance,2,359,26,2021-03-23 19:05:03,2021-03-23 19:09:42.838763
3219,967,5,967,21,359,21,7,1,7,Discrimination,2,359,26,2021-03-23 19:05:03,2021-03-23 19:09:42.838763
3220,968,4,968,22,359,22,8,1,8,Financial Pressure,2,359,26,2021-03-23 19:05:03,2021-03-23 19:09:42.838763
3221,969,6,969,29,359,29,9,0,9,Faculty & Staff Support,2,359,26,2021-03-23 19:05:03,2021-03-23 19:09:42.838763
3222,970,5,970,30,359,30,10,1,10,Friendships,2,359,26,2021-03-23 19:05:03,2021-03-23 19:09:42.838763
3223,971,2,971,16,360,16,6,1,6,Life - School Balance,2,360,27,2021-03-23 19:05:04,2021-03-23 19:16:01.310879
3224,972,5,972,20,360,20,7,1,7,Discrimination,2,360,27,2021-03-23 19:05:04,2021-03-23 19:16:01.310879
3225,973,3,973,25,360,25,8,0,8,Financial Pressure,2,360,27,2021-03-23 19:05:04,2021-03-23 19:16:01.310879
3226,974,6,974,29,360,29,9,0,9,Faculty & Staff Support,2,360,27,2021-03-23 19:05:04,2021-03-23 19:16:01.310879
3227,975,3,975,32,360,32,10,1,10,Friendships,2,360,27,2021-03-23 19:05:04,2021-03-23 19:16:01.310879
3228,1101,4,1101,16,386,16,6,1,6,Life - School Balance,2,386,64,2021-03-23 19:05:08,2021-03-24 00:15:54.024338
3229,1102,6,1102,19,386,19,7,0,7,Discrimination,2,386,64,2021-03-23 19:05:08,2021-03-24 00:15:54.024338
3230,1103,4,1103,25,386,25,8,0,8,Financial Pressure,2,386,64,2021-03-23 19:05:08,2021-03-24 00:15:54.024338
3231,1104,3,1104,29,386,29,9,0,9,Faculty & Staff Support,2,386,64,2021-03-23 19:05:08,2021-03-24 00:15:54.024338
3232,1105,4,1105,30,386,30,10,1,10,Friendships,2,386,64,2021-03-23 19:05:08,2021-03-24 00:15:54.024338
3233,1111,5,1111,16,388,16,6,1,6,Life - School Balance,2,388,66,2021-03-23 19:05:08,2021-03-23 19:06:15.321949
3234,1112,5,1112,19,388,19,7,0,7,Discrimination,2,388,66,2021-03-23 19:05:08,2021-03-23 19:06:15.321949
3235,1113,4,1113,24,388,24,8,1,8,Financial Pressure,2,388,66,2021-03-23 19:05:08,2021-03-23 19:06:15.321949
3236,1114,5,1114,29,388,29,9,0,9,Faculty & Staff Support,2,388,66,2021-03-23 19:05:08,2021-03-23 19:06:15.321949
3237,1115,5,1115,32,388,32,10,1,10,Friendships,2,388,66,2021-03-23 19:05:08,2021-03-23 19:06:15.321949
3238,1131,3,1131,16,392,16,6,1,6,Life - School Balance,2,392,70,2021-03-23 19:05:09,2021-03-23 19:06:32.732152
3239,1132,3,1132,21,392,21,7,1,7,Discrimination,2,392,70,2021-03-23 19:05:09,2021-03-23 19:06:32.732152
3240,1133,3,1133,22,392,22,8,1,8,Financial Pressure,2,392,70,2021-03-23 19:05:09,2021-03-23 19:06:32.732152
3241,1134,5,1134,29,392,29,9,0,9,Faculty & Staff Support,2,392,70,2021-03-23 19:05:09,2021-03-23 19:06:32.732152
3242,1135,4,1135,32,392,32,10,1,10,Friendships,2,392,70,2021-03-23 19:05:09,2021-03-23 19:06:32.732152
3243,1141,4,1141,16,394,16,6,1,6,Life - School Balance,2,394,72,2021-03-23 19:05:09,2021-03-23 23:04:24.349897
3244,1142,4,1142,20,394,20,7,1,7,Discrimination,2,394,72,2021-03-23 19:05:09,2021-03-23 23:04:24.349897
3245,1143,5,1143,22,394,22,8,1,8,Financial Pressure,2,394,72,2021-03-23 19:05:09,2021-03-23 23:04:24.349897
3246,1144,4,1144,28,394,28,9,1,9,Faculty & Staff Support,2,394,72,2021-03-23 19:05:09,2021-03-23 23:04:24.349897
3247,1145,6,1145,31,394,31,10,1,10,Friendships,2,394,72,2021-03-23 19:05:09,2021-03-23 23:04:24.349897
3248,1161,3,1161,16,398,16,6,1,6,Life - School Balance,2,398,76,2021-03-23 19:05:10,2021-03-23 19:13:58.680083
3249,1162,4,1162,20,398,20,7,1,7,Discrimination,2,398,76,2021-03-23 19:05:10,2021-03-23 19:13:58.680083
3250,1163,2,1163,22,398,22,8,1,8,Financial Pressure,2,398,76,2021-03-23 19:05:10,2021-03-23 19:13:58.680083
3251,1164,5,1164,28,398,28,9,1,9,Faculty & Staff Support,2,398,76,2021-03-23 19:05:10,2021-03-23 19:13:58.680083
3252,1165,4,1165,33,398,33,10,0,10,Friendships,2,398,76,2021-03-23 19:05:10,2021-03-23 19:13:58.680083
3253,1166,2,1166,16,399,16,6,1,6,Life - School Balance,2,399,77,2021-03-23 19:05:10,2021-03-23 19:22:09.072176
3254,1167,5,1167,20,399,20,7,1,7,Discrimination,2,399,77,2021-03-23 19:05:10,2021-03-23 19:22:09.072176
3255,1168,3,1168,23,399,23,8,1,8,Financial Pressure,2,399,77,2021-03-23 19:05:10,2021-03-23 19:22:09.072176
3256,1169,4,1169,27,399,27,9,1,9,Faculty & Staff Support,2,399,77,2021-03-23 19:05:10,2021-03-23 19:22:09.072176
3257,1170,4,1170,33,399,33,10,0,10,Friendships,2,399,77,2021-03-23 19:05:10,2021-03-23 19:22:09.072176
3258,1176,4,1176,16,401,16,6,1,6,Life - School Balance,2,401,79,2021-03-23 19:05:10,2021-03-23 23:09:59.116932
3259,1177,4,1177,20,401,20,7,1,7,Discrimination,2,401,79,2021-03-23 19:05:10,2021-03-23 23:09:59.116932
3260,1178,5,1178,24,401,24,8,1,8,Financial Pressure,2,401,79,2021-03-23 19:05:10,2021-03-23 23:09:59.116932
3261,1179,6,1179,26,401,26,9,1,9,Faculty & Staff Support,2,401,79,2021-03-23 19:05:10,2021-03-23 23:09:59.116932
3262,1180,4,1180,30,401,30,10,1,10,Friendships,2,401,79,2021-03-23 19:05:10,2021-03-23 23:09:59.116932
3263,1191,4,1191,16,404,16,6,1,6,Life - School Balance,2,404,87,2021-03-23 19:05:11,2021-03-23 19:13:49.491200
3264,1192,4,1192,20,404,20,7,1,7,Discrimination,2,404,87,2021-03-23 19:05:11,2021-03-23 19:13:49.491200
3265,1193,5,1193,24,404,24,8,1,8,Financial Pressure,2,404,87,2021-03-23 19:05:11,2021-03-23 19:13:49.491200
3266,1194,5,1194,27,404,27,9,1,9,Faculty & Staff Support,2,404,87,2021-03-23 19:05:11,2021-03-23 19:13:49.491200
3267,1195,6,1195,33,404,33,10,0,10,Friendships,2,404,87,2021-03-23 19:05:11,2021-03-23 19:13:49.491200
3268,1211,5,1211,16,408,16,6,1,6,Life - School Balance,2,408,91,2021-03-23 19:05:11,2021-03-23 19:58:05.389501
3269,1212,6,1212,21,408,21,7,1,7,Discrimination,2,408,91,2021-03-23 19:05:11,2021-03-23 19:58:05.389501
3270,1213,2,1213,25,408,25,8,0,8,Financial Pressure,2,408,91,2021-03-23 19:05:11,2021-03-23 19:58:05.389501
3271,1214,5,1214,29,408,29,9,0,9,Faculty & Staff Support,2,408,91,2021-03-23 19:05:11,2021-03-23 19:58:05.389501
3272,1215,5,1215,33,408,33,10,0,10,Friendships,2,408,91,2021-03-23 19:05:11,2021-03-23 19:58:05.389501
3273,1256,5,1256,16,417,16,6,1,6,Life - School Balance,2,417,105,2021-03-23 19:05:13,2021-03-23 19:07:09.471241
3274,1257,3,1257,21,417,21,7,1,7,Discrimination,2,417,105,2021-03-23 19:05:13,2021-03-23 19:07:09.471241
3275,1258,4,1258,23,417,23,8,1,8,Financial Pressure,2,417,105,2021-03-23 19:05:13,2021-03-23 19:07:09.471241
3276,1259,5,1259,27,417,27,9,1,9,Faculty & Staff Support,2,417,105,2021-03-23 19:05:13,2021-03-23 19:07:09.471241
3277,1260,4,1260,30,417,30,10,1,10,Friendships,2,417,105,2021-03-23 19:05:13,2021-03-23 19:07:09.471241
3278,1321,5,1321,16,430,16,6,1,6,Life - School Balance,2,430,19,2021-03-25 14:05:03,2021-03-25 14:42:33.564155
3279,1322,5,1322,19,430,19,7,0,7,Discrimination,2,430,19,2021-03-25 14:05:03,2021-03-25 14:42:33.564155
3280,1323,5,1323,22,430,22,8,1,8,Financial Pressure,2,430,19,2021-03-25 14:05:03,2021-03-25 14:42:33.564155
3281,1324,5,1324,29,430,29,9,0,9,Faculty & Staff Support,2,430,19,2021-03-25 14:05:03,2021-03-25 14:42:33.564155
3282,1325,5,1325,31,430,31,10,1,10,Friendships,2,430,19,2021-03-25 14:05:03,2021-03-25 14:42:33.564155
3283,1351,2,1351,16,436,16,6,1,6,Life - School Balance,2,436,28,2021-03-25 14:05:04,2021-03-25 14:33:54.251095
3284,1352,6,1352,19,436,19,7,0,7,Discrimination,2,436,28,2021-03-25 14:05:04,2021-03-25 14:33:54.251095
3285,1353,5,1353,23,436,23,8,1,8,Financial Pressure,2,436,28,2021-03-25 14:05:04,2021-03-25 14:33:54.251095
3286,1354,5,1354,28,436,28,9,1,9,Faculty & Staff Support,2,436,28,2021-03-25 14:05:04,2021-03-25 14:33:54.251095
3287,1355,6,1355,32,436,32,10,1,10,Friendships,2,436,28,2021-03-25 14:05:04,2021-03-25 14:33:54.251095
3288,1361,3,1361,16,438,16,6,1,6,Life - School Balance,2,438,31,2021-03-25 14:05:04,2021-03-25 14:07:34.460894
3289,1362,6,1362,19,438,19,7,0,7,Discrimination,2,438,31,2021-03-25 14:05:04,2021-03-25 14:07:34.460894
3290,1363,6,1363,22,438,22,8,1,8,Financial Pressure,2,438,31,2021-03-25 14:05:04,2021-03-25 14:07:34.460894
3291,1364,3,1364,28,438,28,9,1,9,Faculty & Staff Support,2,438,31,2021-03-25 14:05:04,2021-03-25 14:07:34.460894
3292,1365,3,1365,32,438,32,10,1,10,Friendships,2,438,31,2021-03-25 14:05:04,2021-03-25 14:07:34.460894
3293,1381,4,1381,16,442,16,6,1,6,Life - School Balance,2,442,36,2021-03-25 14:05:05,2021-03-25 15:31:27.693400
3294,1382,2,1382,19,442,19,7,0,7,Discrimination,2,442,36,2021-03-25 14:05:05,2021-03-25 15:31:27.693400
3295,1383,4,1383,22,442,22,8,1,8,Financial Pressure,2,442,36,2021-03-25 14:05:05,2021-03-25 15:31:27.693400
3296,1384,4,1384,28,442,28,9,1,9,Faculty & Staff Support,2,442,36,2021-03-25 14:05:05,2021-03-25 15:31:27.693400
3297,1385,5,1385,33,442,33,10,0,10,Friendships,2,442,36,2021-03-25 14:05:05,2021-03-25 15:31:27.693400
3298,1401,4,1401,16,446,16,6,1,6,Life - School Balance,2,446,44,2021-03-25 14:05:05,2021-03-25 14:13:20.367677
3299,1402,6,1402,19,446,19,7,0,7,Discrimination,2,446,44,2021-03-25 14:05:05,2021-03-25 14:13:20.367677
3300,1403,4,1403,25,446,25,8,0,8,Financial Pressure,2,446,44,2021-03-25 14:05:05,2021-03-25 14:13:20.367677
3301,1404,5,1404,27,446,27,9,1,9,Faculty & Staff Support,2,446,44,2021-03-25 14:05:05,2021-03-25 14:13:20.367677
3302,1405,4,1405,30,446,30,10,1,10,Friendships,2,446,44,2021-03-25 14:05:05,2021-03-25 14:13:20.367677
3303,1436,2,1436,16,453,16,6,1,6,Life - School Balance,2,453,52,2021-03-25 14:05:07,2021-03-25 15:27:33.853847
3304,1437,2,1437,21,453,21,7,1,7,Discrimination,2,453,52,2021-03-25 14:05:07,2021-03-25 15:27:33.853847
3305,1438,6,1438,22,453,22,8,1,8,Financial Pressure,2,453,52,2021-03-25 14:05:07,2021-03-25 15:27:33.853847
3306,1439,6,1439,29,453,29,9,0,9,Faculty & Staff Support,2,453,52,2021-03-25 14:05:07,2021-03-25 15:27:33.853847
3307,1440,6,1440,30,453,30,10,1,10,Friendships,2,453,52,2021-03-25 14:05:07,2021-03-25 15:27:33.853847
3308,1486,5,1486,16,463,16,6,1,6,Life - School Balance,2,463,66,2021-03-25 14:05:08,2021-03-25 14:38:43.439261
3309,1487,4,1487,20,463,20,7,1,7,Discrimination,2,463,66,2021-03-25 14:05:08,2021-03-25 14:38:43.439261
3310,1488,4,1488,22,463,22,8,1,8,Financial Pressure,2,463,66,2021-03-25 14:05:08,2021-03-25 14:38:43.439261
3311,1489,5,1489,26,463,26,9,1,9,Faculty & Staff Support,2,463,66,2021-03-25 14:05:08,2021-03-25 14:38:43.439261
3312,1490,5,1490,30,463,30,10,1,10,Friendships,2,463,66,2021-03-25 14:05:08,2021-03-25 14:38:43.439261
3313,1521,6,1521,16,470,16,6,1,6,Life - School Balance,2,470,73,2021-03-25 14:05:09,2021-03-25 14:10:59.719036
3314,1522,6,1522,19,470,19,7,0,7,Discrimination,2,470,73,2021-03-25 14:05:09,2021-03-25 14:10:59.719036
3315,1523,1,1523,23,470,23,8,1,8,Financial Pressure,2,470,73,2021-03-25 14:05:09,2021-03-25 14:10:59.719036
3316,1524,6,1524,27,470,27,9,1,9,Faculty & Staff Support,2,470,73,2021-03-25 14:05:09,2021-03-25 14:10:59.719036
3317,1525,6,1525,31,470,31,10,1,10,Friendships,2,470,73,2021-03-25 14:05:09,2021-03-25 14:10:59.719036
3318,1536,2,1536,16,473,16,6,1,6,Life - School Balance,2,473,76,2021-03-25 14:05:10,2021-03-25 16:28:32.931719
3319,1537,4,1537,20,473,20,7,1,7,Discrimination,2,473,76,2021-03-25 14:05:10,2021-03-25 16:28:32.931719
3320,1538,1,1538,23,473,23,8,1,8,Financial Pressure,2,473,76,2021-03-25 14:05:10,2021-03-25 16:28:32.931719
3321,1539,5,1539,29,473,29,9,0,9,Faculty & Staff Support,2,473,76,2021-03-25 14:05:10,2021-03-25 16:28:32.931719
3322,1540,5,1540,31,473,31,10,1,10,Friendships,2,473,76,2021-03-25 14:05:10,2021-03-25 16:28:32.931719
3323,1551,4,1551,16,476,16,6,1,6,Life - School Balance,2,476,79,2021-03-25 14:05:10,2021-03-25 14:06:40.516166
3324,1552,5,1552,19,476,19,7,0,7,Discrimination,2,476,79,2021-03-25 14:05:10,2021-03-25 14:06:40.516166
3325,1553,4,1553,24,476,24,8,1,8,Financial Pressure,2,476,79,2021-03-25 14:05:10,2021-03-25 14:06:40.516166
3326,1554,6,1554,29,476,29,9,0,9,Faculty & Staff Support,2,476,79,2021-03-25 14:05:10,2021-03-25 14:06:40.516166
3327,1555,4,1555,32,476,32,10,1,10,Friendships,2,476,79,2021-03-25 14:05:10,2021-03-25 14:06:40.516166
3328,1571,4,1571,16,480,16,6,1,6,Life - School Balance,2,480,88,2021-03-25 14:05:11,2021-03-25 17:51:10.965252
3329,1572,6,1572,21,480,21,7,1,7,Discrimination,2,480,88,2021-03-25 14:05:11,2021-03-25 17:51:10.965252
3330,1573,5,1573,22,480,22,8,1,8,Financial Pressure,2,480,88,2021-03-25 14:05:11,2021-03-25 17:51:10.965252
3331,1574,4,1574,28,480,28,9,1,9,Faculty & Staff Support,2,480,88,2021-03-25 14:05:11,2021-03-25 17:51:10.965252
3332,1575,6,1575,31,480,31,10,1,10,Friendships,2,480,88,2021-03-25 14:05:11,2021-03-25 17:51:10.965252
3333,1581,6,1581,16,482,16,6,1,6,Life - School Balance,2,482,90,2021-03-25 14:05:11,2021-03-25 14:12:32.476171
3334,1582,5,1582,21,482,21,7,1,7,Discrimination,2,482,90,2021-03-25 14:05:11,2021-03-25 14:12:32.476171
3335,1583,6,1583,24,482,24,8,1,8,Financial Pressure,2,482,90,2021-03-25 14:05:11,2021-03-25 14:12:32.476171
3336,1584,6,1584,28,482,28,9,1,9,Faculty & Staff Support,2,482,90,2021-03-25 14:05:11,2021-03-25 14:12:32.476171
3337,1585,5,1585,32,482,32,10,1,10,Friendships,2,482,90,2021-03-25 14:05:11,2021-03-25 14:12:32.476171
3338,1591,1,1591,16,484,16,6,1,6,Life - School Balance,2,484,93,2021-03-25 14:05:11,2021-03-25 14:07:27.553469
3339,1592,5,1592,21,484,21,7,1,7,Discrimination,2,484,93,2021-03-25 14:05:11,2021-03-25 14:07:27.553469
3340,1593,6,1593,25,484,25,8,0,8,Financial Pressure,2,484,93,2021-03-25 14:05:11,2021-03-25 14:07:27.553469
3341,1594,5,1594,26,484,26,9,1,9,Faculty & Staff Support,2,484,93,2021-03-25 14:05:11,2021-03-25 14:07:27.553469
3342,1595,1,1595,33,484,33,10,0,10,Friendships,2,484,93,2021-03-25 14:05:11,2021-03-25 14:07:27.553469
3343,1601,6,1601,16,486,16,6,1,6,Life - School Balance,2,486,95,2021-03-25 14:05:12,2021-03-25 14:39:27.984491
3344,1602,6,1602,21,486,21,7,1,7,Discrimination,2,486,95,2021-03-25 14:05:12,2021-03-25 14:39:27.984491
3345,1603,4,1603,25,486,25,8,0,8,Financial Pressure,2,486,95,2021-03-25 14:05:12,2021-03-25 14:39:27.984491
3346,1604,6,1604,27,486,27,9,1,9,Faculty & Staff Support,2,486,95,2021-03-25 14:05:12,2021-03-25 14:39:27.984491
3347,1605,6,1605,31,486,31,10,1,10,Friendships,2,486,95,2021-03-25 14:05:12,2021-03-25 14:39:27.984491
3348,1611,4,1611,16,488,16,6,1,6,Life - School Balance,2,488,99,2021-03-25 14:05:12,2021-03-25 14:06:49.999315
3349,1612,6,1612,20,488,20,7,1,7,Discrimination,2,488,99,2021-03-25 14:05:12,2021-03-25 14:06:49.999315
3350,1613,1,1613,24,488,24,8,1,8,Financial Pressure,2,488,99,2021-03-25 14:05:12,2021-03-25 14:06:49.999315
3351,1614,6,1614,28,488,28,9,1,9,Faculty & Staff Support,2,488,99,2021-03-25 14:05:12,2021-03-25 14:06:49.999315
3352,1615,6,1615,33,488,33,10,0,10,Friendships,2,488,99,2021-03-25 14:05:12,2021-03-25 14:06:49.999315
3353,1616,3,1616,16,489,16,6,1,6,Life - School Balance,2,489,100,2021-03-25 14:05:12,2021-03-25 15:01:15.272257
3354,1617,6,1617,19,489,19,7,0,7,Discrimination,2,489,100,2021-03-25 14:05:12,2021-03-25 15:01:15.272257
3355,1618,4,1618,22,489,22,8,1,8,Financial Pressure,2,489,100,2021-03-25 14:05:12,2021-03-25 15:01:15.272257
3356,1619,5,1619,27,489,27,9,1,9,Faculty & Staff Support,2,489,100,2021-03-25 14:05:12,2021-03-25 15:01:15.272257
3357,1620,4,1620,33,489,33,10,0,10,Friendships,2,489,100,2021-03-25 14:05:12,2021-03-25 15:01:15.272257
3358,1626,2,1626,16,491,16,6,1,6,Life - School Balance,2,491,103,2021-03-25 14:05:12,2021-03-25 14:07:09.174345
3359,1627,4,1627,21,491,21,7,1,7,Discrimination,2,491,103,2021-03-25 14:05:12,2021-03-25 14:07:09.174345
3360,1628,6,1628,23,491,23,8,1,8,Financial Pressure,2,491,103,2021-03-25 14:05:12,2021-03-25 14:07:09.174345
3361,1629,6,1629,27,491,27,9,1,9,Faculty & Staff Support,2,491,103,2021-03-25 14:05:12,2021-03-25 14:07:09.174345
3362,1630,6,1630,30,491,30,10,1,10,Friendships,2,491,103,2021-03-25 14:05:12,2021-03-25 14:07:09.174345
3363,1656,4,1656,16,517,16,6,1,6,Life - School Balance,2,517,6,2021-03-30 19:05:01,2021-03-30 19:29:51.217921
3364,1657,6,1657,21,517,21,7,1,7,Discrimination,2,517,6,2021-03-30 19:05:01,2021-03-30 19:29:51.217921
3365,1658,4,1658,25,517,25,8,0,8,Financial Pressure,2,517,6,2021-03-30 19:05:01,2021-03-30 19:29:51.217921
3366,1659,5,1659,28,517,28,9,1,9,Faculty & Staff Support,2,517,6,2021-03-30 19:05:01,2021-03-30 19:29:51.217921
3367,1660,6,1660,30,517,30,10,1,10,Friendships,2,517,6,2021-03-30 19:05:01,2021-03-30 19:29:51.217921
3368,1661,4,1661,16,518,16,6,1,6,Life - School Balance,2,518,9,2021-03-30 19:05:02,2021-03-30 19:06:46.010479
3369,1662,6,1662,21,518,21,7,1,7,Discrimination,2,518,9,2021-03-30 19:05:02,2021-03-30 19:06:46.010479
3370,1663,5,1663,22,518,22,8,1,8,Financial Pressure,2,518,9,2021-03-30 19:05:02,2021-03-30 19:06:46.010479
3371,1664,6,1664,27,518,27,9,1,9,Faculty & Staff Support,2,518,9,2021-03-30 19:05:02,2021-03-30 19:06:46.010479
3372,1665,6,1665,30,518,30,10,1,10,Friendships,2,518,9,2021-03-30 19:05:02,2021-03-30 19:06:46.010479
3373,1696,4,1696,16,525,16,6,1,6,Life - School Balance,2,525,19,2021-03-30 19:05:03,2021-03-30 23:14:54.916041
3374,1697,5,1697,19,525,19,7,0,7,Discrimination,2,525,19,2021-03-30 19:05:03,2021-03-30 23:14:54.916041
3375,1698,5,1698,23,525,23,8,1,8,Financial Pressure,2,525,19,2021-03-30 19:05:03,2021-03-30 23:14:54.916041
3376,1699,5,1699,29,525,29,9,0,9,Faculty & Staff Support,2,525,19,2021-03-30 19:05:03,2021-03-30 23:14:54.916041
3377,1700,4,1700,31,525,31,10,1,10,Friendships,2,525,19,2021-03-30 19:05:03,2021-03-30 23:14:54.916041
3378,1701,4,1701,16,526,16,6,1,6,Life - School Balance,2,526,20,2021-03-30 19:05:03,2021-03-30 20:01:51.512840
3379,1702,5,1702,20,526,20,7,1,7,Discrimination,2,526,20,2021-03-30 19:05:03,2021-03-30 20:01:51.512840
3380,1703,6,1703,22,526,22,8,1,8,Financial Pressure,2,526,20,2021-03-30 19:05:03,2021-03-30 20:01:51.512840
3381,1704,4,1704,26,526,26,9,1,9,Faculty & Staff Support,2,526,20,2021-03-30 19:05:03,2021-03-30 20:01:51.512840
3382,1705,4,1705,31,526,31,10,1,10,Friendships,2,526,20,2021-03-30 19:05:03,2021-03-30 20:01:51.512840
3383,1711,3,1711,16,528,16,6,1,6,Life - School Balance,2,528,23,2021-03-30 19:05:03,2021-03-30 19:09:22.836279
3384,1712,3,1712,20,528,20,7,1,7,Discrimination,2,528,23,2021-03-30 19:05:03,2021-03-30 19:09:22.836279
3385,1713,6,1713,23,528,23,8,1,8,Financial Pressure,2,528,23,2021-03-30 19:05:03,2021-03-30 19:09:22.836279
3386,1714,6,1714,29,528,29,9,0,9,Faculty & Staff Support,2,528,23,2021-03-30 19:05:03,2021-03-30 19:09:22.836279
3387,1715,2,1715,31,528,31,10,1,10,Friendships,2,528,23,2021-03-30 19:05:03,2021-03-30 19:09:22.836279
3388,1721,4,1721,16,530,16,6,1,6,Life - School Balance,2,530,27,2021-03-30 19:05:04,2021-03-30 19:41:03.173765
3389,1722,6,1722,19,530,19,7,0,7,Discrimination,2,530,27,2021-03-30 19:05:04,2021-03-30 19:41:03.173765
3390,1723,4,1723,22,530,22,8,1,8,Financial Pressure,2,530,27,2021-03-30 19:05:04,2021-03-30 19:41:03.173765
3391,1724,6,1724,28,530,28,9,1,9,Faculty & Staff Support,2,530,27,2021-03-30 19:05:04,2021-03-30 19:41:03.173765
3392,1725,6,1725,33,530,33,10,0,10,Friendships,2,530,27,2021-03-30 19:05:04,2021-03-30 19:41:03.173765
3393,1746,4,1746,16,535,16,6,1,6,Life - School Balance,2,535,34,2021-03-30 19:05:04,2021-03-30 19:05:52.342869
3394,1747,6,1747,19,535,19,7,0,7,Discrimination,2,535,34,2021-03-30 19:05:04,2021-03-30 19:05:52.342869
3395,1748,4,1748,25,535,25,8,0,8,Financial Pressure,2,535,34,2021-03-30 19:05:04,2021-03-30 19:05:52.342869
3396,1749,5,1749,27,535,27,9,1,9,Faculty & Staff Support,2,535,34,2021-03-30 19:05:04,2021-03-30 19:05:52.342869
3397,1750,4,1750,32,535,32,10,1,10,Friendships,2,535,34,2021-03-30 19:05:04,2021-03-30 19:05:52.342869
3398,1761,4,1761,16,538,16,6,1,6,Life - School Balance,2,538,40,2021-03-30 19:05:05,2021-03-30 19:07:55.574321
3399,1762,3,1762,21,538,21,7,1,7,Discrimination,2,538,40,2021-03-30 19:05:05,2021-03-30 19:07:55.574321
3400,1763,5,1763,24,538,24,8,1,8,Financial Pressure,2,538,40,2021-03-30 19:05:05,2021-03-30 19:07:55.574321
3401,1764,4,1764,28,538,28,9,1,9,Faculty & Staff Support,2,538,40,2021-03-30 19:05:05,2021-03-30 19:07:55.574321
3402,1765,2,1765,33,538,33,10,0,10,Friendships,2,538,40,2021-03-30 19:05:05,2021-03-30 19:07:55.574321
3403,1811,5,1811,16,548,16,6,1,6,Life - School Balance,2,548,52,2021-03-30 19:05:06,2021-03-30 19:21:36.592905
3404,1812,1,1812,19,548,19,7,0,7,Discrimination,2,548,52,2021-03-30 19:05:06,2021-03-30 19:21:36.592905
3405,1813,6,1813,23,548,23,8,1,8,Financial Pressure,2,548,52,2021-03-30 19:05:06,2021-03-30 19:21:36.592905
3406,1814,6,1814,26,548,26,9,1,9,Faculty & Staff Support,2,548,52,2021-03-30 19:05:06,2021-03-30 19:21:36.592905
3407,1815,4,1815,33,548,33,10,0,10,Friendships,2,548,52,2021-03-30 19:05:06,2021-03-30 19:21:36.592905
3408,1821,3,1821,16,550,16,6,1,6,Life - School Balance,2,550,55,2021-03-30 19:05:07,2021-03-30 19:50:38.733425
3409,1822,5,1822,20,550,20,7,1,7,Discrimination,2,550,55,2021-03-30 19:05:07,2021-03-30 19:50:38.733425
3410,1823,3,1823,24,550,24,8,1,8,Financial Pressure,2,550,55,2021-03-30 19:05:07,2021-03-30 19:50:38.733425
3411,1824,5,1824,29,550,29,9,0,9,Faculty & Staff Support,2,550,55,2021-03-30 19:05:07,2021-03-30 19:50:38.733425
3412,1825,5,1825,32,550,32,10,1,10,Friendships,2,550,55,2021-03-30 19:05:07,2021-03-30 19:50:38.733425
3413,1826,2,1826,16,551,16,6,1,6,Life - School Balance,2,551,57,2021-03-30 19:05:07,2021-03-30 19:06:22.819513
3414,1827,6,1827,20,551,20,7,1,7,Discrimination,2,551,57,2021-03-30 19:05:07,2021-03-30 19:06:22.819513
3415,1828,2,1828,23,551,23,8,1,8,Financial Pressure,2,551,57,2021-03-30 19:05:07,2021-03-30 19:06:22.819513
3416,1829,5,1829,28,551,28,9,1,9,Faculty & Staff Support,2,551,57,2021-03-30 19:05:07,2021-03-30 19:06:22.819513
3417,1830,6,1830,32,551,32,10,1,10,Friendships,2,551,57,2021-03-30 19:05:07,2021-03-30 19:06:22.819513
3418,1831,3,1831,16,552,16,6,1,6,Life - School Balance,2,552,58,2021-03-30 19:05:07,2021-03-30 19:06:22.759334
3419,1832,3,1832,20,552,20,7,1,7,Discrimination,2,552,58,2021-03-30 19:05:07,2021-03-30 19:06:22.759334
3420,1833,2,1833,24,552,24,8,1,8,Financial Pressure,2,552,58,2021-03-30 19:05:07,2021-03-30 19:06:22.759334
3421,1834,5,1834,26,552,26,9,1,9,Faculty & Staff Support,2,552,58,2021-03-30 19:05:07,2021-03-30 19:06:22.759334
3422,1835,5,1835,30,552,30,10,1,10,Friendships,2,552,58,2021-03-30 19:05:07,2021-03-30 19:06:22.759334
3423,1851,4,1851,16,556,16,6,1,6,Life - School Balance,2,556,64,2021-03-30 19:05:08,2021-03-30 19:28:36.939645
3424,1852,4,1852,21,556,21,7,1,7,Discrimination,2,556,64,2021-03-30 19:05:08,2021-03-30 19:28:36.939645
3425,1853,3,1853,25,556,25,8,0,8,Financial Pressure,2,556,64,2021-03-30 19:05:08,2021-03-30 19:28:36.939645
3426,1854,5,1854,28,556,28,9,1,9,Faculty & Staff Support,2,556,64,2021-03-30 19:05:08,2021-03-30 19:28:36.939645
3427,1855,4,1855,30,556,30,10,1,10,Friendships,2,556,64,2021-03-30 19:05:08,2021-03-30 19:28:36.939645
3428,1886,4,1886,16,563,16,6,1,6,Life - School Balance,2,563,71,2021-03-30 19:05:09,2021-03-30 19:42:51.007903
3429,1887,5,1887,20,563,20,7,1,7,Discrimination,2,563,71,2021-03-30 19:05:09,2021-03-30 19:42:51.007903
3430,1888,4,1888,23,563,23,8,1,8,Financial Pressure,2,563,71,2021-03-30 19:05:09,2021-03-30 19:42:51.007903
3431,1889,5,1889,27,563,27,9,1,9,Faculty & Staff Support,2,563,71,2021-03-30 19:05:09,2021-03-30 19:42:51.007903
3432,1890,5,1890,32,563,32,10,1,10,Friendships,2,563,71,2021-03-30 19:05:09,2021-03-30 19:42:51.007903
3433,1896,6,1896,16,565,16,6,1,6,Life - School Balance,2,565,73,2021-03-30 19:05:09,2021-03-30 19:32:44.457744
3434,1897,5,1897,20,565,20,7,1,7,Discrimination,2,565,73,2021-03-30 19:05:09,2021-03-30 19:32:44.457744
3435,1898,2,1898,22,565,22,8,1,8,Financial Pressure,2,565,73,2021-03-30 19:05:09,2021-03-30 19:32:44.457744
3436,1899,6,1899,28,565,28,9,1,9,Faculty & Staff Support,2,565,73,2021-03-30 19:05:09,2021-03-30 19:32:44.457744
3437,1900,6,1900,32,565,32,10,1,10,Friendships,2,565,73,2021-03-30 19:05:09,2021-03-30 19:32:44.457744
3438,1901,4,1901,16,566,16,6,1,6,Life - School Balance,2,566,74,2021-03-30 19:05:09,2021-03-31 02:40:12.565264
3439,1902,6,1902,19,566,19,7,0,7,Discrimination,2,566,74,2021-03-30 19:05:09,2021-03-31 02:40:12.565264
3440,1903,4,1903,25,566,25,8,0,8,Financial Pressure,2,566,74,2021-03-30 19:05:09,2021-03-31 02:40:12.565264
3441,1904,6,1904,29,566,29,9,0,9,Faculty & Staff Support,2,566,74,2021-03-30 19:05:09,2021-03-31 02:40:12.565264
3442,1905,6,1905,31,566,31,10,1,10,Friendships,2,566,74,2021-03-30 19:05:09,2021-03-31 02:40:12.565264
3443,1936,5,1936,16,573,16,6,1,6,Life - School Balance,2,573,85,2021-03-30 19:05:10,2021-03-31 00:27:10.711856
3444,1937,6,1937,19,573,19,7,0,7,Discrimination,2,573,85,2021-03-30 19:05:10,2021-03-31 00:27:10.711856
3445,1938,4,1938,24,573,24,8,1,8,Financial Pressure,2,573,85,2021-03-30 19:05:10,2021-03-31 00:27:10.711856
3446,1939,6,1939,27,573,27,9,1,9,Faculty & Staff Support,2,573,85,2021-03-30 19:05:10,2021-03-31 00:27:10.711856
3447,1940,4,1940,32,573,32,10,1,10,Friendships,2,573,85,2021-03-30 19:05:10,2021-03-31 00:27:10.711856
3448,1951,2,1951,16,576,16,6,1,6,Life - School Balance,2,576,88,2021-03-30 19:05:11,2021-03-30 21:31:07.205733
3449,1952,6,1952,21,576,21,7,1,7,Discrimination,2,576,88,2021-03-30 19:05:11,2021-03-30 21:31:07.205733
3450,1953,5,1953,24,576,24,8,1,8,Financial Pressure,2,576,88,2021-03-30 19:05:11,2021-03-30 21:31:07.205733
3451,1954,4,1954,28,576,28,9,1,9,Faculty & Staff Support,2,576,88,2021-03-30 19:05:11,2021-03-30 21:31:07.205733
3452,1955,5,1955,31,576,31,10,1,10,Friendships,2,576,88,2021-03-30 19:05:11,2021-03-30 21:31:07.205733
3453,1971,4,1971,16,580,16,6,1,6,Life - School Balance,2,580,93,2021-03-30 19:05:11,2021-03-30 19:07:30.069843
3454,1972,5,1972,21,580,21,7,1,7,Discrimination,2,580,93,2021-03-30 19:05:11,2021-03-30 19:07:30.069843
3455,1973,6,1973,25,580,25,8,0,8,Financial Pressure,2,580,93,2021-03-30 19:05:11,2021-03-30 19:07:30.069843
3456,1974,4,1974,28,580,28,9,1,9,Faculty & Staff Support,2,580,93,2021-03-30 19:05:11,2021-03-30 19:07:30.069843
3457,1975,1,1975,32,580,32,10,1,10,Friendships,2,580,93,2021-03-30 19:05:11,2021-03-30 19:07:30.069843
3458,1976,6,1976,16,581,16,6,1,6,Life - School Balance,2,581,94,2021-03-30 19:05:12,2021-03-30 19:11:08.309681
3459,1977,6,1977,20,581,20,7,1,7,Discrimination,2,581,94,2021-03-30 19:05:12,2021-03-30 19:11:08.309681
3460,1978,3,1978,23,581,23,8,1,8,Financial Pressure,2,581,94,2021-03-30 19:05:12,2021-03-30 19:11:08.309681
3461,1979,6,1979,28,581,28,9,1,9,Faculty & Staff Support,2,581,94,2021-03-30 19:05:12,2021-03-30 19:11:08.309681
3462,1980,6,1980,31,581,31,10,1,10,Friendships,2,581,94,2021-03-30 19:05:12,2021-03-30 19:11:08.309681
3463,1986,3,1986,16,583,16,6,1,6,Life - School Balance,2,583,96,2021-03-30 19:05:12,2021-03-30 19:49:11.222163
3464,1987,5,1987,21,583,21,7,1,7,Discrimination,2,583,96,2021-03-30 19:05:12,2021-03-30 19:49:11.222163
3465,1988,5,1988,24,583,24,8,1,8,Financial Pressure,2,583,96,2021-03-30 19:05:12,2021-03-30 19:49:11.222163
3466,1989,5,1989,29,583,29,9,0,9,Faculty & Staff Support,2,583,96,2021-03-30 19:05:12,2021-03-30 19:49:11.222163
3467,1990,5,1990,33,583,33,10,0,10,Friendships,2,583,96,2021-03-30 19:05:12,2021-03-30 19:49:11.222163
3468,1996,4,1996,16,585,16,6,1,6,Life - School Balance,2,585,99,2021-03-30 19:05:12,2021-03-30 19:10:35.959467
3469,1997,6,1997,20,585,20,7,1,7,Discrimination,2,585,99,2021-03-30 19:05:12,2021-03-30 19:10:35.959467
3470,1998,1,1998,22,585,22,8,1,8,Financial Pressure,2,585,99,2021-03-30 19:05:12,2021-03-30 19:10:35.959467
3471,1999,6,1999,28,585,28,9,1,9,Faculty & Staff Support,2,585,99,2021-03-30 19:05:12,2021-03-30 19:10:35.959467
3472,2000,6,2000,30,585,30,10,1,10,Friendships,2,585,99,2021-03-30 19:05:12,2021-03-30 19:10:35.959467
3473,2056,4,2056,16,597,16,6,1,6,Life - School Balance,2,597,9,2021-04-01 14:05:02,2021-04-01 14:45:32.565040
3474,2057,6,2057,20,597,20,7,1,7,Discrimination,2,597,9,2021-04-01 14:05:02,2021-04-01 14:45:32.565040
3475,2058,5,2058,24,597,24,8,1,8,Financial Pressure,2,597,9,2021-04-01 14:05:02,2021-04-01 14:45:32.565040
3476,2059,6,2059,27,597,27,9,1,9,Faculty & Staff Support,2,597,9,2021-04-01 14:05:02,2021-04-01 14:45:32.565040
3477,2060,5,2060,33,597,33,10,0,10,Friendships,2,597,9,2021-04-01 14:05:02,2021-04-01 14:45:32.565040
3478,2066,4,2066,16,599,16,6,1,6,Life - School Balance,2,599,13,2021-04-01 14:05:02,2021-04-01 16:44:03.884675
3479,2067,4,2067,21,599,21,7,1,7,Discrimination,2,599,13,2021-04-01 14:05:02,2021-04-01 16:44:03.884675
3480,2068,4,2068,24,599,24,8,1,8,Financial Pressure,2,599,13,2021-04-01 14:05:02,2021-04-01 16:44:03.884675
3481,2069,3,2069,28,599,28,9,1,9,Faculty & Staff Support,2,599,13,2021-04-01 14:05:02,2021-04-01 16:44:03.884675
3482,2070,5,2070,31,599,31,10,1,10,Friendships,2,599,13,2021-04-01 14:05:02,2021-04-01 16:44:03.884675
3483,2091,4,2091,16,604,16,6,1,6,Life - School Balance,2,604,19,2021-04-01 14:05:03,2021-04-01 15:34:31.282213
3484,2092,5,2092,19,604,19,7,0,7,Discrimination,2,604,19,2021-04-01 14:05:03,2021-04-01 15:34:31.282213
3485,2093,4,2093,24,604,24,8,1,8,Financial Pressure,2,604,19,2021-04-01 14:05:03,2021-04-01 15:34:31.282213
3486,2094,5,2094,26,604,26,9,1,9,Faculty & Staff Support,2,604,19,2021-04-01 14:05:03,2021-04-01 15:34:31.282213
3487,2095,4,2095,31,604,31,10,1,10,Friendships,2,604,19,2021-04-01 14:05:03,2021-04-01 15:34:31.282213
3488,2141,4,2141,16,614,16,6,1,6,Life - School Balance,2,614,34,2021-04-01 14:05:05,2021-04-01 16:36:36.239728
3489,2142,6,2142,19,614,19,7,0,7,Discrimination,2,614,34,2021-04-01 14:05:05,2021-04-01 16:36:36.239728
3490,2143,4,2143,25,614,25,8,0,8,Financial Pressure,2,614,34,2021-04-01 14:05:05,2021-04-01 16:36:36.239728
3491,2144,6,2144,27,614,27,9,1,9,Faculty & Staff Support,2,614,34,2021-04-01 14:05:05,2021-04-01 16:36:36.239728
3492,2145,3,2145,33,614,33,10,0,10,Friendships,2,614,34,2021-04-01 14:05:05,2021-04-01 16:36:36.239728
3493,2166,5,2166,16,619,16,6,1,6,Life - School Balance,2,619,42,2021-04-01 14:05:06,2021-04-01 17:30:08.370568
3494,2167,5,2167,19,619,19,7,0,7,Discrimination,2,619,42,2021-04-01 14:05:06,2021-04-01 17:30:08.370568
3495,2168,3,2168,25,619,25,8,0,8,Financial Pressure,2,619,42,2021-04-01 14:05:06,2021-04-01 17:30:08.370568
3496,2169,5,2169,28,619,28,9,1,9,Faculty & Staff Support,2,619,42,2021-04-01 14:05:06,2021-04-01 17:30:08.370568
3497,2170,6,2170,31,619,31,10,1,10,Friendships,2,619,42,2021-04-01 14:05:06,2021-04-01 17:30:08.370568
3498,2176,5,2176,16,621,16,6,1,6,Life - School Balance,2,621,45,2021-04-01 14:05:06,2021-04-01 14:16:50.156852
3499,2177,6,2177,21,621,21,7,1,7,Discrimination,2,621,45,2021-04-01 14:05:06,2021-04-01 14:16:50.156852
3500,2178,1,2178,23,621,23,8,1,8,Financial Pressure,2,621,45,2021-04-01 14:05:06,2021-04-01 14:16:50.156852
3501,2179,6,2179,28,621,28,9,1,9,Faculty & Staff Support,2,621,45,2021-04-01 14:05:06,2021-04-01 14:16:50.156852
3502,2180,5,2180,30,621,30,10,1,10,Friendships,2,621,45,2021-04-01 14:05:06,2021-04-01 14:16:50.156852
3503,2191,5,2191,16,624,16,6,1,6,Life - School Balance,2,624,48,2021-04-01 14:05:07,2021-04-01 19:40:51.275284
3504,2192,6,2192,20,624,20,7,1,7,Discrimination,2,624,48,2021-04-01 14:05:07,2021-04-01 19:40:51.275284
3505,2193,3,2193,25,624,25,8,0,8,Financial Pressure,2,624,48,2021-04-01 14:05:07,2021-04-01 19:40:51.275284
3506,2194,6,2194,29,624,29,9,0,9,Faculty & Staff Support,2,624,48,2021-04-01 14:05:07,2021-04-01 19:40:51.275284
3507,2195,5,2195,32,624,32,10,1,10,Friendships,2,624,48,2021-04-01 14:05:07,2021-04-01 19:40:51.275284
3508,2206,5,2206,16,627,16,6,1,6,Life - School Balance,2,627,52,2021-04-01 14:05:07,2021-04-01 16:37:53.874716
3509,2207,1,2207,19,627,19,7,0,7,Discrimination,2,627,52,2021-04-01 14:05:07,2021-04-01 16:37:53.874716
3510,2208,6,2208,24,627,24,8,1,8,Financial Pressure,2,627,52,2021-04-01 14:05:07,2021-04-01 16:37:53.874716
3511,2209,6,2209,27,627,27,9,1,9,Faculty & Staff Support,2,627,52,2021-04-01 14:05:07,2021-04-01 16:37:53.874716
3512,2210,5,2210,32,627,32,10,1,10,Friendships,2,627,52,2021-04-01 14:05:07,2021-04-01 16:37:53.874716
3513,2211,3,2211,16,628,16,6,1,6,Life - School Balance,2,628,54,2021-04-01 14:05:07,2021-04-01 14:06:20.624859
3514,2212,3,2212,21,628,21,7,1,7,Discrimination,2,628,54,2021-04-01 14:05:07,2021-04-01 14:06:20.624859
3515,2213,6,2213,25,628,25,8,0,8,Financial Pressure,2,628,54,2021-04-01 14:05:07,2021-04-01 14:06:20.624859
3516,2214,6,2214,29,628,29,9,0,9,Faculty & Staff Support,2,628,54,2021-04-01 14:05:07,2021-04-01 14:06:20.624859
3517,2215,5,2215,32,628,32,10,1,10,Friendships,2,628,54,2021-04-01 14:05:07,2021-04-01 14:06:20.624859
3518,2216,3,2216,16,629,16,6,1,6,Life - School Balance,2,629,55,2021-04-01 14:05:07,2021-04-01 16:48:24.704782
3519,2217,5,2217,19,629,19,7,0,7,Discrimination,2,629,55,2021-04-01 14:05:07,2021-04-01 16:48:24.704782
3520,2218,2,2218,25,629,25,8,0,8,Financial Pressure,2,629,55,2021-04-01 14:05:07,2021-04-01 16:48:24.704782
3521,2219,5,2219,29,629,29,9,0,9,Faculty & Staff Support,2,629,55,2021-04-01 14:05:07,2021-04-01 16:48:24.704782
3522,2220,3,2220,31,629,31,10,1,10,Friendships,2,629,55,2021-04-01 14:05:07,2021-04-01 16:48:24.704782
3523,2306,3,2306,16,647,16,6,1,6,Life - School Balance,2,647,76,2021-04-01 14:05:11,2021-04-01 15:26:50.773270
3524,2307,5,2307,21,647,21,7,1,7,Discrimination,2,647,76,2021-04-01 14:05:11,2021-04-01 15:26:50.773270
3525,2308,1,2308,22,647,22,8,1,8,Financial Pressure,2,647,76,2021-04-01 14:05:11,2021-04-01 15:26:50.773270
3526,2309,4,2309,26,647,26,9,1,9,Faculty & Staff Support,2,647,76,2021-04-01 14:05:11,2021-04-01 15:26:50.773270
3527,2310,4,2310,30,647,30,10,1,10,Friendships,2,647,76,2021-04-01 14:05:11,2021-04-01 15:26:50.773270
3528,2321,3,2321,16,650,16,6,1,6,Life - School Balance,2,650,79,2021-04-01 14:05:11,2021-04-02 00:31:35.814441
3529,2322,4,2322,20,650,20,7,1,7,Discrimination,2,650,79,2021-04-01 14:05:11,2021-04-02 00:31:35.814441
3530,2323,4,2323,23,650,23,8,1,8,Financial Pressure,2,650,79,2021-04-01 14:05:11,2021-04-02 00:31:35.814441
3531,2324,5,2324,29,650,29,9,0,9,Faculty & Staff Support,2,650,79,2021-04-01 14:05:11,2021-04-02 00:31:35.814441
3532,2325,4,2325,32,650,32,10,1,10,Friendships,2,650,79,2021-04-01 14:05:11,2021-04-02 00:31:35.814441
3533,2331,5,2331,16,652,16,6,1,6,Life - School Balance,2,652,85,2021-04-01 14:05:11,2021-04-01 18:49:47.534374
3534,2332,6,2332,20,652,20,7,1,7,Discrimination,2,652,85,2021-04-01 14:05:11,2021-04-01 18:49:47.534374
3535,2333,2,2333,23,652,23,8,1,8,Financial Pressure,2,652,85,2021-04-01 14:05:11,2021-04-01 18:49:47.534374
3536,2334,4,2334,26,652,26,9,1,9,Faculty & Staff Support,2,652,85,2021-04-01 14:05:11,2021-04-01 18:49:47.534374
3537,2335,4,2335,32,652,32,10,1,10,Friendships,2,652,85,2021-04-01 14:05:11,2021-04-01 18:49:47.534374
3538,2351,6,2351,16,656,16,6,1,6,Life - School Balance,2,656,89,2021-04-01 14:05:12,2021-04-01 14:06:23.963078
3539,2352,6,2352,19,656,19,7,0,7,Discrimination,2,656,89,2021-04-01 14:05:12,2021-04-01 14:06:23.963078
3540,2353,2,2353,23,656,23,8,1,8,Financial Pressure,2,656,89,2021-04-01 14:05:12,2021-04-01 14:06:23.963078
3541,2354,6,2354,26,656,26,9,1,9,Faculty & Staff Support,2,656,89,2021-04-01 14:05:12,2021-04-01 14:06:23.963078
3542,2355,6,2355,30,656,30,10,1,10,Friendships,2,656,89,2021-04-01 14:05:12,2021-04-01 14:06:23.963078
3543,2361,5,2361,16,658,16,6,1,6,Life - School Balance,2,658,91,2021-04-01 14:05:12,2021-04-01 14:46:33.918697
3544,2362,1,2362,21,658,21,7,1,7,Discrimination,2,658,91,2021-04-01 14:05:12,2021-04-01 14:46:33.918697
3545,2363,3,2363,23,658,23,8,1,8,Financial Pressure,2,658,91,2021-04-01 14:05:12,2021-04-01 14:46:33.918697
3546,2364,5,2364,26,658,26,9,1,9,Faculty & Staff Support,2,658,91,2021-04-01 14:05:12,2021-04-01 14:46:33.918697
3547,2365,5,2365,33,658,33,10,0,10,Friendships,2,658,91,2021-04-01 14:05:12,2021-04-01 14:46:33.918697
3548,2366,2,2366,16,659,16,6,1,6,Life - School Balance,2,659,93,2021-04-01 14:05:13,2021-04-01 16:52:52.676574
3549,2367,6,2367,19,659,19,7,0,7,Discrimination,2,659,93,2021-04-01 14:05:13,2021-04-01 16:52:52.676574
3550,2368,6,2368,24,659,24,8,1,8,Financial Pressure,2,659,93,2021-04-01 14:05:13,2021-04-01 16:52:52.676574
3551,2369,4,2369,26,659,26,9,1,9,Faculty & Staff Support,2,659,93,2021-04-01 14:05:13,2021-04-01 16:52:52.676574
3552,2370,2,2370,31,659,31,10,1,10,Friendships,2,659,93,2021-04-01 14:05:13,2021-04-01 16:52:52.676574
3553,2371,6,2371,16,660,16,6,1,6,Life - School Balance,2,660,94,2021-04-01 14:05:13,2021-04-01 14:06:43.417674
3554,2372,6,2372,19,660,19,7,0,7,Discrimination,2,660,94,2021-04-01 14:05:13,2021-04-01 14:06:43.417674
3555,2373,6,2373,25,660,25,8,0,8,Financial Pressure,2,660,94,2021-04-01 14:05:13,2021-04-01 14:06:43.417674
3556,2374,6,2374,28,660,28,9,1,9,Faculty & Staff Support,2,660,94,2021-04-01 14:05:13,2021-04-01 14:06:43.417674
3557,2375,6,2375,32,660,32,10,1,10,Friendships,2,660,94,2021-04-01 14:05:13,2021-04-01 14:06:43.417674
3558,2386,4,2386,16,663,16,6,1,6,Life - School Balance,2,663,98,2021-04-01 14:05:13,2021-04-01 14:06:48.985023
3559,2387,4,2387,20,663,20,7,1,7,Discrimination,2,663,98,2021-04-01 14:05:13,2021-04-01 14:06:48.985023
3560,2388,5,2388,22,663,22,8,1,8,Financial Pressure,2,663,98,2021-04-01 14:05:13,2021-04-01 14:06:48.985023
3561,2389,3,2389,26,663,26,9,1,9,Faculty & Staff Support,2,663,98,2021-04-01 14:05:13,2021-04-01 14:06:48.985023
3562,2390,4,2390,32,663,32,10,1,10,Friendships,2,663,98,2021-04-01 14:05:13,2021-04-01 14:06:48.985023
3563,2391,5,2391,16,664,16,6,1,6,Life - School Balance,2,664,99,2021-04-01 14:05:13,2021-04-01 15:10:33.040620
3564,2392,6,2392,19,664,19,7,0,7,Discrimination,2,664,99,2021-04-01 14:05:13,2021-04-01 15:10:33.040620
3565,2393,1,2393,24,664,24,8,1,8,Financial Pressure,2,664,99,2021-04-01 14:05:13,2021-04-01 15:10:33.040620
3566,2394,6,2394,26,664,26,9,1,9,Faculty & Staff Support,2,664,99,2021-04-01 14:05:13,2021-04-01 15:10:33.040620
3567,2395,6,2395,32,664,32,10,1,10,Friendships,2,664,99,2021-04-01 14:05:13,2021-04-01 15:10:33.040620
3568,2441,2,2441,16,674,16,6,1,6,Life - School Balance,2,674,5,2021-04-06 19:05:01,2021-04-06 19:05:35.047300
3569,2442,5,2442,20,674,20,7,1,7,Discrimination,2,674,5,2021-04-06 19:05:01,2021-04-06 19:05:35.047300
3570,2443,3,2443,23,674,23,8,1,8,Financial Pressure,2,674,5,2021-04-06 19:05:01,2021-04-06 19:05:35.047300
3571,2444,5,2444,29,674,29,9,0,9,Faculty & Staff Support,2,674,5,2021-04-06 19:05:01,2021-04-06 19:05:35.047300
3572,2445,4,2445,32,674,32,10,1,10,Friendships,2,674,5,2021-04-06 19:05:01,2021-04-06 19:05:35.047300
3573,2451,5,2451,16,676,16,6,1,6,Life - School Balance,2,676,9,2021-04-06 19:05:01,2021-04-07 15:09:19.407755
3574,2452,6,2452,20,676,20,7,1,7,Discrimination,2,676,9,2021-04-06 19:05:01,2021-04-07 15:09:19.407755
3575,2453,5,2453,23,676,23,8,1,8,Financial Pressure,2,676,9,2021-04-06 19:05:01,2021-04-07 15:09:19.407755
3576,2454,6,2454,26,676,26,9,1,9,Faculty & Staff Support,2,676,9,2021-04-06 19:05:01,2021-04-07 15:09:19.407755
3577,2455,5,2455,33,676,33,10,0,10,Friendships,2,676,9,2021-04-06 19:05:01,2021-04-07 15:09:19.407755
3578,2476,2,2476,16,681,16,6,1,6,Life - School Balance,2,681,17,2021-04-06 19:05:02,2021-04-06 19:58:49.868561
3579,2477,5,2477,20,681,20,7,1,7,Discrimination,2,681,17,2021-04-06 19:05:02,2021-04-06 19:58:49.868561
3580,2478,6,2478,24,681,24,8,1,8,Financial Pressure,2,681,17,2021-04-06 19:05:02,2021-04-06 19:58:49.868561
3581,2479,4,2479,27,681,27,9,1,9,Faculty & Staff Support,2,681,17,2021-04-06 19:05:02,2021-04-06 19:58:49.868561
3582,2480,5,2480,30,681,30,10,1,10,Friendships,2,681,17,2021-04-06 19:05:02,2021-04-06 19:58:49.868561
3583,2506,3,2506,16,687,16,6,1,6,Life - School Balance,2,687,26,2021-04-06 19:05:03,2021-04-06 19:12:48.296052
3584,2507,6,2507,19,687,19,7,0,7,Discrimination,2,687,26,2021-04-06 19:05:03,2021-04-06 19:12:48.296052
3585,2508,4,2508,25,687,25,8,0,8,Financial Pressure,2,687,26,2021-04-06 19:05:03,2021-04-06 19:12:48.296052
3586,2509,5,2509,26,687,26,9,1,9,Faculty & Staff Support,2,687,26,2021-04-06 19:05:03,2021-04-06 19:12:48.296052
3587,2510,5,2510,32,687,32,10,1,10,Friendships,2,687,26,2021-04-06 19:05:03,2021-04-06 19:12:48.296052
3588,2556,5,2556,16,697,16,6,1,6,Life - School Balance,2,697,41,2021-04-06 19:05:05,2021-04-06 22:22:09.587226
3589,2557,5,2557,19,697,19,7,0,7,Discrimination,2,697,41,2021-04-06 19:05:05,2021-04-06 22:22:09.587226
3590,2558,4,2558,25,697,25,8,0,8,Financial Pressure,2,697,41,2021-04-06 19:05:05,2021-04-06 22:22:09.587226
3591,2559,5,2559,28,697,28,9,1,9,Faculty & Staff Support,2,697,41,2021-04-06 19:05:05,2021-04-06 22:22:09.587226
3592,2560,5,2560,30,697,30,10,1,10,Friendships,2,697,41,2021-04-06 19:05:05,2021-04-06 22:22:09.587226
3593,2571,5,2571,16,700,16,6,1,6,Life - School Balance,2,700,45,2021-04-06 19:05:06,2021-04-06 19:12:31.343803
3594,2572,6,2572,19,700,19,7,0,7,Discrimination,2,700,45,2021-04-06 19:05:06,2021-04-06 19:12:31.343803
3595,2573,1,2573,23,700,23,8,1,8,Financial Pressure,2,700,45,2021-04-06 19:05:06,2021-04-06 19:12:31.343803
3596,2574,6,2574,29,700,29,9,0,9,Faculty & Staff Support,2,700,45,2021-04-06 19:05:06,2021-04-06 19:12:31.343803
3597,2575,5,2575,32,700,32,10,1,10,Friendships,2,700,45,2021-04-06 19:05:06,2021-04-06 19:12:31.343803
3598,2576,2,2576,16,701,16,6,1,6,Life - School Balance,2,701,46,2021-04-06 19:05:07,2021-04-06 19:13:44.552196
3599,2577,6,2577,19,701,19,7,0,7,Discrimination,2,701,46,2021-04-06 19:05:07,2021-04-06 19:13:44.552196
3600,2578,3,2578,25,701,25,8,0,8,Financial Pressure,2,701,46,2021-04-06 19:05:07,2021-04-06 19:13:44.552196
3601,2579,4,2579,27,701,27,9,1,9,Faculty & Staff Support,2,701,46,2021-04-06 19:05:07,2021-04-06 19:13:44.552196
3602,2580,6,2580,33,701,33,10,0,10,Friendships,2,701,46,2021-04-06 19:05:07,2021-04-06 19:13:44.552196
3603,2586,3,2586,16,703,16,6,1,6,Life - School Balance,2,703,48,2021-04-06 19:05:07,2021-04-06 20:30:12.803898
3604,2587,6,2587,19,703,19,7,0,7,Discrimination,2,703,48,2021-04-06 19:05:07,2021-04-06 20:30:12.803898
3605,2588,4,2588,22,703,22,8,1,8,Financial Pressure,2,703,48,2021-04-06 19:05:07,2021-04-06 20:30:12.803898
3606,2589,4,2589,28,703,28,9,1,9,Faculty & Staff Support,2,703,48,2021-04-06 19:05:07,2021-04-06 20:30:12.803898
3607,2590,5,2590,33,703,33,10,0,10,Friendships,2,703,48,2021-04-06 19:05:07,2021-04-06 20:30:12.803898
3608,2591,4,2591,16,704,16,6,1,6,Life - School Balance,2,704,49,2021-04-06 19:05:07,2021-04-06 20:55:20.077098
3609,2592,4,2592,20,704,20,7,1,7,Discrimination,2,704,49,2021-04-06 19:05:07,2021-04-06 20:55:20.077098
3610,2593,5,2593,24,704,24,8,1,8,Financial Pressure,2,704,49,2021-04-06 19:05:07,2021-04-06 20:55:20.077098
3611,2594,4,2594,28,704,28,9,1,9,Faculty & Staff Support,2,704,49,2021-04-06 19:05:07,2021-04-06 20:55:20.077098
3612,2595,4,2595,33,704,33,10,0,10,Friendships,2,704,49,2021-04-06 19:05:07,2021-04-06 20:55:20.077098
3613,2611,3,2611,16,708,16,6,1,6,Life - School Balance,2,708,55,2021-04-06 19:05:08,2021-04-06 20:03:36.970852
3614,2612,4,2612,21,708,21,7,1,7,Discrimination,2,708,55,2021-04-06 19:05:08,2021-04-06 20:03:36.970852
3615,2613,2,2613,24,708,24,8,1,8,Financial Pressure,2,708,55,2021-04-06 19:05:08,2021-04-06 20:03:36.970852
3616,2614,4,2614,28,708,28,9,1,9,Faculty & Staff Support,2,708,55,2021-04-06 19:05:08,2021-04-06 20:03:36.970852
3617,2615,4,2615,33,708,33,10,0,10,Friendships,2,708,55,2021-04-06 19:05:08,2021-04-06 20:03:36.970852
3618,2641,4,2641,16,714,16,6,1,6,Life - School Balance,2,714,64,2021-04-06 19:05:09,2021-04-07 13:55:38.241709
3619,2642,3,2642,19,714,19,7,0,7,Discrimination,2,714,64,2021-04-06 19:05:09,2021-04-07 13:55:38.241709
3620,2643,3,2643,24,714,24,8,1,8,Financial Pressure,2,714,64,2021-04-06 19:05:09,2021-04-07 13:55:38.241709
3621,2644,3,2644,28,714,28,9,1,9,Faculty & Staff Support,2,714,64,2021-04-06 19:05:09,2021-04-07 13:55:38.241709
3622,2645,5,2645,31,714,31,10,1,10,Friendships,2,714,64,2021-04-06 19:05:09,2021-04-07 13:55:38.241709
3623,2651,5,2651,16,716,16,6,1,6,Life - School Balance,2,716,66,2021-04-06 19:05:09,2021-04-06 19:12:00.338905
3624,2652,4,2652,19,716,19,7,0,7,Discrimination,2,716,66,2021-04-06 19:05:09,2021-04-06 19:12:00.338905
3625,2653,5,2653,25,716,25,8,0,8,Financial Pressure,2,716,66,2021-04-06 19:05:09,2021-04-06 19:12:00.338905
3626,2654,5,2654,29,716,29,9,0,9,Faculty & Staff Support,2,716,66,2021-04-06 19:05:09,2021-04-06 19:12:00.338905
3627,2655,5,2655,33,716,33,10,0,10,Friendships,2,716,66,2021-04-06 19:05:09,2021-04-06 19:12:00.338905
3628,2686,6,2686,16,723,16,6,1,6,Life - School Balance,2,723,73,2021-04-06 19:05:10,2021-04-06 19:09:44.952849
3629,2687,6,2687,21,723,21,7,1,7,Discrimination,2,723,73,2021-04-06 19:05:10,2021-04-06 19:09:44.952849
3630,2688,5,2688,22,723,22,8,1,8,Financial Pressure,2,723,73,2021-04-06 19:05:10,2021-04-06 19:09:44.952849
3631,2689,6,2689,27,723,27,9,1,9,Faculty & Staff Support,2,723,73,2021-04-06 19:05:10,2021-04-06 19:09:44.952849
3632,2690,6,2690,30,723,30,10,1,10,Friendships,2,723,73,2021-04-06 19:05:10,2021-04-06 19:09:44.952849
3633,2696,3,2696,16,725,16,6,1,6,Life - School Balance,2,725,75,2021-04-06 19:05:10,2021-04-06 19:18:46.623795
3634,2697,6,2697,21,725,21,7,1,7,Discrimination,2,725,75,2021-04-06 19:05:10,2021-04-06 19:18:46.623795
3635,2698,4,2698,25,725,25,8,0,8,Financial Pressure,2,725,75,2021-04-06 19:05:10,2021-04-06 19:18:46.623795
3636,2699,6,2699,29,725,29,9,0,9,Faculty & Staff Support,2,725,75,2021-04-06 19:05:10,2021-04-06 19:18:46.623795
3637,2700,5,2700,31,725,31,10,1,10,Friendships,2,725,75,2021-04-06 19:05:10,2021-04-06 19:18:46.623795
3638,2701,3,2701,16,726,16,6,1,6,Life - School Balance,2,726,76,2021-04-06 19:05:11,2021-04-06 19:23:33.007058
3639,2702,5,2702,21,726,21,7,1,7,Discrimination,2,726,76,2021-04-06 19:05:11,2021-04-06 19:23:33.007058
3640,2703,1,2703,24,726,24,8,1,8,Financial Pressure,2,726,76,2021-04-06 19:05:11,2021-04-06 19:23:33.007058
3641,2704,4,2704,28,726,28,9,1,9,Faculty & Staff Support,2,726,76,2021-04-06 19:05:11,2021-04-06 19:23:33.007058
3642,2705,5,2705,33,726,33,10,0,10,Friendships,2,726,76,2021-04-06 19:05:11,2021-04-06 19:23:33.007058
3643,2706,3,2706,16,727,16,6,1,6,Life - School Balance,2,727,77,2021-04-06 19:05:11,2021-04-06 20:08:33.805467
3644,2707,5,2707,20,727,20,7,1,7,Discrimination,2,727,77,2021-04-06 19:05:11,2021-04-06 20:08:33.805467
3645,2708,5,2708,24,727,24,8,1,8,Financial Pressure,2,727,77,2021-04-06 19:05:11,2021-04-06 20:08:33.805467
3646,2709,5,2709,26,727,26,9,1,9,Faculty & Staff Support,2,727,77,2021-04-06 19:05:11,2021-04-06 20:08:33.805467
3647,2710,4,2710,32,727,32,10,1,10,Friendships,2,727,77,2021-04-06 19:05:11,2021-04-06 20:08:33.805467
3648,2726,4,2726,16,731,16,6,1,6,Life - School Balance,2,731,85,2021-04-06 19:05:11,2021-04-06 20:15:05.255630
3649,2727,6,2727,21,731,21,7,1,7,Discrimination,2,731,85,2021-04-06 19:05:11,2021-04-06 20:15:05.255630
3650,2728,1,2728,25,731,25,8,0,8,Financial Pressure,2,731,85,2021-04-06 19:05:11,2021-04-06 20:15:05.255630
3651,2729,4,2729,29,731,29,9,0,9,Faculty & Staff Support,2,731,85,2021-04-06 19:05:11,2021-04-06 20:15:05.255630
3652,2730,6,2730,31,731,31,10,1,10,Friendships,2,731,85,2021-04-06 19:05:11,2021-04-06 20:15:05.255630
3653,2731,4,2731,16,732,16,6,1,6,Life - School Balance,2,732,86,2021-04-06 19:05:12,2021-04-06 19:07:14.783927
3654,2732,5,2732,21,732,21,7,1,7,Discrimination,2,732,86,2021-04-06 19:05:12,2021-04-06 19:07:14.783927
3655,2733,3,2733,23,732,23,8,1,8,Financial Pressure,2,732,86,2021-04-06 19:05:12,2021-04-06 19:07:14.783927
3656,2734,4,2734,28,732,28,9,1,9,Faculty & Staff Support,2,732,86,2021-04-06 19:05:12,2021-04-06 19:07:14.783927
3657,2735,5,2735,31,732,31,10,1,10,Friendships,2,732,86,2021-04-06 19:05:12,2021-04-06 19:07:14.783927
3658,2736,4,2736,16,733,16,6,1,6,Life - School Balance,2,733,87,2021-04-06 19:05:12,2021-04-06 20:04:56.796731
3659,2737,6,2737,20,733,20,7,1,7,Discrimination,2,733,87,2021-04-06 19:05:12,2021-04-06 20:04:56.796731
3660,2738,1,2738,22,733,22,8,1,8,Financial Pressure,2,733,87,2021-04-06 19:05:12,2021-04-06 20:04:56.796731
3661,2739,5,2739,27,733,27,9,1,9,Faculty & Staff Support,2,733,87,2021-04-06 19:05:12,2021-04-06 20:04:56.796731
3662,2740,4,2740,30,733,30,10,1,10,Friendships,2,733,87,2021-04-06 19:05:12,2021-04-06 20:04:56.796731
3663,2761,1,2761,16,738,16,6,1,6,Life - School Balance,2,738,93,2021-04-06 19:05:13,2021-04-07 00:12:55.237805
3664,2762,6,2762,19,738,19,7,0,7,Discrimination,2,738,93,2021-04-06 19:05:13,2021-04-07 00:12:55.237805
3665,2763,4,2763,22,738,22,8,1,8,Financial Pressure,2,738,93,2021-04-06 19:05:13,2021-04-07 00:12:55.237805
3666,2764,4,2764,27,738,27,9,1,9,Faculty & Staff Support,2,738,93,2021-04-06 19:05:13,2021-04-07 00:12:55.237805
3667,2765,1,2765,33,738,33,10,0,10,Friendships,2,738,93,2021-04-06 19:05:13,2021-04-07 00:12:55.237805
3668,2766,6,2766,16,739,16,6,1,6,Life - School Balance,2,739,94,2021-04-06 19:05:13,2021-04-06 19:07:09.189982
3669,2767,6,2767,20,739,20,7,1,7,Discrimination,2,739,94,2021-04-06 19:05:13,2021-04-06 19:07:09.189982
3670,2768,4,2768,25,739,25,8,0,8,Financial Pressure,2,739,94,2021-04-06 19:05:13,2021-04-06 19:07:09.189982
3671,2769,6,2769,28,739,28,9,1,9,Faculty & Staff Support,2,739,94,2021-04-06 19:05:13,2021-04-06 19:07:09.189982
3672,2770,6,2770,32,739,32,10,1,10,Friendships,2,739,94,2021-04-06 19:05:13,2021-04-06 19:07:09.189982
3673,2771,5,2771,16,740,16,6,1,6,Life - School Balance,2,740,95,2021-04-06 19:05:13,2021-04-06 19:30:00.429866
3674,2772,6,2772,19,740,19,7,0,7,Discrimination,2,740,95,2021-04-06 19:05:13,2021-04-06 19:30:00.429866
3675,2773,4,2773,24,740,24,8,1,8,Financial Pressure,2,740,95,2021-04-06 19:05:13,2021-04-06 19:30:00.429866
3676,2774,5,2774,29,740,29,9,0,9,Faculty & Staff Support,2,740,95,2021-04-06 19:05:13,2021-04-06 19:30:00.429866
3677,2775,6,2775,30,740,30,10,1,10,Friendships,2,740,95,2021-04-06 19:05:13,2021-04-06 19:30:00.429866
3678,2776,4,2776,16,741,16,6,1,6,Life - School Balance,2,741,96,2021-04-06 19:05:13,2021-04-06 21:02:54.590737
3679,2777,5,2777,21,741,21,7,1,7,Discrimination,2,741,96,2021-04-06 19:05:13,2021-04-06 21:02:54.590737
3680,2778,5,2778,23,741,23,8,1,8,Financial Pressure,2,741,96,2021-04-06 19:05:13,2021-04-06 21:02:54.590737
3681,2779,4,2779,26,741,26,9,1,9,Faculty & Staff Support,2,741,96,2021-04-06 19:05:13,2021-04-06 21:02:54.590737
3682,2780,4,2780,30,741,30,10,1,10,Friendships,2,741,96,2021-04-06 19:05:13,2021-04-06 21:02:54.590737
3683,2806,4,2806,16,747,16,6,1,6,Life - School Balance,2,747,104,2021-04-06 19:05:14,2021-04-06 19:30:14.847372
3684,2807,5,2807,19,747,19,7,0,7,Discrimination,2,747,104,2021-04-06 19:05:14,2021-04-06 19:30:14.847372
3685,2808,3,2808,23,747,23,8,1,8,Financial Pressure,2,747,104,2021-04-06 19:05:14,2021-04-06 19:30:14.847372
3686,2809,6,2809,29,747,29,9,0,9,Faculty & Staff Support,2,747,104,2021-04-06 19:05:14,2021-04-06 19:30:14.847372
3687,2810,4,2810,32,747,32,10,1,10,Friendships,2,747,104,2021-04-06 19:05:14,2021-04-06 19:30:14.847372
3688,2836,3,2836,16,753,16,6,1,6,Life - School Balance,2,753,5,2021-04-08 14:05:02,2021-04-08 14:16:37.308621
3689,2837,5,2837,21,753,21,7,1,7,Discrimination,2,753,5,2021-04-08 14:05:02,2021-04-08 14:16:37.308621
3690,2838,3,2838,22,753,22,8,1,8,Financial Pressure,2,753,5,2021-04-08 14:05:02,2021-04-08 14:16:37.308621
3691,2839,4,2839,27,753,27,9,1,9,Faculty & Staff Support,2,753,5,2021-04-08 14:05:02,2021-04-08 14:16:37.308621
3692,2840,5,2840,30,753,30,10,1,10,Friendships,2,753,5,2021-04-08 14:05:02,2021-04-08 14:16:37.308621
3693,2856,3,2856,16,757,16,6,1,6,Life - School Balance,2,757,13,2021-04-08 14:05:03,2021-04-08 14:48:05.239006
3694,2857,4,2857,19,757,19,7,0,7,Discrimination,2,757,13,2021-04-08 14:05:03,2021-04-08 14:48:05.239006
3695,2858,4,2858,22,757,22,8,1,8,Financial Pressure,2,757,13,2021-04-08 14:05:03,2021-04-08 14:48:05.239006
3696,2859,4,2859,27,757,27,9,1,9,Faculty & Staff Support,2,757,13,2021-04-08 14:05:03,2021-04-08 14:48:05.239006
3697,2860,5,2860,31,757,31,10,1,10,Friendships,2,757,13,2021-04-08 14:05:03,2021-04-08 14:48:05.239006
3698,2871,2,2871,16,760,16,6,1,6,Life - School Balance,2,760,17,2021-04-08 14:05:03,2021-04-08 14:59:19.865959
3699,2872,5,2872,21,760,21,7,1,7,Discrimination,2,760,17,2021-04-08 14:05:03,2021-04-08 14:59:19.865959
3700,2873,6,2873,25,760,25,8,0,8,Financial Pressure,2,760,17,2021-04-08 14:05:03,2021-04-08 14:59:19.865959
3701,2874,2,2874,28,760,28,9,1,9,Faculty & Staff Support,2,760,17,2021-04-08 14:05:03,2021-04-08 14:59:19.865959
3702,2875,4,2875,30,760,30,10,1,10,Friendships,2,760,17,2021-04-08 14:05:03,2021-04-08 14:59:19.865959
3703,2876,4,2876,16,761,16,6,1,6,Life - School Balance,2,761,18,2021-04-08 14:05:03,2021-04-08 14:08:21.800474
3704,2877,2,2877,19,761,19,7,0,7,Discrimination,2,761,18,2021-04-08 14:05:03,2021-04-08 14:08:21.800474
3705,2878,6,2878,24,761,24,8,1,8,Financial Pressure,2,761,18,2021-04-08 14:05:03,2021-04-08 14:08:21.800474
3706,2879,5,2879,29,761,29,9,0,9,Faculty & Staff Support,2,761,18,2021-04-08 14:05:03,2021-04-08 14:08:21.800474
3707,2880,4,2880,30,761,30,10,1,10,Friendships,2,761,18,2021-04-08 14:05:03,2021-04-08 14:08:21.800474
3708,2906,3,2906,16,767,16,6,1,6,Life - School Balance,2,767,27,2021-04-08 14:05:04,2021-04-08 14:05:48.267123
3709,2907,6,2907,21,767,21,7,1,7,Discrimination,2,767,27,2021-04-08 14:05:04,2021-04-08 14:05:48.267123
3710,2908,1,2908,23,767,23,8,1,8,Financial Pressure,2,767,27,2021-04-08 14:05:04,2021-04-08 14:05:48.267123
3711,2909,5,2909,27,767,27,9,1,9,Faculty & Staff Support,2,767,27,2021-04-08 14:05:04,2021-04-08 14:05:48.267123
3712,2910,5,2910,30,767,30,10,1,10,Friendships,2,767,27,2021-04-08 14:05:04,2021-04-08 14:05:48.267123
3713,2916,1,2916,16,769,16,6,1,6,Life - School Balance,2,769,30,2021-04-08 14:05:05,2021-04-08 14:08:45.490982
3714,2917,5,2917,20,769,20,7,1,7,Discrimination,2,769,30,2021-04-08 14:05:05,2021-04-08 14:08:45.490982
3715,2918,3,2918,25,769,25,8,0,8,Financial Pressure,2,769,30,2021-04-08 14:05:05,2021-04-08 14:08:45.490982
3716,2919,4,2919,29,769,29,9,0,9,Faculty & Staff Support,2,769,30,2021-04-08 14:05:05,2021-04-08 14:08:45.490982
3717,2920,6,2920,33,769,33,10,0,10,Friendships,2,769,30,2021-04-08 14:05:05,2021-04-08 14:08:45.490982
3718,2946,2,2946,16,775,16,6,1,6,Life - School Balance,2,775,40,2021-04-08 14:05:06,2021-04-08 14:38:14.493485
3719,2947,3,2947,19,775,19,7,0,7,Discrimination,2,775,40,2021-04-08 14:05:06,2021-04-08 14:38:14.493485
3720,2948,5,2948,24,775,24,8,1,8,Financial Pressure,2,775,40,2021-04-08 14:05:06,2021-04-08 14:38:14.493485
3721,2949,4,2949,28,775,28,9,1,9,Faculty & Staff Support,2,775,40,2021-04-08 14:05:06,2021-04-08 14:38:14.493485
3722,2950,3,2950,32,775,32,10,1,10,Friendships,2,775,40,2021-04-08 14:05:06,2021-04-08 14:38:14.493485
3723,2961,4,2961,16,778,16,6,1,6,Life - School Balance,2,778,44,2021-04-08 14:05:06,2021-04-08 18:00:59.010218
3724,2962,5,2962,19,778,19,7,0,7,Discrimination,2,778,44,2021-04-08 14:05:06,2021-04-08 18:00:59.010218
3725,2963,4,2963,24,778,24,8,1,8,Financial Pressure,2,778,44,2021-04-08 14:05:06,2021-04-08 18:00:59.010218
3726,2964,3,2964,26,778,26,9,1,9,Faculty & Staff Support,2,778,44,2021-04-08 14:05:06,2021-04-08 18:00:59.010218
3727,2965,4,2965,30,778,30,10,1,10,Friendships,2,778,44,2021-04-08 14:05:06,2021-04-08 18:00:59.010218
3728,2966,5,2966,16,779,16,6,1,6,Life - School Balance,2,779,45,2021-04-08 14:05:06,2021-04-08 14:11:32.049784
3729,2967,6,2967,21,779,21,7,1,7,Discrimination,2,779,45,2021-04-08 14:05:06,2021-04-08 14:11:32.049784
3730,2968,2,2968,25,779,25,8,0,8,Financial Pressure,2,779,45,2021-04-08 14:05:06,2021-04-08 14:11:32.049784
3731,2969,6,2969,27,779,27,9,1,9,Faculty & Staff Support,2,779,45,2021-04-08 14:05:06,2021-04-08 14:11:32.049784
3732,2970,5,2970,31,779,31,10,1,10,Friendships,2,779,45,2021-04-08 14:05:06,2021-04-08 14:11:32.049784
3733,2976,5,2976,16,781,16,6,1,6,Life - School Balance,2,781,47,2021-04-08 14:05:07,2021-04-08 14:14:56.180514
3734,2977,6,2977,20,781,20,7,1,7,Discrimination,2,781,47,2021-04-08 14:05:07,2021-04-08 14:14:56.180514
3735,2978,4,2978,24,781,24,8,1,8,Financial Pressure,2,781,47,2021-04-08 14:05:07,2021-04-08 14:14:56.180514
3736,2979,5,2979,27,781,27,9,1,9,Faculty & Staff Support,2,781,47,2021-04-08 14:05:07,2021-04-08 14:14:56.180514
3737,2980,4,2980,30,781,30,10,1,10,Friendships,2,781,47,2021-04-08 14:05:07,2021-04-08 14:14:56.180514
3738,3001,3,3001,16,786,16,6,1,6,Life - School Balance,2,786,54,2021-04-08 14:05:08,2021-04-08 14:22:34.456876
3739,3002,5,3002,19,786,19,7,0,7,Discrimination,2,786,54,2021-04-08 14:05:08,2021-04-08 14:22:34.456876
3740,3003,4,3003,23,786,23,8,1,8,Financial Pressure,2,786,54,2021-04-08 14:05:08,2021-04-08 14:22:34.456876
3741,3004,6,3004,28,786,28,9,1,9,Faculty & Staff Support,2,786,54,2021-04-08 14:05:08,2021-04-08 14:22:34.456876
3742,3005,5,3005,33,786,33,10,0,10,Friendships,2,786,54,2021-04-08 14:05:08,2021-04-08 14:22:34.456876
3743,3006,3,3006,16,787,16,6,1,6,Life - School Balance,2,787,55,2021-04-08 14:05:08,2021-04-08 14:49:11.423374
3744,3007,4,3007,20,787,20,7,1,7,Discrimination,2,787,55,2021-04-08 14:05:08,2021-04-08 14:49:11.423374
3745,3008,2,3008,22,787,22,8,1,8,Financial Pressure,2,787,55,2021-04-08 14:05:08,2021-04-08 14:49:11.423374
3746,3009,5,3009,27,787,27,9,1,9,Faculty & Staff Support,2,787,55,2021-04-08 14:05:08,2021-04-08 14:49:11.423374
3747,3010,4,3010,32,787,32,10,1,10,Friendships,2,787,55,2021-04-08 14:05:08,2021-04-08 14:49:11.423374
3748,3021,3,3021,16,790,16,6,1,6,Life - School Balance,2,790,60,2021-04-08 14:05:08,2021-04-08 16:16:27.279346
3749,3022,3,3022,19,790,19,7,0,7,Discrimination,2,790,60,2021-04-08 14:05:08,2021-04-08 16:16:27.279346
3750,3023,5,3023,24,790,24,8,1,8,Financial Pressure,2,790,60,2021-04-08 14:05:08,2021-04-08 16:16:27.279346
3751,3024,3,3024,28,790,28,9,1,9,Faculty & Staff Support,2,790,60,2021-04-08 14:05:08,2021-04-08 16:16:27.279346
3752,3025,4,3025,32,790,32,10,1,10,Friendships,2,790,60,2021-04-08 14:05:08,2021-04-08 16:16:27.279346
3753,3051,4,3051,16,796,16,6,1,6,Life - School Balance,2,796,67,2021-04-08 14:05:09,2021-04-08 17:31:51.339790
3754,3052,3,3052,19,796,19,7,0,7,Discrimination,2,796,67,2021-04-08 14:05:09,2021-04-08 17:31:51.339790
3755,3053,6,3053,23,796,23,8,1,8,Financial Pressure,2,796,67,2021-04-08 14:05:09,2021-04-08 17:31:51.339790
3756,3054,4,3054,29,796,29,9,0,9,Faculty & Staff Support,2,796,67,2021-04-08 14:05:09,2021-04-08 17:31:51.339790
3757,3055,4,3055,31,796,31,10,1,10,Friendships,2,796,67,2021-04-08 14:05:09,2021-04-08 17:31:51.339790
3758,3066,3,3066,16,799,16,6,1,6,Life - School Balance,2,799,70,2021-04-08 14:05:10,2021-04-08 14:16:00.603588
3759,3067,5,3067,19,799,19,7,0,7,Discrimination,2,799,70,2021-04-08 14:05:10,2021-04-08 14:16:00.603588
3760,3068,3,3068,23,799,23,8,1,8,Financial Pressure,2,799,70,2021-04-08 14:05:10,2021-04-08 14:16:00.603588
3761,3069,4,3069,27,799,27,9,1,9,Faculty & Staff Support,2,799,70,2021-04-08 14:05:10,2021-04-08 14:16:00.603588
3762,3070,6,3070,31,799,31,10,1,10,Friendships,2,799,70,2021-04-08 14:05:10,2021-04-08 14:16:00.603588
3763,3131,4,3131,16,812,16,6,1,6,Life - School Balance,2,812,87,2021-04-08 14:05:13,2021-04-08 14:54:06.301489
3764,3132,4,3132,20,812,20,7,1,7,Discrimination,2,812,87,2021-04-08 14:05:13,2021-04-08 14:54:06.301489
3765,3133,3,3133,24,812,24,8,1,8,Financial Pressure,2,812,87,2021-04-08 14:05:13,2021-04-08 14:54:06.301489
3766,3134,6,3134,27,812,27,9,1,9,Faculty & Staff Support,2,812,87,2021-04-08 14:05:13,2021-04-08 14:54:06.301489
3767,3135,4,3135,30,812,30,10,1,10,Friendships,2,812,87,2021-04-08 14:05:13,2021-04-08 14:54:06.301489
3768,3136,5,3136,16,813,16,6,1,6,Life - School Balance,2,813,88,2021-04-08 14:05:13,2021-04-08 15:21:42.879284
3769,3137,6,3137,20,813,20,7,1,7,Discrimination,2,813,88,2021-04-08 14:05:13,2021-04-08 15:21:42.879284
3770,3138,4,3138,24,813,24,8,1,8,Financial Pressure,2,813,88,2021-04-08 14:05:13,2021-04-08 15:21:42.879284
3771,3139,5,3139,28,813,28,9,1,9,Faculty & Staff Support,2,813,88,2021-04-08 14:05:13,2021-04-08 15:21:42.879284
3772,3140,6,3140,33,813,33,10,0,10,Friendships,2,813,88,2021-04-08 14:05:13,2021-04-08 15:21:42.879284
3773,3146,4,3146,16,815,16,6,1,6,Life - School Balance,2,815,90,2021-04-08 14:05:13,2021-04-08 14:11:37.400990
3774,3147,5,3147,21,815,21,7,1,7,Discrimination,2,815,90,2021-04-08 14:05:13,2021-04-08 14:11:37.400990
3775,3148,6,3148,22,815,22,8,1,8,Financial Pressure,2,815,90,2021-04-08 14:05:13,2021-04-08 14:11:37.400990
3776,3149,6,3149,28,815,28,9,1,9,Faculty & Staff Support,2,815,90,2021-04-08 14:05:13,2021-04-08 14:11:37.400990
3777,3150,6,3150,30,815,30,10,1,10,Friendships,2,815,90,2021-04-08 14:05:13,2021-04-08 14:11:37.400990
3778,3151,5,3151,16,816,16,6,1,6,Life - School Balance,2,816,91,2021-04-08 14:05:14,2021-04-08 14:26:30.008847
3779,3152,6,3152,19,816,19,7,0,7,Discrimination,2,816,91,2021-04-08 14:05:14,2021-04-08 14:26:30.008847
3780,3153,2,3153,25,816,25,8,0,8,Financial Pressure,2,816,91,2021-04-08 14:05:14,2021-04-08 14:26:30.008847
3781,3154,6,3154,27,816,27,9,1,9,Faculty & Staff Support,2,816,91,2021-04-08 14:05:14,2021-04-08 14:26:30.008847
3782,3155,6,3155,30,816,30,10,1,10,Friendships,2,816,91,2021-04-08 14:05:14,2021-04-08 14:26:30.008847
3783,3156,4,3156,16,817,16,6,1,6,Life - School Balance,2,817,93,2021-04-08 14:05:14,2021-04-08 14:23:24.831884
3784,3157,6,3157,19,817,19,7,0,7,Discrimination,2,817,93,2021-04-08 14:05:14,2021-04-08 14:23:24.831884
3785,3158,4,3158,22,817,22,8,1,8,Financial Pressure,2,817,93,2021-04-08 14:05:14,2021-04-08 14:23:24.831884
3786,3159,3,3159,28,817,28,9,1,9,Faculty & Staff Support,2,817,93,2021-04-08 14:05:14,2021-04-08 14:23:24.831884
3787,3160,3,3160,30,817,30,10,1,10,Friendships,2,817,93,2021-04-08 14:05:14,2021-04-08 14:23:24.831884
3788,3176,5,3176,16,821,16,6,1,6,Life - School Balance,2,821,98,2021-04-08 14:05:15,2021-04-08 14:06:52.216440
3789,3177,2,3177,20,821,20,7,1,7,Discrimination,2,821,98,2021-04-08 14:05:15,2021-04-08 14:06:52.216440
3790,3178,5,3178,24,821,24,8,1,8,Financial Pressure,2,821,98,2021-04-08 14:05:15,2021-04-08 14:06:52.216440
3791,3179,2,3179,26,821,26,9,1,9,Faculty & Staff Support,2,821,98,2021-04-08 14:05:15,2021-04-08 14:06:52.216440
3792,3180,4,3180,33,821,33,10,0,10,Friendships,2,821,98,2021-04-08 14:05:15,2021-04-08 14:06:52.216440
3793,3206,3,3206,16,827,16,6,1,6,Life - School Balance,2,827,105,2021-04-08 14:05:16,2021-04-08 14:23:42.660419
3794,3207,4,3207,19,827,19,7,0,7,Discrimination,2,827,105,2021-04-08 14:05:16,2021-04-08 14:23:42.660419
3795,3208,6,3208,22,827,22,8,1,8,Financial Pressure,2,827,105,2021-04-08 14:05:16,2021-04-08 14:23:42.660419
3796,3209,4,3209,26,827,26,9,1,9,Faculty & Staff Support,2,827,105,2021-04-08 14:05:16,2021-04-08 14:23:42.660419
3797,3210,4,3210,32,827,32,10,1,10,Friendships,2,827,105,2021-04-08 14:05:16,2021-04-08 14:23:42.660419
3798,3251,4,3251,16,836,16,6,1,6,Life - School Balance,2,836,13,2021-04-13 19:05:02,2021-04-13 19:05:41.061741
3799,3252,4,3252,20,836,20,7,1,7,Discrimination,2,836,13,2021-04-13 19:05:02,2021-04-13 19:05:41.061741
3800,3253,4,3253,22,836,22,8,1,8,Financial Pressure,2,836,13,2021-04-13 19:05:02,2021-04-13 19:05:41.061741
3801,3254,4,3254,29,836,29,9,0,9,Faculty & Staff Support,2,836,13,2021-04-13 19:05:02,2021-04-13 19:05:41.061741
3802,3255,5,3255,31,836,31,10,1,10,Friendships,2,836,13,2021-04-13 19:05:02,2021-04-13 19:05:41.061741
3803,3276,5,3276,16,841,16,6,1,6,Life - School Balance,2,841,19,2021-04-13 19:05:02,2021-04-13 20:01:38.539572
3804,3277,5,3277,20,841,20,7,1,7,Discrimination,2,841,19,2021-04-13 19:05:02,2021-04-13 20:01:38.539572
3805,3278,3,3278,24,841,24,8,1,8,Financial Pressure,2,841,19,2021-04-13 19:05:02,2021-04-13 20:01:38.539572
3806,3279,4,3279,29,841,29,9,0,9,Faculty & Staff Support,2,841,19,2021-04-13 19:05:02,2021-04-13 20:01:38.539572
3807,3280,4,3280,30,841,30,10,1,10,Friendships,2,841,19,2021-04-13 19:05:02,2021-04-13 20:01:38.539572
3808,3281,4,3281,16,842,16,6,1,6,Life - School Balance,2,842,20,2021-04-13 19:05:03,2021-04-13 19:59:54.240368
3809,3282,5,3282,20,842,20,7,1,7,Discrimination,2,842,20,2021-04-13 19:05:03,2021-04-13 19:59:54.240368
3810,3283,5,3283,23,842,23,8,1,8,Financial Pressure,2,842,20,2021-04-13 19:05:03,2021-04-13 19:59:54.240368
3811,3284,5,3284,28,842,28,9,1,9,Faculty & Staff Support,2,842,20,2021-04-13 19:05:03,2021-04-13 19:59:54.240368
3812,3285,4,3285,32,842,32,10,1,10,Friendships,2,842,20,2021-04-13 19:05:03,2021-04-13 19:59:54.240368
3813,3286,2,3286,16,843,16,6,1,6,Life - School Balance,2,843,22,2021-04-13 19:05:03,2021-04-13 19:06:41.853992
3814,3287,2,3287,21,843,21,7,1,7,Discrimination,2,843,22,2021-04-13 19:05:03,2021-04-13 19:06:41.853992
3815,3288,5,3288,25,843,25,8,0,8,Financial Pressure,2,843,22,2021-04-13 19:05:03,2021-04-13 19:06:41.853992
3816,3289,3,3289,28,843,28,9,1,9,Faculty & Staff Support,2,843,22,2021-04-13 19:05:03,2021-04-13 19:06:41.853992
3817,3290,5,3290,31,843,31,10,1,10,Friendships,2,843,22,2021-04-13 19:05:03,2021-04-13 19:06:41.853992
3818,3316,3,3316,16,849,16,6,1,6,Life - School Balance,2,849,31,2021-04-13 19:05:04,2021-04-13 19:06:43.465179
3819,3317,6,3317,19,849,19,7,0,7,Discrimination,2,849,31,2021-04-13 19:05:04,2021-04-13 19:06:43.465179
3820,3318,5,3318,23,849,23,8,1,8,Financial Pressure,2,849,31,2021-04-13 19:05:04,2021-04-13 19:06:43.465179
3821,3319,3,3319,27,849,27,9,1,9,Faculty & Staff Support,2,849,31,2021-04-13 19:05:04,2021-04-13 19:06:43.465179
3822,3320,3,3320,32,849,32,10,1,10,Friendships,2,849,31,2021-04-13 19:05:04,2021-04-13 19:06:43.465179
3823,3366,5,3366,16,859,16,6,1,6,Life - School Balance,2,859,46,2021-04-13 19:05:05,2021-04-13 19:07:06.139299
3824,3367,6,3367,21,859,21,7,1,7,Discrimination,2,859,46,2021-04-13 19:05:05,2021-04-13 19:07:06.139299
3825,3368,4,3368,22,859,22,8,1,8,Financial Pressure,2,859,46,2021-04-13 19:05:05,2021-04-13 19:07:06.139299
3826,3369,5,3369,27,859,27,9,1,9,Faculty & Staff Support,2,859,46,2021-04-13 19:05:05,2021-04-13 19:07:06.139299
3827,3370,6,3370,32,859,32,10,1,10,Friendships,2,859,46,2021-04-13 19:05:05,2021-04-13 19:07:06.139299
3828,3416,3,3416,16,869,16,6,1,6,Life - School Balance,2,869,60,2021-04-13 19:05:07,2021-04-13 20:02:48.234997
3829,3417,4,3417,19,869,19,7,0,7,Discrimination,2,869,60,2021-04-13 19:05:07,2021-04-13 20:02:48.234997
3830,3418,3,3418,23,869,23,8,1,8,Financial Pressure,2,869,60,2021-04-13 19:05:07,2021-04-13 20:02:48.234997
3831,3419,4,3419,29,869,29,9,0,9,Faculty & Staff Support,2,869,60,2021-04-13 19:05:07,2021-04-13 20:02:48.234997
3832,3420,4,3420,31,869,31,10,1,10,Friendships,2,869,60,2021-04-13 19:05:07,2021-04-13 20:02:48.234997
3833,3486,3,3486,16,883,16,6,1,6,Life - School Balance,2,883,75,2021-04-13 19:05:09,2021-04-13 19:07:25.279873
3834,3487,6,3487,21,883,21,7,1,7,Discrimination,2,883,75,2021-04-13 19:05:09,2021-04-13 19:07:25.279873
3835,3488,3,3488,23,883,23,8,1,8,Financial Pressure,2,883,75,2021-04-13 19:05:09,2021-04-13 19:07:25.279873
3836,3489,5,3489,28,883,28,9,1,9,Faculty & Staff Support,2,883,75,2021-04-13 19:05:09,2021-04-13 19:07:25.279873
3837,3490,6,3490,32,883,32,10,1,10,Friendships,2,883,75,2021-04-13 19:05:09,2021-04-13 19:07:25.279873
3838,3491,3,3491,16,884,16,6,1,6,Life - School Balance,2,884,76,2021-04-13 19:05:09,2021-04-14 01:34:03.272791
3839,3492,4,3492,20,884,20,7,1,7,Discrimination,2,884,76,2021-04-13 19:05:09,2021-04-14 01:34:03.272791
3840,3493,5,3493,25,884,25,8,0,8,Financial Pressure,2,884,76,2021-04-13 19:05:09,2021-04-14 01:34:03.272791
3841,3494,4,3494,27,884,27,9,1,9,Faculty & Staff Support,2,884,76,2021-04-13 19:05:09,2021-04-14 01:34:03.272791
3842,3495,4,3495,32,884,32,10,1,10,Friendships,2,884,76,2021-04-13 19:05:09,2021-04-14 01:34:03.272791
3843,3521,4,3521,16,890,16,6,1,6,Life - School Balance,2,890,86,2021-04-13 19:05:10,2021-04-13 19:27:20.061570
3844,3522,5,3522,20,890,20,7,1,7,Discrimination,2,890,86,2021-04-13 19:05:10,2021-04-13 19:27:20.061570
3845,3523,3,3523,23,890,23,8,1,8,Financial Pressure,2,890,86,2021-04-13 19:05:10,2021-04-13 19:27:20.061570
3846,3524,5,3524,29,890,29,9,0,9,Faculty & Staff Support,2,890,86,2021-04-13 19:05:10,2021-04-13 19:27:20.061570
3847,3525,5,3525,31,890,31,10,1,10,Friendships,2,890,86,2021-04-13 19:05:10,2021-04-13 19:27:20.061570
3848,3546,5,3546,16,895,16,6,1,6,Life - School Balance,2,895,91,2021-04-13 19:05:11,2021-04-13 19:38:08.951343
3849,3547,6,3547,21,895,21,7,1,7,Discrimination,2,895,91,2021-04-13 19:05:11,2021-04-13 19:38:08.951343
3850,3548,2,3548,23,895,23,8,1,8,Financial Pressure,2,895,91,2021-04-13 19:05:11,2021-04-13 19:38:08.951343
3851,3549,6,3549,27,895,27,9,1,9,Faculty & Staff Support,2,895,91,2021-04-13 19:05:11,2021-04-13 19:38:08.951343
3852,3550,6,3550,30,895,30,10,1,10,Friendships,2,895,91,2021-04-13 19:05:11,2021-04-13 19:38:08.951343
3853,3581,4,3581,16,902,16,6,1,6,Life - School Balance,2,902,100,2021-04-13 19:05:12,2021-04-13 19:06:39.050756
3854,3582,6,3582,21,902,21,7,1,7,Discrimination,2,902,100,2021-04-13 19:05:12,2021-04-13 19:06:39.050756
3855,3583,4,3583,22,902,22,8,1,8,Financial Pressure,2,902,100,2021-04-13 19:05:12,2021-04-13 19:06:39.050756
3856,3584,5,3584,27,902,27,9,1,9,Faculty & Staff Support,2,902,100,2021-04-13 19:05:12,2021-04-13 19:06:39.050756
3857,3585,5,3585,33,902,33,10,0,10,Friendships,2,902,100,2021-04-13 19:05:12,2021-04-13 19:06:39.050756
3858,3626,3,3626,16,911,16,6,1,6,Life - School Balance,2,911,5,2021-04-15 14:05:01,2021-04-15 14:55:37.053082
3859,3627,5,3627,21,911,21,7,1,7,Discrimination,2,911,5,2021-04-15 14:05:01,2021-04-15 14:55:37.053082
3860,3628,3,3628,25,911,25,8,0,8,Financial Pressure,2,911,5,2021-04-15 14:05:01,2021-04-15 14:55:37.053082
3861,3629,5,3629,26,911,26,9,1,9,Faculty & Staff Support,2,911,5,2021-04-15 14:05:01,2021-04-15 14:55:37.053082
3862,3630,5,3630,32,911,32,10,1,10,Friendships,2,911,5,2021-04-15 14:05:01,2021-04-15 14:55:37.053082
3863,3671,4,3671,16,920,16,6,1,6,Life - School Balance,2,920,19,2021-04-15 14:05:03,2021-04-15 14:48:40.004806
3864,3672,4,3672,21,920,21,7,1,7,Discrimination,2,920,19,2021-04-15 14:05:03,2021-04-15 14:48:40.004806
3865,3673,4,3673,22,920,22,8,1,8,Financial Pressure,2,920,19,2021-04-15 14:05:03,2021-04-15 14:48:40.004806
3866,3674,4,3674,28,920,28,9,1,9,Faculty & Staff Support,2,920,19,2021-04-15 14:05:03,2021-04-15 14:48:40.004806
3867,3675,4,3675,32,920,32,10,1,10,Friendships,2,920,19,2021-04-15 14:05:03,2021-04-15 14:48:40.004806
3868,3751,4,3751,16,936,16,6,1,6,Life - School Balance,2,936,44,2021-04-15 14:05:06,2021-04-15 14:05:58.920815
3869,3752,3,3752,20,936,20,7,1,7,Discrimination,2,936,44,2021-04-15 14:05:06,2021-04-15 14:05:58.920815
3870,3753,3,3753,22,936,22,8,1,8,Financial Pressure,2,936,44,2021-04-15 14:05:06,2021-04-15 14:05:58.920815
3871,3754,3,3754,29,936,29,9,0,9,Faculty & Staff Support,2,936,44,2021-04-15 14:05:06,2021-04-15 14:05:58.920815
3872,3755,4,3755,32,936,32,10,1,10,Friendships,2,936,44,2021-04-15 14:05:06,2021-04-15 14:05:58.920815
3873,3756,5,3756,16,937,16,6,1,6,Life - School Balance,2,937,45,2021-04-15 14:05:06,2021-04-15 14:05:48.079884
3874,3757,5,3757,20,937,20,7,1,7,Discrimination,2,937,45,2021-04-15 14:05:06,2021-04-15 14:05:48.079884
3875,3758,1,3758,23,937,23,8,1,8,Financial Pressure,2,937,45,2021-04-15 14:05:06,2021-04-15 14:05:48.079884
3876,3759,5,3759,26,937,26,9,1,9,Faculty & Staff Support,2,937,45,2021-04-15 14:05:06,2021-04-15 14:05:48.079884
3877,3760,5,3760,31,937,31,10,1,10,Friendships,2,937,45,2021-04-15 14:05:06,2021-04-15 14:05:48.079884
3878,3761,3,3761,16,938,16,6,1,6,Life - School Balance,2,938,46,2021-04-15 14:05:07,2021-04-15 14:14:04.909465
3879,3762,4,3762,19,938,19,7,0,7,Discrimination,2,938,46,2021-04-15 14:05:07,2021-04-15 14:14:04.909465
3880,3763,3,3763,25,938,25,8,0,8,Financial Pressure,2,938,46,2021-04-15 14:05:07,2021-04-15 14:14:04.909465
3881,3764,3,3764,27,938,27,9,1,9,Faculty & Staff Support,2,938,46,2021-04-15 14:05:07,2021-04-15 14:14:04.909465
3882,3765,4,3765,31,938,31,10,1,10,Friendships,2,938,46,2021-04-15 14:05:07,2021-04-15 14:14:04.909465
3883,3776,4,3776,16,941,16,6,1,6,Life - School Balance,2,941,49,2021-04-15 14:05:07,2021-04-15 21:41:29.983905
3884,3777,4,3777,21,941,21,7,1,7,Discrimination,2,941,49,2021-04-15 14:05:07,2021-04-15 21:41:29.983905
3885,3778,4,3778,23,941,23,8,1,8,Financial Pressure,2,941,49,2021-04-15 14:05:07,2021-04-15 21:41:29.983905
3886,3779,4,3779,26,941,26,9,1,9,Faculty & Staff Support,2,941,49,2021-04-15 14:05:07,2021-04-15 21:41:29.983905
3887,3780,4,3780,33,941,33,10,0,10,Friendships,2,941,49,2021-04-15 14:05:07,2021-04-15 21:41:29.983905
3888,3806,3,3806,16,947,16,6,1,6,Life - School Balance,2,947,58,2021-04-15 14:05:08,2021-04-16 04:38:08.113108
3889,3807,3,3807,21,947,21,7,1,7,Discrimination,2,947,58,2021-04-15 14:05:08,2021-04-16 04:38:08.113108
3890,3808,2,3808,22,947,22,8,1,8,Financial Pressure,2,947,58,2021-04-15 14:05:08,2021-04-16 04:38:08.113108
3891,3809,5,3809,29,947,29,9,0,9,Faculty & Staff Support,2,947,58,2021-04-15 14:05:08,2021-04-16 04:38:08.113108
3892,3810,4,3810,30,947,30,10,1,10,Friendships,2,947,58,2021-04-15 14:05:08,2021-04-16 04:38:08.113108
3893,3901,4,3901,16,966,16,6,1,6,Life - School Balance,2,966,79,2021-04-15 14:05:12,2021-04-15 17:02:31.939844
3894,3902,4,3902,21,966,21,7,1,7,Discrimination,2,966,79,2021-04-15 14:05:12,2021-04-15 17:02:31.939844
3895,3903,4,3903,22,966,22,8,1,8,Financial Pressure,2,966,79,2021-04-15 14:05:12,2021-04-15 17:02:31.939844
3896,3904,6,3904,27,966,27,9,1,9,Faculty & Staff Support,2,966,79,2021-04-15 14:05:12,2021-04-15 17:02:31.939844
3897,3905,5,3905,33,966,33,10,0,10,Friendships,2,966,79,2021-04-15 14:05:12,2021-04-15 17:02:31.939844
3898,3906,2,3906,16,967,16,6,1,6,Life - School Balance,2,967,84,2021-04-15 14:05:12,2021-04-15 16:01:46.762165
3899,3907,5,3907,21,967,21,7,1,7,Discrimination,2,967,84,2021-04-15 14:05:12,2021-04-15 16:01:46.762165
3900,3908,4,3908,25,967,25,8,0,8,Financial Pressure,2,967,84,2021-04-15 14:05:12,2021-04-15 16:01:46.762165
3901,3909,3,3909,28,967,28,9,1,9,Faculty & Staff Support,2,967,84,2021-04-15 14:05:12,2021-04-15 16:01:46.762165
3902,3910,5,3910,33,967,33,10,0,10,Friendships,2,967,84,2021-04-15 14:05:12,2021-04-15 16:01:46.762165
3903,3916,5,3916,16,969,16,6,1,6,Life - School Balance,2,969,86,2021-04-15 14:05:12,2021-04-15 14:12:01.679422
3904,3917,5,3917,20,969,20,7,1,7,Discrimination,2,969,86,2021-04-15 14:05:12,2021-04-15 14:12:01.679422
3905,3918,3,3918,22,969,22,8,1,8,Financial Pressure,2,969,86,2021-04-15 14:05:12,2021-04-15 14:12:01.679422
3906,3919,5,3919,26,969,26,9,1,9,Faculty & Staff Support,2,969,86,2021-04-15 14:05:12,2021-04-15 14:12:01.679422
3907,3920,5,3920,33,969,33,10,0,10,Friendships,2,969,86,2021-04-15 14:05:12,2021-04-15 14:12:01.679422
3908,3956,5,3956,16,977,16,6,1,6,Life - School Balance,2,977,95,2021-04-15 14:05:14,2021-04-15 14:07:22.665697
3909,3957,6,3957,19,977,19,7,0,7,Discrimination,2,977,95,2021-04-15 14:05:14,2021-04-15 14:07:22.665697
3910,3958,4,3958,22,977,22,8,1,8,Financial Pressure,2,977,95,2021-04-15 14:05:14,2021-04-15 14:07:22.665697
3911,3959,6,3959,26,977,26,9,1,9,Faculty & Staff Support,2,977,95,2021-04-15 14:05:14,2021-04-15 14:07:22.665697
3912,3960,6,3960,32,977,32,10,1,10,Friendships,2,977,95,2021-04-15 14:05:14,2021-04-15 14:07:22.665697
3913,3971,4,3971,16,980,16,6,1,6,Life - School Balance,2,980,99,2021-04-15 14:05:14,2021-04-15 14:13:52.867868
3914,3972,6,3972,19,980,19,7,0,7,Discrimination,2,980,99,2021-04-15 14:05:14,2021-04-15 14:13:52.867868
3915,3973,2,3973,24,980,24,8,1,8,Financial Pressure,2,980,99,2021-04-15 14:05:14,2021-04-15 14:13:52.867868
3916,3974,6,3974,27,980,27,9,1,9,Faculty & Staff Support,2,980,99,2021-04-15 14:05:14,2021-04-15 14:13:52.867868
3917,3975,6,3975,30,980,30,10,1,10,Friendships,2,980,99,2021-04-15 14:05:14,2021-04-15 14:13:52.867868
3918,3986,5,3986,16,983,16,6,1,6,Life - School Balance,2,983,103,2021-04-15 14:05:15,2021-04-15 14:06:42.950765
3919,3987,2,3987,20,983,20,7,1,7,Discrimination,2,983,103,2021-04-15 14:05:15,2021-04-15 14:06:42.950765
3920,3988,6,3988,24,983,24,8,1,8,Financial Pressure,2,983,103,2021-04-15 14:05:15,2021-04-15 14:06:42.950765
3921,3989,6,3989,27,983,27,9,1,9,Faculty & Staff Support,2,983,103,2021-04-15 14:05:15,2021-04-15 14:06:42.950765
3922,3990,1,3990,31,983,31,10,1,10,Friendships,2,983,103,2021-04-15 14:05:15,2021-04-15 14:06:42.950765
3923,4096,3,4096,16,1005,16,6,1,6,Life - School Balance,2,1005,5,2021-04-20 19:05:01,2021-04-21 15:24:31.705610
3924,4097,5,4097,20,1005,20,7,1,7,Discrimination,2,1005,5,2021-04-20 19:05:01,2021-04-21 15:24:31.705610
3925,4098,3,4098,23,1005,23,8,1,8,Financial Pressure,2,1005,5,2021-04-20 19:05:01,2021-04-21 15:24:31.705610
3926,4099,4,4099,26,1005,26,9,1,9,Faculty & Staff Support,2,1005,5,2021-04-20 19:05:01,2021-04-21 15:24:31.705610
3927,4100,4,4100,32,1005,32,10,1,10,Friendships,2,1005,5,2021-04-20 19:05:01,2021-04-21 15:24:31.705610
3928,4111,3,4111,16,1008,16,6,1,6,Life - School Balance,2,1008,10,2021-04-20 19:05:02,2021-04-20 19:43:51.965142
3929,4112,6,4112,21,1008,21,7,1,7,Discrimination,2,1008,10,2021-04-20 19:05:02,2021-04-20 19:43:51.965142
3930,4113,3,4113,22,1008,22,8,1,8,Financial Pressure,2,1008,10,2021-04-20 19:05:02,2021-04-20 19:43:51.965142
3931,4114,4,4114,27,1008,27,9,1,9,Faculty & Staff Support,2,1008,10,2021-04-20 19:05:02,2021-04-20 19:43:51.965142
3932,4115,4,4115,30,1008,30,10,1,10,Friendships,2,1008,10,2021-04-20 19:05:02,2021-04-20 19:43:51.965142
3933,4131,2,4131,16,1012,16,6,1,6,Life - School Balance,2,1012,17,2021-04-20 19:05:03,2021-04-20 20:17:07.792892
3934,4132,6,4132,19,1012,19,7,0,7,Discrimination,2,1012,17,2021-04-20 19:05:03,2021-04-20 20:17:07.792892
3935,4133,6,4133,24,1012,24,8,1,8,Financial Pressure,2,1012,17,2021-04-20 19:05:03,2021-04-20 20:17:07.792892
3936,4134,2,4134,28,1012,28,9,1,9,Faculty & Staff Support,2,1012,17,2021-04-20 19:05:03,2021-04-20 20:17:07.792892
3937,4135,4,4135,32,1012,32,10,1,10,Friendships,2,1012,17,2021-04-20 19:05:03,2021-04-20 20:17:07.792892
3938,4141,5,4141,16,1014,16,6,1,6,Life - School Balance,2,1014,19,2021-04-20 19:05:03,2021-04-20 21:09:14.055063
3939,4142,5,4142,20,1014,20,7,1,7,Discrimination,2,1014,19,2021-04-20 19:05:03,2021-04-20 21:09:14.055063
3940,4143,5,4143,22,1014,22,8,1,8,Financial Pressure,2,1014,19,2021-04-20 19:05:03,2021-04-20 21:09:14.055063
3941,4144,5,4144,28,1014,28,9,1,9,Faculty & Staff Support,2,1014,19,2021-04-20 19:05:03,2021-04-20 21:09:14.055063
3942,4145,5,4145,33,1014,33,10,0,10,Friendships,2,1014,19,2021-04-20 19:05:03,2021-04-20 21:09:14.055063
3943,4151,3,4151,16,1016,16,6,1,6,Life - School Balance,2,1016,22,2021-04-20 19:05:03,2021-04-20 19:08:13.752410
3944,4152,2,4152,21,1016,21,7,1,7,Discrimination,2,1016,22,2021-04-20 19:05:03,2021-04-20 19:08:13.752410
3945,4153,6,4153,25,1016,25,8,0,8,Financial Pressure,2,1016,22,2021-04-20 19:05:03,2021-04-20 19:08:13.752410
3946,4154,4,4154,28,1016,28,9,1,9,Faculty & Staff Support,2,1016,22,2021-04-20 19:05:03,2021-04-20 19:08:13.752410
3947,4155,4,4155,33,1016,33,10,0,10,Friendships,2,1016,22,2021-04-20 19:05:03,2021-04-20 19:08:13.752410
3948,4161,4,4161,16,1018,16,6,1,6,Life - School Balance,2,1018,26,2021-04-20 19:05:04,2021-04-20 19:51:31.478615
3949,4162,6,4162,20,1018,20,7,1,7,Discrimination,2,1018,26,2021-04-20 19:05:04,2021-04-20 19:51:31.478615
3950,4163,4,4163,23,1018,23,8,1,8,Financial Pressure,2,1018,26,2021-04-20 19:05:04,2021-04-20 19:51:31.478615
3951,4164,6,4164,28,1018,28,9,1,9,Faculty & Staff Support,2,1018,26,2021-04-20 19:05:04,2021-04-20 19:51:31.478615
3952,4165,3,4165,33,1018,33,10,0,10,Friendships,2,1018,26,2021-04-20 19:05:04,2021-04-20 19:51:31.478615
3953,4166,2,4166,16,1019,16,6,1,6,Life - School Balance,2,1019,27,2021-04-20 19:05:04,2021-04-20 19:34:35.693269
3954,4167,5,4167,20,1019,20,7,1,7,Discrimination,2,1019,27,2021-04-20 19:05:04,2021-04-20 19:34:35.693269
3955,4168,2,4168,23,1019,23,8,1,8,Financial Pressure,2,1019,27,2021-04-20 19:05:04,2021-04-20 19:34:35.693269
3956,4169,5,4169,29,1019,29,9,0,9,Faculty & Staff Support,2,1019,27,2021-04-20 19:05:04,2021-04-20 19:34:35.693269
3957,4170,5,4170,30,1019,30,10,1,10,Friendships,2,1019,27,2021-04-20 19:05:04,2021-04-20 19:34:35.693269
3958,4176,1,4176,16,1021,16,6,1,6,Life - School Balance,2,1021,30,2021-04-20 19:05:04,2021-04-20 19:09:36.557072
3959,4177,3,4177,21,1021,21,7,1,7,Discrimination,2,1021,30,2021-04-20 19:05:04,2021-04-20 19:09:36.557072
3960,4178,5,4178,23,1021,23,8,1,8,Financial Pressure,2,1021,30,2021-04-20 19:05:04,2021-04-20 19:09:36.557072
3961,4179,3,4179,26,1021,26,9,1,9,Faculty & Staff Support,2,1021,30,2021-04-20 19:05:04,2021-04-20 19:09:36.557072
3962,4180,6,4180,33,1021,33,10,0,10,Friendships,2,1021,30,2021-04-20 19:05:04,2021-04-20 19:09:36.557072
3963,4206,6,4206,16,1027,16,6,1,6,Life - School Balance,2,1027,40,2021-04-20 19:05:05,2021-04-20 19:06:13.268947
3964,4207,4,4207,19,1027,19,7,0,7,Discrimination,2,1027,40,2021-04-20 19:05:05,2021-04-20 19:06:13.268947
3965,4208,6,4208,23,1027,23,8,1,8,Financial Pressure,2,1027,40,2021-04-20 19:05:05,2021-04-20 19:06:13.268947
3966,4209,3,4209,28,1027,28,9,1,9,Faculty & Staff Support,2,1027,40,2021-04-20 19:05:05,2021-04-20 19:06:13.268947
3967,4210,3,4210,30,1027,30,10,1,10,Friendships,2,1027,40,2021-04-20 19:05:05,2021-04-20 19:06:13.268947
3968,4216,5,4216,16,1029,16,6,1,6,Life - School Balance,2,1029,42,2021-04-20 19:05:05,2021-04-21 14:54:29.488170
3969,4217,5,4217,21,1029,21,7,1,7,Discrimination,2,1029,42,2021-04-20 19:05:05,2021-04-21 14:54:29.488170
3970,4218,4,4218,23,1029,23,8,1,8,Financial Pressure,2,1029,42,2021-04-20 19:05:05,2021-04-21 14:54:29.488170
3971,4219,6,4219,26,1029,26,9,1,9,Faculty & Staff Support,2,1029,42,2021-04-20 19:05:05,2021-04-21 14:54:29.488170
3972,4220,4,4220,33,1029,33,10,0,10,Friendships,2,1029,42,2021-04-20 19:05:05,2021-04-21 14:54:29.488170
3973,4226,5,4226,16,1031,16,6,1,6,Life - School Balance,2,1031,45,2021-04-20 19:05:06,2021-04-20 19:32:44.070554
3974,4227,6,4227,20,1031,20,7,1,7,Discrimination,2,1031,45,2021-04-20 19:05:06,2021-04-20 19:32:44.070554
3975,4228,1,4228,25,1031,25,8,0,8,Financial Pressure,2,1031,45,2021-04-20 19:05:06,2021-04-20 19:32:44.070554
3976,4229,6,4229,29,1031,29,9,0,9,Faculty & Staff Support,2,1031,45,2021-04-20 19:05:06,2021-04-20 19:32:44.070554
3977,4230,4,4230,30,1031,30,10,1,10,Friendships,2,1031,45,2021-04-20 19:05:06,2021-04-20 19:32:44.070554
3978,4236,4,4236,16,1033,16,6,1,6,Life - School Balance,2,1033,47,2021-04-20 19:05:06,2021-04-20 19:09:17.499602
3979,4237,5,4237,21,1033,21,7,1,7,Discrimination,2,1033,47,2021-04-20 19:05:06,2021-04-20 19:09:17.499602
3980,4238,4,4238,23,1033,23,8,1,8,Financial Pressure,2,1033,47,2021-04-20 19:05:06,2021-04-20 19:09:17.499602
3981,4239,6,4239,26,1033,26,9,1,9,Faculty & Staff Support,2,1033,47,2021-04-20 19:05:06,2021-04-20 19:09:17.499602
3982,4240,5,4240,32,1033,32,10,1,10,Friendships,2,1033,47,2021-04-20 19:05:06,2021-04-20 19:09:17.499602
3983,4246,4,4246,16,1035,16,6,1,6,Life - School Balance,2,1035,49,2021-04-20 19:05:06,2021-04-20 23:28:24.068205
3984,4247,4,4247,20,1035,20,7,1,7,Discrimination,2,1035,49,2021-04-20 19:05:06,2021-04-20 23:28:24.068205
3985,4248,4,4248,25,1035,25,8,0,8,Financial Pressure,2,1035,49,2021-04-20 19:05:06,2021-04-20 23:28:24.068205
3986,4249,4,4249,27,1035,27,9,1,9,Faculty & Staff Support,2,1035,49,2021-04-20 19:05:06,2021-04-20 23:28:24.068205
3987,4250,4,4250,30,1035,30,10,1,10,Friendships,2,1035,49,2021-04-20 19:05:06,2021-04-20 23:28:24.068205
3988,4266,3,4266,16,1039,16,6,1,6,Life - School Balance,2,1039,55,2021-04-20 19:05:07,2021-04-20 19:08:09.145385
3989,4267,6,4267,19,1039,19,7,0,7,Discrimination,2,1039,55,2021-04-20 19:05:07,2021-04-20 19:08:09.145385
3990,4268,2,4268,23,1039,23,8,1,8,Financial Pressure,2,1039,55,2021-04-20 19:05:07,2021-04-20 19:08:09.145385
3991,4269,4,4269,26,1039,26,9,1,9,Faculty & Staff Support,2,1039,55,2021-04-20 19:05:07,2021-04-20 19:08:09.145385
3992,4270,4,4270,30,1039,30,10,1,10,Friendships,2,1039,55,2021-04-20 19:05:07,2021-04-20 19:08:09.145385
3993,4296,4,4296,16,1045,16,6,1,6,Life - School Balance,2,1045,64,2021-04-20 19:05:08,2021-04-21 03:01:45.346000
3994,4297,4,4297,20,1045,20,7,1,7,Discrimination,2,1045,64,2021-04-20 19:05:08,2021-04-21 03:01:45.346000
3995,4298,3,4298,25,1045,25,8,0,8,Financial Pressure,2,1045,64,2021-04-20 19:05:08,2021-04-21 03:01:45.346000
3996,4299,3,4299,29,1045,29,9,0,9,Faculty & Staff Support,2,1045,64,2021-04-20 19:05:08,2021-04-21 03:01:45.346000
3997,4300,4,4300,31,1045,31,10,1,10,Friendships,2,1045,64,2021-04-20 19:05:08,2021-04-21 03:01:45.346000
3998,4306,5,4306,16,1047,16,6,1,6,Life - School Balance,2,1047,66,2021-04-20 19:05:08,2021-04-20 19:06:58.958262
3999,4307,5,4307,21,1047,21,7,1,7,Discrimination,2,1047,66,2021-04-20 19:05:08,2021-04-20 19:06:58.958262
4000,4308,3,4308,22,1047,22,8,1,8,Financial Pressure,2,1047,66,2021-04-20 19:05:08,2021-04-20 19:06:58.958262
4001,4309,5,4309,29,1047,29,9,0,9,Faculty & Staff Support,2,1047,66,2021-04-20 19:05:08,2021-04-20 19:06:58.958262
4002,4310,5,4310,30,1047,30,10,1,10,Friendships,2,1047,66,2021-04-20 19:05:08,2021-04-20 19:06:58.958262
4003,4311,4,4311,16,1048,16,6,1,6,Life - School Balance,2,1048,67,2021-04-20 19:05:09,2021-04-20 20:39:07.115652
4004,4312,3,4312,20,1048,20,7,1,7,Discrimination,2,1048,67,2021-04-20 19:05:09,2021-04-20 20:39:07.115652
4005,4313,5,4313,24,1048,24,8,1,8,Financial Pressure,2,1048,67,2021-04-20 19:05:09,2021-04-20 20:39:07.115652
4006,4314,4,4314,29,1048,29,9,0,9,Faculty & Staff Support,2,1048,67,2021-04-20 19:05:09,2021-04-20 20:39:07.115652
4007,4315,3,4315,31,1048,31,10,1,10,Friendships,2,1048,67,2021-04-20 19:05:09,2021-04-20 20:39:07.115652
4008,4316,2,4316,16,1049,16,6,1,6,Life - School Balance,2,1049,68,2021-04-20 19:05:09,2021-04-20 19:22:05.907384
4009,4317,4,4317,20,1049,20,7,1,7,Discrimination,2,1049,68,2021-04-20 19:05:09,2021-04-20 19:22:05.907384
4010,4318,3,4318,22,1049,22,8,1,8,Financial Pressure,2,1049,68,2021-04-20 19:05:09,2021-04-20 19:22:05.907384
4011,4319,5,4319,29,1049,29,9,0,9,Faculty & Staff Support,2,1049,68,2021-04-20 19:05:09,2021-04-20 19:22:05.907384
4012,4320,3,4320,30,1049,30,10,1,10,Friendships,2,1049,68,2021-04-20 19:05:09,2021-04-20 19:22:05.907384
4013,4326,3,4326,16,1051,16,6,1,6,Life - School Balance,2,1051,70,2021-04-20 19:05:09,2021-04-20 19:07:09.953517
4014,4327,5,4327,20,1051,20,7,1,7,Discrimination,2,1051,70,2021-04-20 19:05:09,2021-04-20 19:07:09.953517
4015,4328,3,4328,24,1051,24,8,1,8,Financial Pressure,2,1051,70,2021-04-20 19:05:09,2021-04-20 19:07:09.953517
4016,4329,5,4329,29,1051,29,9,0,9,Faculty & Staff Support,2,1051,70,2021-04-20 19:05:09,2021-04-20 19:07:09.953517
4017,4330,4,4330,30,1051,30,10,1,10,Friendships,2,1051,70,2021-04-20 19:05:09,2021-04-20 19:07:09.953517
4018,4346,4,4346,16,1055,16,6,1,6,Life - School Balance,2,1055,74,2021-04-20 19:05:10,2021-04-20 19:20:53.344352
4019,4347,6,4347,20,1055,20,7,1,7,Discrimination,2,1055,74,2021-04-20 19:05:10,2021-04-20 19:20:53.344352
4020,4348,4,4348,23,1055,23,8,1,8,Financial Pressure,2,1055,74,2021-04-20 19:05:10,2021-04-20 19:20:53.344352
4021,4349,6,4349,29,1055,29,9,0,9,Faculty & Staff Support,2,1055,74,2021-04-20 19:05:10,2021-04-20 19:20:53.344352
4022,4350,6,4350,32,1055,32,10,1,10,Friendships,2,1055,74,2021-04-20 19:05:10,2021-04-20 19:20:53.344352
4023,4351,3,4351,16,1056,16,6,1,6,Life - School Balance,2,1056,75,2021-04-20 19:05:10,2021-04-20 19:14:48.946139
4024,4352,6,4352,20,1056,20,7,1,7,Discrimination,2,1056,75,2021-04-20 19:05:10,2021-04-20 19:14:48.946139
4025,4353,3,4353,24,1056,24,8,1,8,Financial Pressure,2,1056,75,2021-04-20 19:05:10,2021-04-20 19:14:48.946139
4026,4354,6,4354,27,1056,27,9,1,9,Faculty & Staff Support,2,1056,75,2021-04-20 19:05:10,2021-04-20 19:14:48.946139
4027,4355,6,4355,32,1056,32,10,1,10,Friendships,2,1056,75,2021-04-20 19:05:10,2021-04-20 19:14:48.946139
4028,4366,2,4366,16,1059,16,6,1,6,Life - School Balance,2,1059,78,2021-04-20 19:05:10,2021-04-20 19:13:04.966717
4029,4367,5,4367,19,1059,19,7,0,7,Discrimination,2,1059,78,2021-04-20 19:05:10,2021-04-20 19:13:04.966717
4030,4368,3,4368,22,1059,22,8,1,8,Financial Pressure,2,1059,78,2021-04-20 19:05:10,2021-04-20 19:13:04.966717
4031,4369,4,4369,28,1059,28,9,1,9,Faculty & Staff Support,2,1059,78,2021-04-20 19:05:10,2021-04-20 19:13:04.966717
4032,4370,6,4370,32,1059,32,10,1,10,Friendships,2,1059,78,2021-04-20 19:05:10,2021-04-20 19:13:04.966717
4033,4371,3,4371,16,1060,16,6,1,6,Life - School Balance,2,1060,79,2021-04-20 19:05:10,2021-04-20 19:08:36.631168
4034,4372,5,4372,20,1060,20,7,1,7,Discrimination,2,1060,79,2021-04-20 19:05:10,2021-04-20 19:08:36.631168
4035,4373,4,4373,23,1060,23,8,1,8,Financial Pressure,2,1060,79,2021-04-20 19:05:10,2021-04-20 19:08:36.631168
4036,4374,1,4374,29,1060,29,9,0,9,Faculty & Staff Support,2,1060,79,2021-04-20 19:05:10,2021-04-20 19:08:36.631168
4037,4375,5,4375,30,1060,30,10,1,10,Friendships,2,1060,79,2021-04-20 19:05:10,2021-04-20 19:08:36.631168
4038,4381,5,4381,16,1062,16,6,1,6,Life - School Balance,2,1062,85,2021-04-20 19:05:11,2021-04-20 19:30:07.419200
4039,4382,6,4382,21,1062,21,7,1,7,Discrimination,2,1062,85,2021-04-20 19:05:11,2021-04-20 19:30:07.419200
4040,4383,2,4383,23,1062,23,8,1,8,Financial Pressure,2,1062,85,2021-04-20 19:05:11,2021-04-20 19:30:07.419200
4041,4384,5,4384,28,1062,28,9,1,9,Faculty & Staff Support,2,1062,85,2021-04-20 19:05:11,2021-04-20 19:30:07.419200
4042,4385,3,4385,32,1062,32,10,1,10,Friendships,2,1062,85,2021-04-20 19:05:11,2021-04-20 19:30:07.419200
4043,4386,5,4386,16,1063,16,6,1,6,Life - School Balance,2,1063,86,2021-04-20 19:05:11,2021-04-20 23:30:33.007431
4044,4387,5,4387,20,1063,20,7,1,7,Discrimination,2,1063,86,2021-04-20 19:05:11,2021-04-20 23:30:33.007431
4045,4388,3,4388,23,1063,23,8,1,8,Financial Pressure,2,1063,86,2021-04-20 19:05:11,2021-04-20 23:30:33.007431
4046,4389,5,4389,29,1063,29,9,0,9,Faculty & Staff Support,2,1063,86,2021-04-20 19:05:11,2021-04-20 23:30:33.007431
4047,4390,5,4390,30,1063,30,10,1,10,Friendships,2,1063,86,2021-04-20 19:05:11,2021-04-20 23:30:33.007431
4048,4406,3,4406,16,1067,16,6,1,6,Life - School Balance,2,1067,90,2021-04-20 19:05:11,2021-04-20 19:11:16.857017
4049,4407,5,4407,21,1067,21,7,1,7,Discrimination,2,1067,90,2021-04-20 19:05:11,2021-04-20 19:11:16.857017
4050,4408,4,4408,25,1067,25,8,0,8,Financial Pressure,2,1067,90,2021-04-20 19:05:11,2021-04-20 19:11:16.857017
4051,4409,5,4409,27,1067,27,9,1,9,Faculty & Staff Support,2,1067,90,2021-04-20 19:05:11,2021-04-20 19:11:16.857017
4052,4410,6,4410,30,1067,30,10,1,10,Friendships,2,1067,90,2021-04-20 19:05:11,2021-04-20 19:11:16.857017
4053,4426,5,4426,16,1071,16,6,1,6,Life - School Balance,2,1071,95,2021-04-20 19:05:12,2021-04-20 19:06:48.219691
4054,4427,6,4427,20,1071,20,7,1,7,Discrimination,2,1071,95,2021-04-20 19:05:12,2021-04-20 19:06:48.219691
4055,4428,5,4428,24,1071,24,8,1,8,Financial Pressure,2,1071,95,2021-04-20 19:05:12,2021-04-20 19:06:48.219691
4056,4429,6,4429,28,1071,28,9,1,9,Faculty & Staff Support,2,1071,95,2021-04-20 19:05:12,2021-04-20 19:06:48.219691
4057,4430,6,4430,30,1071,30,10,1,10,Friendships,2,1071,95,2021-04-20 19:05:12,2021-04-20 19:06:48.219691
4058,4441,6,4441,16,1074,16,6,1,6,Life - School Balance,2,1074,99,2021-04-20 19:05:12,2021-04-20 20:49:38.901103
4059,4442,5,4442,21,1074,21,7,1,7,Discrimination,2,1074,99,2021-04-20 19:05:12,2021-04-20 20:49:38.901103
4060,4443,1,4443,22,1074,22,8,1,8,Financial Pressure,2,1074,99,2021-04-20 19:05:12,2021-04-20 20:49:38.901103
4061,4444,5,4444,26,1074,26,9,1,9,Faculty & Staff Support,2,1074,99,2021-04-20 19:05:12,2021-04-20 20:49:38.901103
4062,4445,5,4445,32,1074,32,10,1,10,Friendships,2,1074,99,2021-04-20 19:05:12,2021-04-20 20:49:38.901103
4063,4446,1,4446,16,1075,16,6,1,6,Life - School Balance,2,1075,100,2021-04-20 19:05:13,2021-04-20 19:49:23.730749
4064,4447,6,4447,19,1075,19,7,0,7,Discrimination,2,1075,100,2021-04-20 19:05:13,2021-04-20 19:49:23.730749
4065,4448,5,4448,22,1075,22,8,1,8,Financial Pressure,2,1075,100,2021-04-20 19:05:13,2021-04-20 19:49:23.730749
4066,4449,5,4449,29,1075,29,9,0,9,Faculty & Staff Support,2,1075,100,2021-04-20 19:05:13,2021-04-20 19:49:23.730749
4067,4450,4,4450,30,1075,30,10,1,10,Friendships,2,1075,100,2021-04-20 19:05:13,2021-04-20 19:49:23.730749
4068,4506,3,4506,16,1087,16,6,1,6,Life - School Balance,2,1087,10,2021-04-22 14:05:02,2021-04-22 14:07:22.747213
4069,4507,6,4507,21,1087,21,7,1,7,Discrimination,2,1087,10,2021-04-22 14:05:02,2021-04-22 14:07:22.747213
4070,4508,3,4508,25,1087,25,8,0,8,Financial Pressure,2,1087,10,2021-04-22 14:05:02,2021-04-22 14:07:22.747213
4071,4509,4,4509,27,1087,27,9,1,9,Faculty & Staff Support,2,1087,10,2021-04-22 14:05:02,2021-04-22 14:07:22.747213
4072,4510,4,4510,30,1087,30,10,1,10,Friendships,2,1087,10,2021-04-22 14:05:02,2021-04-22 14:07:22.747213
4073,4511,4,4511,16,1088,16,6,1,6,Life - School Balance,2,1088,13,2021-04-22 14:05:02,2021-04-22 14:30:51.608455
4074,4512,5,4512,21,1088,21,7,1,7,Discrimination,2,1088,13,2021-04-22 14:05:02,2021-04-22 14:30:51.608455
4075,4513,4,4513,22,1088,22,8,1,8,Financial Pressure,2,1088,13,2021-04-22 14:05:02,2021-04-22 14:30:51.608455
4076,4514,5,4514,27,1088,27,9,1,9,Faculty & Staff Support,2,1088,13,2021-04-22 14:05:02,2021-04-22 14:30:51.608455
4077,4515,5,4515,33,1088,33,10,0,10,Friendships,2,1088,13,2021-04-22 14:05:02,2021-04-22 14:30:51.608455
4078,4531,4,4531,16,1092,16,6,1,6,Life - School Balance,2,1092,18,2021-04-22 14:05:03,2021-04-22 14:32:28.787665
4079,4532,4,4532,20,1092,20,7,1,7,Discrimination,2,1092,18,2021-04-22 14:05:03,2021-04-22 14:32:28.787665
4080,4533,6,4533,23,1092,23,8,1,8,Financial Pressure,2,1092,18,2021-04-22 14:05:03,2021-04-22 14:32:28.787665
4081,4534,4,4534,28,1092,28,9,1,9,Faculty & Staff Support,2,1092,18,2021-04-22 14:05:03,2021-04-22 14:32:28.787665
4082,4535,4,4535,33,1092,33,10,0,10,Friendships,2,1092,18,2021-04-22 14:05:03,2021-04-22 14:32:28.787665
4083,4541,4,4541,16,1094,16,6,1,6,Life - School Balance,2,1094,20,2021-04-22 14:05:03,2021-04-22 14:56:06.449523
4084,4542,3,4542,19,1094,19,7,0,7,Discrimination,2,1094,20,2021-04-22 14:05:03,2021-04-22 14:56:06.449523
4085,4543,5,4543,24,1094,24,8,1,8,Financial Pressure,2,1094,20,2021-04-22 14:05:03,2021-04-22 14:56:06.449523
4086,4544,4,4544,26,1094,26,9,1,9,Faculty & Staff Support,2,1094,20,2021-04-22 14:05:03,2021-04-22 14:56:06.449523
4087,4545,4,4545,32,1094,32,10,1,10,Friendships,2,1094,20,2021-04-22 14:05:03,2021-04-22 14:56:06.449523
4088,4546,3,4546,16,1095,16,6,1,6,Life - School Balance,2,1095,22,2021-04-22 14:05:03,2021-04-22 14:27:28.101528
4089,4547,3,4547,21,1095,21,7,1,7,Discrimination,2,1095,22,2021-04-22 14:05:03,2021-04-22 14:27:28.101528
4090,4548,5,4548,24,1095,24,8,1,8,Financial Pressure,2,1095,22,2021-04-22 14:05:03,2021-04-22 14:27:28.101528
4091,4549,5,4549,29,1095,29,9,0,9,Faculty & Staff Support,2,1095,22,2021-04-22 14:05:03,2021-04-22 14:27:28.101528
4092,4550,6,4550,31,1095,31,10,1,10,Friendships,2,1095,22,2021-04-22 14:05:03,2021-04-22 14:27:28.101528
4093,4551,3,4551,16,1096,16,6,1,6,Life - School Balance,2,1096,23,2021-04-22 14:05:03,2021-04-22 14:13:25.309186
4094,4552,4,4552,20,1096,20,7,1,7,Discrimination,2,1096,23,2021-04-22 14:05:03,2021-04-22 14:13:25.309186
4095,4553,6,4553,23,1096,23,8,1,8,Financial Pressure,2,1096,23,2021-04-22 14:05:03,2021-04-22 14:13:25.309186
4096,4554,6,4554,29,1096,29,9,0,9,Faculty & Staff Support,2,1096,23,2021-04-22 14:05:03,2021-04-22 14:13:25.309186
4097,4555,3,4555,33,1096,33,10,0,10,Friendships,2,1096,23,2021-04-22 14:05:03,2021-04-22 14:13:25.309186
4098,4561,3,4561,16,1098,16,6,1,6,Life - School Balance,2,1098,27,2021-04-22 14:05:04,2021-04-22 14:35:17.244108
4099,4562,5,4562,19,1098,19,7,0,7,Discrimination,2,1098,27,2021-04-22 14:05:04,2021-04-22 14:35:17.244108
4100,4563,2,4563,24,1098,24,8,1,8,Financial Pressure,2,1098,27,2021-04-22 14:05:04,2021-04-22 14:35:17.244108
4101,4564,5,4564,29,1098,29,9,0,9,Faculty & Staff Support,2,1098,27,2021-04-22 14:05:04,2021-04-22 14:35:17.244108
4102,4565,5,4565,32,1098,32,10,1,10,Friendships,2,1098,27,2021-04-22 14:05:04,2021-04-22 14:35:17.244108
4103,4571,1,4571,16,1100,16,6,1,6,Life - School Balance,2,1100,30,2021-04-22 14:05:04,2021-04-22 14:12:02.167023
4104,4572,4,4572,21,1100,21,7,1,7,Discrimination,2,1100,30,2021-04-22 14:05:04,2021-04-22 14:12:02.167023
4105,4573,4,4573,22,1100,22,8,1,8,Financial Pressure,2,1100,30,2021-04-22 14:05:04,2021-04-22 14:12:02.167023
4106,4574,4,4574,28,1100,28,9,1,9,Faculty & Staff Support,2,1100,30,2021-04-22 14:05:04,2021-04-22 14:12:02.167023
4107,4575,3,4575,30,1100,30,10,1,10,Friendships,2,1100,30,2021-04-22 14:05:04,2021-04-22 14:12:02.167023
4108,4646,4,4646,16,1115,16,6,1,6,Life - School Balance,2,1115,50,2021-04-22 14:05:07,2021-04-22 14:05:52.028653
4109,4647,3,4647,19,1115,19,7,0,7,Discrimination,2,1115,50,2021-04-22 14:05:07,2021-04-22 14:05:52.028653
4110,4648,6,4648,22,1115,22,8,1,8,Financial Pressure,2,1115,50,2021-04-22 14:05:07,2021-04-22 14:05:52.028653
4111,4649,4,4649,28,1115,28,9,1,9,Faculty & Staff Support,2,1115,50,2021-04-22 14:05:07,2021-04-22 14:05:52.028653
4112,4650,3,4650,33,1115,33,10,0,10,Friendships,2,1115,50,2021-04-22 14:05:07,2021-04-22 14:05:52.028653
4113,4656,3,4656,16,1117,16,6,1,6,Life - School Balance,2,1117,54,2021-04-22 14:05:07,2021-04-22 14:14:40.072681
4114,4657,4,4657,21,1117,21,7,1,7,Discrimination,2,1117,54,2021-04-22 14:05:07,2021-04-22 14:14:40.072681
4115,4658,3,4658,23,1117,23,8,1,8,Financial Pressure,2,1117,54,2021-04-22 14:05:07,2021-04-22 14:14:40.072681
4116,4659,6,4659,29,1117,29,9,0,9,Faculty & Staff Support,2,1117,54,2021-04-22 14:05:07,2021-04-22 14:14:40.072681
4117,4660,5,4660,31,1117,31,10,1,10,Friendships,2,1117,54,2021-04-22 14:05:07,2021-04-22 14:14:40.072681
4118,4661,3,4661,16,1118,16,6,1,6,Life - School Balance,2,1118,55,2021-04-22 14:05:07,2021-04-22 14:06:06.894456
4119,4662,6,4662,19,1118,19,7,0,7,Discrimination,2,1118,55,2021-04-22 14:05:07,2021-04-22 14:06:06.894456
4120,4663,3,4663,22,1118,22,8,1,8,Financial Pressure,2,1118,55,2021-04-22 14:05:07,2021-04-22 14:06:06.894456
4121,4664,4,4664,28,1118,28,9,1,9,Faculty & Staff Support,2,1118,55,2021-04-22 14:05:07,2021-04-22 14:06:06.894456
4122,4665,4,4665,32,1118,32,10,1,10,Friendships,2,1118,55,2021-04-22 14:05:07,2021-04-22 14:06:06.894456
4123,4701,5,4701,16,1126,16,6,1,6,Life - School Balance,2,1126,66,2021-04-22 14:05:08,2021-04-22 14:06:58.941948
4124,4702,5,4702,19,1126,19,7,0,7,Discrimination,2,1126,66,2021-04-22 14:05:08,2021-04-22 14:06:58.941948
4125,4703,3,4703,22,1126,22,8,1,8,Financial Pressure,2,1126,66,2021-04-22 14:05:08,2021-04-22 14:06:58.941948
4126,4704,5,4704,28,1126,28,9,1,9,Faculty & Staff Support,2,1126,66,2021-04-22 14:05:08,2021-04-22 14:06:58.941948
4127,4705,5,4705,30,1126,30,10,1,10,Friendships,2,1126,66,2021-04-22 14:05:08,2021-04-22 14:06:58.941948
4128,4716,4,4716,16,1129,16,6,1,6,Life - School Balance,2,1129,69,2021-04-22 14:05:09,2021-04-22 15:21:36.092949
4129,4717,5,4717,21,1129,21,7,1,7,Discrimination,2,1129,69,2021-04-22 14:05:09,2021-04-22 15:21:36.092949
4130,4718,4,4718,24,1129,24,8,1,8,Financial Pressure,2,1129,69,2021-04-22 14:05:09,2021-04-22 15:21:36.092949
4131,4719,4,4719,29,1129,29,9,0,9,Faculty & Staff Support,2,1129,69,2021-04-22 14:05:09,2021-04-22 15:21:36.092949
4132,4720,4,4720,32,1129,32,10,1,10,Friendships,2,1129,69,2021-04-22 14:05:09,2021-04-22 15:21:36.092949
4133,4726,4,4726,16,1131,16,6,1,6,Life - School Balance,2,1131,71,2021-04-22 14:05:09,2021-04-22 14:25:21.549859
4134,4727,5,4727,19,1131,19,7,0,7,Discrimination,2,1131,71,2021-04-22 14:05:09,2021-04-22 14:25:21.549859
4135,4728,4,4728,24,1131,24,8,1,8,Financial Pressure,2,1131,71,2021-04-22 14:05:09,2021-04-22 14:25:21.549859
4136,4729,5,4729,27,1131,27,9,1,9,Faculty & Staff Support,2,1131,71,2021-04-22 14:05:09,2021-04-22 14:25:21.549859
4137,4730,5,4730,30,1131,30,10,1,10,Friendships,2,1131,71,2021-04-22 14:05:09,2021-04-22 14:25:21.549859
4138,4736,6,4736,16,1133,16,6,1,6,Life - School Balance,2,1133,73,2021-04-22 14:05:09,2021-04-22 18:32:06.269809
4139,4737,6,4737,20,1133,20,7,1,7,Discrimination,2,1133,73,2021-04-22 14:05:09,2021-04-22 18:32:06.269809
4140,4738,1,4738,23,1133,23,8,1,8,Financial Pressure,2,1133,73,2021-04-22 14:05:09,2021-04-22 18:32:06.269809
4141,4739,6,4739,26,1133,26,9,1,9,Faculty & Staff Support,2,1133,73,2021-04-22 14:05:09,2021-04-22 18:32:06.269809
4142,4740,6,4740,30,1133,30,10,1,10,Friendships,2,1133,73,2021-04-22 14:05:09,2021-04-22 18:32:06.269809
4143,4751,4,4751,16,1136,16,6,1,6,Life - School Balance,2,1136,76,2021-04-22 14:05:10,2021-04-22 16:47:58.935447
4144,4752,5,4752,19,1136,19,7,0,7,Discrimination,2,1136,76,2021-04-22 14:05:10,2021-04-22 16:47:58.935447
4145,4753,2,4753,23,1136,23,8,1,8,Financial Pressure,2,1136,76,2021-04-22 14:05:10,2021-04-22 16:47:58.935447
4146,4754,4,4754,27,1136,27,9,1,9,Faculty & Staff Support,2,1136,76,2021-04-22 14:05:10,2021-04-22 16:47:58.935447
4147,4755,5,4755,33,1136,33,10,0,10,Friendships,2,1136,76,2021-04-22 14:05:10,2021-04-22 16:47:58.935447
4148,4781,5,4781,16,1142,16,6,1,6,Life - School Balance,2,1142,86,2021-04-22 14:05:11,2021-04-22 16:55:59.659433
4149,4782,5,4782,20,1142,20,7,1,7,Discrimination,2,1142,86,2021-04-22 14:05:11,2021-04-22 16:55:59.659433
4150,4783,3,4783,23,1142,23,8,1,8,Financial Pressure,2,1142,86,2021-04-22 14:05:11,2021-04-22 16:55:59.659433
4151,4784,5,4784,28,1142,28,9,1,9,Faculty & Staff Support,2,1142,86,2021-04-22 14:05:11,2021-04-22 16:55:59.659433
4152,4785,5,4785,32,1142,32,10,1,10,Friendships,2,1142,86,2021-04-22 14:05:11,2021-04-22 16:55:59.659433
4153,4791,2,4791,16,1144,16,6,1,6,Life - School Balance,2,1144,88,2021-04-22 14:05:11,2021-04-22 17:13:21.769973
4154,4792,5,4792,20,1144,20,7,1,7,Discrimination,2,1144,88,2021-04-22 14:05:11,2021-04-22 17:13:21.769973
4155,4793,3,4793,25,1144,25,8,0,8,Financial Pressure,2,1144,88,2021-04-22 14:05:11,2021-04-22 17:13:21.769973
4156,4794,5,4794,26,1144,26,9,1,9,Faculty & Staff Support,2,1144,88,2021-04-22 14:05:11,2021-04-22 17:13:21.769973
4157,4795,6,4795,31,1144,31,10,1,10,Friendships,2,1144,88,2021-04-22 14:05:11,2021-04-22 17:13:21.769973
4158,4806,5,4806,16,1147,16,6,1,6,Life - School Balance,2,1147,91,2021-04-22 14:05:12,2021-04-22 14:07:48.616743
4159,4807,6,4807,21,1147,21,7,1,7,Discrimination,2,1147,91,2021-04-22 14:05:12,2021-04-22 14:07:48.616743
4160,4808,2,4808,22,1147,22,8,1,8,Financial Pressure,2,1147,91,2021-04-22 14:05:12,2021-04-22 14:07:48.616743
4161,4809,6,4809,29,1147,29,9,0,9,Faculty & Staff Support,2,1147,91,2021-04-22 14:05:12,2021-04-22 14:07:48.616743
4162,4810,6,4810,31,1147,31,10,1,10,Friendships,2,1147,91,2021-04-22 14:05:12,2021-04-22 14:07:48.616743
4163,4821,4,4821,16,1150,16,6,1,6,Life - School Balance,2,1150,95,2021-04-22 14:05:12,2021-04-22 14:37:11.477931
4164,4822,6,4822,21,1150,21,7,1,7,Discrimination,2,1150,95,2021-04-22 14:05:12,2021-04-22 14:37:11.477931
4165,4823,1,4823,25,1150,25,8,0,8,Financial Pressure,2,1150,95,2021-04-22 14:05:12,2021-04-22 14:37:11.477931
4166,4824,6,4824,28,1150,28,9,1,9,Faculty & Staff Support,2,1150,95,2021-04-22 14:05:12,2021-04-22 14:37:11.477931
4167,4825,6,4825,30,1150,30,10,1,10,Friendships,2,1150,95,2021-04-22 14:05:12,2021-04-22 14:37:11.477931
4168,20116,2,20116,16,2023,16,6,1,6,Life - School Balance,2,2023,17,2021-04-27 19:05:03,2021-04-27 19:50:41.253258
4169,20117,6,20117,21,2023,21,7,1,7,Discrimination,2,2023,17,2021-04-27 19:05:03,2021-04-27 19:50:41.253258
4170,20118,6,20118,23,2023,23,8,1,8,Financial Pressure,2,2023,17,2021-04-27 19:05:03,2021-04-27 19:50:41.253258
4171,20119,3,20119,26,2023,26,9,1,9,Faculty & Staff Support,2,2023,17,2021-04-27 19:05:03,2021-04-27 19:50:41.253258
4172,20120,5,20120,33,2023,33,10,0,10,Friendships,2,2023,17,2021-04-27 19:05:03,2021-04-27 19:50:41.253258
4173,20136,2,20136,16,2027,16,6,1,6,Life - School Balance,2,2027,22,2021-04-27 19:05:04,2021-04-27 21:59:45.370099
4174,20137,4,20137,20,2027,20,7,1,7,Discrimination,2,2027,22,2021-04-27 19:05:04,2021-04-27 21:59:45.370099
4175,20138,6,20138,25,2027,25,8,0,8,Financial Pressure,2,2027,22,2021-04-27 19:05:04,2021-04-27 21:59:45.370099
4176,20139,5,20139,28,2027,28,9,1,9,Faculty & Staff Support,2,2027,22,2021-04-27 19:05:04,2021-04-27 21:59:45.370099
4177,20140,4,20140,32,2027,32,10,1,10,Friendships,2,2027,22,2021-04-27 19:05:04,2021-04-27 21:59:45.370099
4178,20151,2,20151,16,2030,16,6,1,6,Life - School Balance,2,2030,27,2021-04-27 19:05:04,2021-04-27 20:29:24.173922
4179,20152,5,20152,21,2030,21,7,1,7,Discrimination,2,2030,27,2021-04-27 19:05:04,2021-04-27 20:29:24.173922
4180,20153,4,20153,25,2030,25,8,0,8,Financial Pressure,2,2030,27,2021-04-27 19:05:04,2021-04-27 20:29:24.173922
4181,20154,5,20154,28,2030,28,9,1,9,Faculty & Staff Support,2,2030,27,2021-04-27 19:05:04,2021-04-27 20:29:24.173922
4182,20155,5,20155,30,2030,30,10,1,10,Friendships,2,2030,27,2021-04-27 19:05:04,2021-04-27 20:29:24.173922
4183,20161,1,20161,16,2032,16,6,1,6,Life - School Balance,2,2032,30,2021-04-27 19:05:05,2021-04-27 19:13:36.382559
4184,20162,6,20162,19,2032,19,7,0,7,Discrimination,2,2032,30,2021-04-27 19:05:05,2021-04-27 19:13:36.382559
4185,20163,3,20163,22,2032,22,8,1,8,Financial Pressure,2,2032,30,2021-04-27 19:05:05,2021-04-27 19:13:36.382559
4186,20164,6,20164,29,2032,29,9,0,9,Faculty & Staff Support,2,2032,30,2021-04-27 19:05:05,2021-04-27 19:13:36.382559
4187,20165,6,20165,33,2032,33,10,0,10,Friendships,2,2032,30,2021-04-27 19:05:05,2021-04-27 19:13:36.382559
4188,20166,3,20166,16,2033,16,6,1,6,Life - School Balance,2,2033,31,2021-04-27 19:05:05,2021-04-27 19:13:58.516237
4189,20167,6,20167,19,2033,19,7,0,7,Discrimination,2,2033,31,2021-04-27 19:05:05,2021-04-27 19:13:58.516237
4190,20168,6,20168,23,2033,23,8,1,8,Financial Pressure,2,2033,31,2021-04-27 19:05:05,2021-04-27 19:13:58.516237
4191,20169,3,20169,29,2033,29,9,0,9,Faculty & Staff Support,2,2033,31,2021-04-27 19:05:05,2021-04-27 19:13:58.516237
4192,20170,3,20170,30,2033,30,10,1,10,Friendships,2,2033,31,2021-04-27 19:05:05,2021-04-27 19:13:58.516237
4193,20186,3,20186,16,2037,16,6,1,6,Life - School Balance,2,2037,36,2021-04-27 19:05:06,2021-04-27 19:13:23.476251
4194,20187,4,20187,20,2037,20,7,1,7,Discrimination,2,2037,36,2021-04-27 19:05:06,2021-04-27 19:13:23.476251
4195,20188,6,20188,24,2037,24,8,1,8,Financial Pressure,2,2037,36,2021-04-27 19:05:06,2021-04-27 19:13:23.476251
4196,20189,4,20189,26,2037,26,9,1,9,Faculty & Staff Support,2,2037,36,2021-04-27 19:05:06,2021-04-27 19:13:23.476251
4197,20190,5,20190,31,2037,31,10,1,10,Friendships,2,2037,36,2021-04-27 19:05:06,2021-04-27 19:13:23.476251
4198,20206,4,20206,16,2041,16,6,1,6,Life - School Balance,2,2041,44,2021-04-27 19:05:06,2021-04-27 20:09:49.330159
4199,20207,4,20207,20,2041,20,7,1,7,Discrimination,2,2041,44,2021-04-27 19:05:06,2021-04-27 20:09:49.330159
4200,20208,4,20208,24,2041,24,8,1,8,Financial Pressure,2,2041,44,2021-04-27 19:05:06,2021-04-27 20:09:49.330159
4201,20209,2,20209,27,2041,27,9,1,9,Faculty & Staff Support,2,2041,44,2021-04-27 19:05:06,2021-04-27 20:09:49.330159
4202,20210,4,20210,30,2041,30,10,1,10,Friendships,2,2041,44,2021-04-27 19:05:06,2021-04-27 20:09:49.330159
4203,20236,4,20236,16,2047,16,6,1,6,Life - School Balance,2,2047,50,2021-04-27 19:05:07,2021-04-27 19:06:06.870921
4204,20237,3,20237,19,2047,19,7,0,7,Discrimination,2,2047,50,2021-04-27 19:05:07,2021-04-27 19:06:06.870921
4205,20238,6,20238,22,2047,22,8,1,8,Financial Pressure,2,2047,50,2021-04-27 19:05:07,2021-04-27 19:06:06.870921
4206,20239,4,20239,28,2047,28,9,1,9,Faculty & Staff Support,2,2047,50,2021-04-27 19:05:07,2021-04-27 19:06:06.870921
4207,20240,1,20240,31,2047,31,10,1,10,Friendships,2,2047,50,2021-04-27 19:05:07,2021-04-27 19:06:06.870921
4208,20246,4,20246,16,2049,16,6,1,6,Life - School Balance,2,2049,54,2021-04-27 19:05:08,2021-04-27 19:43:39.513985
4209,20247,5,20247,19,2049,19,7,0,7,Discrimination,2,2049,54,2021-04-27 19:05:08,2021-04-27 19:43:39.513985
4210,20248,4,20248,24,2049,24,8,1,8,Financial Pressure,2,2049,54,2021-04-27 19:05:08,2021-04-27 19:43:39.513985
4211,20249,6,20249,26,2049,26,9,1,9,Faculty & Staff Support,2,2049,54,2021-04-27 19:05:08,2021-04-27 19:43:39.513985
4212,20250,4,20250,32,2049,32,10,1,10,Friendships,2,2049,54,2021-04-27 19:05:08,2021-04-27 19:43:39.513985
4213,20251,3,20251,16,2050,16,6,1,6,Life - School Balance,2,2050,55,2021-04-27 19:05:08,2021-04-27 21:22:49.990447
4214,20252,4,20252,20,2050,20,7,1,7,Discrimination,2,2050,55,2021-04-27 19:05:08,2021-04-27 21:22:49.990447
4215,20253,3,20253,25,2050,25,8,0,8,Financial Pressure,2,2050,55,2021-04-27 19:05:08,2021-04-27 21:22:49.990447
4216,20254,4,20254,27,2050,27,9,1,9,Faculty & Staff Support,2,2050,55,2021-04-27 19:05:08,2021-04-27 21:22:49.990447
4217,20255,4,20255,32,2050,32,10,1,10,Friendships,2,2050,55,2021-04-27 19:05:08,2021-04-27 21:22:49.990447
4218,20256,5,20256,16,2051,16,6,1,6,Life - School Balance,2,2051,57,2021-04-27 19:05:08,2021-04-27 19:06:53.327960
4219,20257,6,20257,20,2051,20,7,1,7,Discrimination,2,2051,57,2021-04-27 19:05:08,2021-04-27 19:06:53.327960
4220,20258,2,20258,22,2051,22,8,1,8,Financial Pressure,2,2051,57,2021-04-27 19:05:08,2021-04-27 19:06:53.327960
4221,20259,5,20259,28,2051,28,9,1,9,Faculty & Staff Support,2,2051,57,2021-04-27 19:05:08,2021-04-27 19:06:53.327960
4222,20260,6,20260,30,2051,30,10,1,10,Friendships,2,2051,57,2021-04-27 19:05:08,2021-04-27 19:06:53.327960
4223,20266,4,20266,16,2053,16,6,1,6,Life - School Balance,2,2053,60,2021-04-27 19:05:08,2021-04-27 19:06:57.347417
4224,20267,3,20267,21,2053,21,7,1,7,Discrimination,2,2053,60,2021-04-27 19:05:08,2021-04-27 19:06:57.347417
4225,20268,6,20268,24,2053,24,8,1,8,Financial Pressure,2,2053,60,2021-04-27 19:05:08,2021-04-27 19:06:57.347417
4226,20269,4,20269,27,2053,27,9,1,9,Faculty & Staff Support,2,2053,60,2021-04-27 19:05:08,2021-04-27 19:06:57.347417
4227,20270,4,20270,32,2053,32,10,1,10,Friendships,2,2053,60,2021-04-27 19:05:08,2021-04-27 19:06:57.347417
4228,20291,5,20291,16,2058,16,6,1,6,Life - School Balance,2,2058,66,2021-04-27 19:05:09,2021-04-27 19:27:36.200226
4229,20292,5,20292,20,2058,20,7,1,7,Discrimination,2,2058,66,2021-04-27 19:05:09,2021-04-27 19:27:36.200226
4230,20293,4,20293,24,2058,24,8,1,8,Financial Pressure,2,2058,66,2021-04-27 19:05:09,2021-04-27 19:27:36.200226
4231,20294,5,20294,28,2058,28,9,1,9,Faculty & Staff Support,2,2058,66,2021-04-27 19:05:09,2021-04-27 19:27:36.200226
4232,20295,5,20295,30,2058,30,10,1,10,Friendships,2,2058,66,2021-04-27 19:05:09,2021-04-27 19:27:36.200226
4233,20326,6,20326,16,2065,16,6,1,6,Life - School Balance,2,2065,73,2021-04-27 19:05:10,2021-04-27 19:06:31.265915
4234,20327,6,20327,21,2065,21,7,1,7,Discrimination,2,2065,73,2021-04-27 19:05:10,2021-04-27 19:06:31.265915
4235,20328,2,20328,22,2065,22,8,1,8,Financial Pressure,2,2065,73,2021-04-27 19:05:10,2021-04-27 19:06:31.265915
4236,20329,6,20329,26,2065,26,9,1,9,Faculty & Staff Support,2,2065,73,2021-04-27 19:05:10,2021-04-27 19:06:31.265915
4237,20330,6,20330,31,2065,31,10,1,10,Friendships,2,2065,73,2021-04-27 19:05:10,2021-04-27 19:06:31.265915
4238,20331,4,20331,16,2066,16,6,1,6,Life - School Balance,2,2066,74,2021-04-27 19:05:10,2021-04-28 01:22:09.710342
4239,20332,6,20332,21,2066,21,7,1,7,Discrimination,2,2066,74,2021-04-27 19:05:10,2021-04-28 01:22:09.710342
4240,20333,4,20333,25,2066,25,8,0,8,Financial Pressure,2,2066,74,2021-04-27 19:05:10,2021-04-28 01:22:09.710342
4241,20334,6,20334,28,2066,28,9,1,9,Faculty & Staff Support,2,2066,74,2021-04-27 19:05:10,2021-04-28 01:22:09.710342
4242,20335,6,20335,31,2066,31,10,1,10,Friendships,2,2066,74,2021-04-27 19:05:10,2021-04-28 01:22:09.710342
4243,20336,4,20336,16,2067,16,6,1,6,Life - School Balance,2,2067,75,2021-04-27 19:05:10,2021-04-27 19:37:03.450304
4244,20337,6,20337,21,2067,21,7,1,7,Discrimination,2,2067,75,2021-04-27 19:05:10,2021-04-27 19:37:03.450304
4245,20338,4,20338,22,2067,22,8,1,8,Financial Pressure,2,2067,75,2021-04-27 19:05:10,2021-04-27 19:37:03.450304
4246,20339,6,20339,26,2067,26,9,1,9,Faculty & Staff Support,2,2067,75,2021-04-27 19:05:10,2021-04-27 19:37:03.450304
4247,20340,6,20340,30,2067,30,10,1,10,Friendships,2,2067,75,2021-04-27 19:05:10,2021-04-27 19:37:03.450304
4248,20341,2,20341,16,2068,16,6,1,6,Life - School Balance,2,2068,76,2021-04-27 19:05:11,2021-04-27 19:13:44.154945
4249,20342,4,20342,20,2068,20,7,1,7,Discrimination,2,2068,76,2021-04-27 19:05:11,2021-04-27 19:13:44.154945
4250,20343,2,20343,25,2068,25,8,0,8,Financial Pressure,2,2068,76,2021-04-27 19:05:11,2021-04-27 19:13:44.154945
4251,20344,4,20344,28,2068,28,9,1,9,Faculty & Staff Support,2,2068,76,2021-04-27 19:05:11,2021-04-27 19:13:44.154945
4252,20345,5,20345,33,2068,33,10,0,10,Friendships,2,2068,76,2021-04-27 19:05:11,2021-04-27 19:13:44.154945
4253,20356,2,20356,16,2071,16,6,1,6,Life - School Balance,2,2071,79,2021-04-27 19:05:11,2021-04-27 20:28:28.289214
4254,20357,6,20357,19,2071,19,7,0,7,Discrimination,2,2071,79,2021-04-27 19:05:11,2021-04-27 20:28:28.289214
4255,20358,4,20358,25,2071,25,8,0,8,Financial Pressure,2,2071,79,2021-04-27 19:05:11,2021-04-27 20:28:28.289214
4256,20359,6,20359,28,2071,28,9,1,9,Faculty & Staff Support,2,2071,79,2021-04-27 19:05:11,2021-04-27 20:28:28.289214
4257,20360,6,20360,33,2071,33,10,0,10,Friendships,2,2071,79,2021-04-27 19:05:11,2021-04-27 20:28:28.289214
4258,20361,2,20361,16,2072,16,6,1,6,Life - School Balance,2,2072,84,2021-04-27 19:05:11,2021-04-27 19:58:50.381329
4259,20362,6,20362,21,2072,21,7,1,7,Discrimination,2,2072,84,2021-04-27 19:05:11,2021-04-27 19:58:50.381329
4260,20363,4,20363,23,2072,23,8,1,8,Financial Pressure,2,2072,84,2021-04-27 19:05:11,2021-04-27 19:58:50.381329
4261,20364,4,20364,26,2072,26,9,1,9,Faculty & Staff Support,2,2072,84,2021-04-27 19:05:11,2021-04-27 19:58:50.381329
4262,20365,4,20365,30,2072,30,10,1,10,Friendships,2,2072,84,2021-04-27 19:05:11,2021-04-27 19:58:50.381329
4263,20376,3,20376,16,2075,16,6,1,6,Life - School Balance,2,2075,87,2021-04-27 19:05:12,2021-04-27 19:15:35.824313
4264,20377,6,20377,19,2075,19,7,0,7,Discrimination,2,2075,87,2021-04-27 19:05:12,2021-04-27 19:15:35.824313
4265,20378,4,20378,25,2075,25,8,0,8,Financial Pressure,2,2075,87,2021-04-27 19:05:12,2021-04-27 19:15:35.824313
4266,20379,5,20379,27,2075,27,9,1,9,Faculty & Staff Support,2,2075,87,2021-04-27 19:05:12,2021-04-27 19:15:35.824313
4267,20380,6,20380,31,2075,31,10,1,10,Friendships,2,2075,87,2021-04-27 19:05:12,2021-04-27 19:15:35.824313
4268,20381,4,20381,16,2076,16,6,1,6,Life - School Balance,2,2076,88,2021-04-27 19:05:12,2021-04-27 19:06:30.085896
4269,20382,5,20382,20,2076,20,7,1,7,Discrimination,2,2076,88,2021-04-27 19:05:12,2021-04-27 19:06:30.085896
4270,20383,3,20383,25,2076,25,8,0,8,Financial Pressure,2,2076,88,2021-04-27 19:05:12,2021-04-27 19:06:30.085896
4271,20384,5,20384,26,2076,26,9,1,9,Faculty & Staff Support,2,2076,88,2021-04-27 19:05:12,2021-04-27 19:06:30.085896
4272,20385,6,20385,30,2076,30,10,1,10,Friendships,2,2076,88,2021-04-27 19:05:12,2021-04-27 19:06:30.085896
4273,20386,5,20386,16,2077,16,6,1,6,Life - School Balance,2,2077,89,2021-04-27 19:05:12,2021-04-27 20:52:52.516281
4274,20387,6,20387,20,2077,20,7,1,7,Discrimination,2,2077,89,2021-04-27 19:05:12,2021-04-27 20:52:52.516281
4275,20388,4,20388,24,2077,24,8,1,8,Financial Pressure,2,2077,89,2021-04-27 19:05:12,2021-04-27 20:52:52.516281
4276,20389,6,20389,29,2077,29,9,0,9,Faculty & Staff Support,2,2077,89,2021-04-27 19:05:12,2021-04-27 20:52:52.516281
4277,20390,4,20390,33,2077,33,10,0,10,Friendships,2,2077,89,2021-04-27 19:05:12,2021-04-27 20:52:52.516281
4278,20416,4,20416,16,2083,16,6,1,6,Life - School Balance,2,2083,96,2021-04-27 19:05:13,2021-04-27 20:09:51.771537
4279,20417,5,20417,19,2083,19,7,0,7,Discrimination,2,2083,96,2021-04-27 19:05:13,2021-04-27 20:09:51.771537
4280,20418,6,20418,22,2083,22,8,1,8,Financial Pressure,2,2083,96,2021-04-27 19:05:13,2021-04-27 20:09:51.771537
4281,20419,4,20419,27,2083,27,9,1,9,Faculty & Staff Support,2,2083,96,2021-04-27 19:05:13,2021-04-27 20:09:51.771537
4282,20420,4,20420,31,2083,31,10,1,10,Friendships,2,2083,96,2021-04-27 19:05:13,2021-04-27 20:09:51.771537
4283,20520,4,20520,16,2102,16,6,1,6,Life - School Balance,2,2102,6,2021-04-29 15:03:21,2021-04-29 15:11:02.251713
4284,20521,6,20521,19,2102,19,7,0,7,Discrimination,2,2102,6,2021-04-29 15:03:21,2021-04-29 15:11:02.251713
4285,20522,5,20522,25,2102,25,8,0,8,Financial Pressure,2,2102,6,2021-04-29 15:03:21,2021-04-29 15:11:02.251713
4286,20523,5,20523,28,2102,28,9,1,9,Faculty & Staff Support,2,2102,6,2021-04-29 15:03:21,2021-04-29 15:11:02.251713
4287,20524,5,20524,33,2102,33,10,0,10,Friendships,2,2102,6,2021-04-29 15:03:21,2021-04-29 15:11:02.251713
4288,20530,4,20530,16,2104,16,6,1,6,Life - School Balance,2,2104,10,2021-04-29 15:03:22,2021-04-29 15:03:49.374095
4289,20531,6,20531,21,2104,21,7,1,7,Discrimination,2,2104,10,2021-04-29 15:03:22,2021-04-29 15:03:49.374095
4290,20532,3,20532,22,2104,22,8,1,8,Financial Pressure,2,2104,10,2021-04-29 15:03:22,2021-04-29 15:03:49.374095
4291,20533,5,20533,27,2104,27,9,1,9,Faculty & Staff Support,2,2104,10,2021-04-29 15:03:22,2021-04-29 15:03:49.374095
4292,20534,4,20534,32,2104,32,10,1,10,Friendships,2,2104,10,2021-04-29 15:03:22,2021-04-29 15:03:49.374095
4293,20630,5,20630,16,2124,16,6,1,6,Life - School Balance,2,2124,41,2021-04-29 15:03:25,2021-04-29 15:04:19.316295
4294,20631,5,20631,21,2124,21,7,1,7,Discrimination,2,2124,41,2021-04-29 15:03:25,2021-04-29 15:04:19.316295
4295,20632,4,20632,24,2124,24,8,1,8,Financial Pressure,2,2124,41,2021-04-29 15:03:25,2021-04-29 15:04:19.316295
4296,20633,5,20633,27,2124,27,9,1,9,Faculty & Staff Support,2,2124,41,2021-04-29 15:03:25,2021-04-29 15:04:19.316295
4297,20634,5,20634,33,2124,33,10,0,10,Friendships,2,2124,41,2021-04-29 15:03:25,2021-04-29 15:04:19.316295
4298,20670,4,20670,16,2132,16,6,1,6,Life - School Balance,2,2132,50,2021-04-29 15:03:27,2021-04-29 15:08:07.949981
4299,20671,3,20671,19,2132,19,7,0,7,Discrimination,2,2132,50,2021-04-29 15:03:27,2021-04-29 15:08:07.949981
4300,20672,6,20672,24,2132,24,8,1,8,Financial Pressure,2,2132,50,2021-04-29 15:03:27,2021-04-29 15:08:07.949981
4301,20673,4,20673,28,2132,28,9,1,9,Faculty & Staff Support,2,2132,50,2021-04-29 15:03:27,2021-04-29 15:08:07.949981
4302,20674,3,20674,33,2132,33,10,0,10,Friendships,2,2132,50,2021-04-29 15:03:27,2021-04-29 15:08:07.949981
4303,20685,3,20685,16,2135,16,6,1,6,Life - School Balance,2,2135,55,2021-04-29 15:03:27,2021-04-29 15:06:39.248202
4304,20686,4,20686,20,2135,20,7,1,7,Discrimination,2,2135,55,2021-04-29 15:03:27,2021-04-29 15:06:39.248202
4305,20687,2,20687,23,2135,23,8,1,8,Financial Pressure,2,2135,55,2021-04-29 15:03:27,2021-04-29 15:06:39.248202
4306,20688,4,20688,27,2135,27,9,1,9,Faculty & Staff Support,2,2135,55,2021-04-29 15:03:27,2021-04-29 15:06:39.248202
4307,20689,3,20689,31,2135,31,10,1,10,Friendships,2,2135,55,2021-04-29 15:03:27,2021-04-29 15:06:39.248202
4308,20690,5,20690,16,2136,16,6,1,6,Life - School Balance,2,2136,57,2021-04-29 15:03:27,2021-04-29 15:04:28.131658
4309,20691,6,20691,20,2136,20,7,1,7,Discrimination,2,2136,57,2021-04-29 15:03:27,2021-04-29 15:04:28.131658
4310,20692,3,20692,25,2136,25,8,0,8,Financial Pressure,2,2136,57,2021-04-29 15:03:27,2021-04-29 15:04:28.131658
4311,20693,5,20693,27,2136,27,9,1,9,Faculty & Staff Support,2,2136,57,2021-04-29 15:03:27,2021-04-29 15:04:28.131658
4312,20694,6,20694,31,2136,31,10,1,10,Friendships,2,2136,57,2021-04-29 15:03:27,2021-04-29 15:04:28.131658
4313,20730,4,20730,16,2144,16,6,1,6,Life - School Balance,2,2144,67,2021-04-29 15:03:29,2021-04-29 16:00:31.138386
4314,20731,3,20731,20,2144,20,7,1,7,Discrimination,2,2144,67,2021-04-29 15:03:29,2021-04-29 16:00:31.138386
4315,20732,5,20732,24,2144,24,8,1,8,Financial Pressure,2,2144,67,2021-04-29 15:03:29,2021-04-29 16:00:31.138386
4316,20733,6,20733,27,2144,27,9,1,9,Faculty & Staff Support,2,2144,67,2021-04-29 15:03:29,2021-04-29 16:00:31.138386
4317,20734,4,20734,32,2144,32,10,1,10,Friendships,2,2144,67,2021-04-29 15:03:29,2021-04-29 16:00:31.138386
4318,20750,4,20750,16,2148,16,6,1,6,Life - School Balance,2,2148,71,2021-04-29 15:03:30,2021-04-29 15:19:56.024627
4319,20751,6,20751,21,2148,21,7,1,7,Discrimination,2,2148,71,2021-04-29 15:03:30,2021-04-29 15:19:56.024627
4320,20752,3,20752,25,2148,25,8,0,8,Financial Pressure,2,2148,71,2021-04-29 15:03:30,2021-04-29 15:19:56.024627
4321,20753,5,20753,26,2148,26,9,1,9,Faculty & Staff Support,2,2148,71,2021-04-29 15:03:30,2021-04-29 15:19:56.024627
4322,20754,5,20754,30,2148,30,10,1,10,Friendships,2,2148,71,2021-04-29 15:03:30,2021-04-29 15:19:56.024627
4323,20760,6,20760,16,2150,16,6,1,6,Life - School Balance,2,2150,73,2021-04-29 15:03:30,2021-04-29 19:20:29.637536
4324,20761,6,20761,19,2150,19,7,0,7,Discrimination,2,2150,73,2021-04-29 15:03:30,2021-04-29 19:20:29.637536
4325,20762,1,20762,22,2150,22,8,1,8,Financial Pressure,2,2150,73,2021-04-29 15:03:30,2021-04-29 19:20:29.637536
4326,20763,6,20763,28,2150,28,9,1,9,Faculty & Staff Support,2,2150,73,2021-04-29 15:03:30,2021-04-29 19:20:29.637536
4327,20764,6,20764,31,2150,31,10,1,10,Friendships,2,2150,73,2021-04-29 15:03:30,2021-04-29 19:20:29.637536
4328,20765,5,20765,16,2151,16,6,1,6,Life - School Balance,2,2151,74,2021-04-29 15:03:30,2021-04-29 15:05:07.668172
4329,20766,6,20766,21,2151,21,7,1,7,Discrimination,2,2151,74,2021-04-29 15:03:30,2021-04-29 15:05:07.668172
4330,20767,4,20767,23,2151,23,8,1,8,Financial Pressure,2,2151,74,2021-04-29 15:03:30,2021-04-29 15:05:07.668172
4331,20768,5,20768,26,2151,26,9,1,9,Faculty & Staff Support,2,2151,74,2021-04-29 15:03:30,2021-04-29 15:05:07.668172
4332,20769,6,20769,32,2151,32,10,1,10,Friendships,2,2151,74,2021-04-29 15:03:30,2021-04-29 15:05:07.668172
4333,20780,2,20780,16,2154,16,6,1,6,Life - School Balance,2,2154,77,2021-04-29 15:03:31,2021-04-29 15:13:32.820729
4334,20781,4,20781,21,2154,21,7,1,7,Discrimination,2,2154,77,2021-04-29 15:03:31,2021-04-29 15:13:32.820729
4335,20782,4,20782,24,2154,24,8,1,8,Financial Pressure,2,2154,77,2021-04-29 15:03:31,2021-04-29 15:13:32.820729
4336,20783,4,20783,28,2154,28,9,1,9,Faculty & Staff Support,2,2154,77,2021-04-29 15:03:31,2021-04-29 15:13:32.820729
4337,20784,4,20784,31,2154,31,10,1,10,Friendships,2,2154,77,2021-04-29 15:03:31,2021-04-29 15:13:32.820729
4338,20785,3,20785,16,2155,16,6,1,6,Life - School Balance,2,2155,78,2021-04-29 15:03:31,2021-04-29 15:24:02.456905
4339,20786,5,20786,21,2155,21,7,1,7,Discrimination,2,2155,78,2021-04-29 15:03:31,2021-04-29 15:24:02.456905
4340,20787,3,20787,22,2155,22,8,1,8,Financial Pressure,2,2155,78,2021-04-29 15:03:31,2021-04-29 15:24:02.456905
4341,20788,5,20788,26,2155,26,9,1,9,Faculty & Staff Support,2,2155,78,2021-04-29 15:03:31,2021-04-29 15:24:02.456905
4342,20789,6,20789,30,2155,30,10,1,10,Friendships,2,2155,78,2021-04-29 15:03:31,2021-04-29 15:24:02.456905
4343,20795,2,20795,16,2157,16,6,1,6,Life - School Balance,2,2157,84,2021-04-29 15:03:31,2021-04-29 16:23:20.956778
4344,20796,6,20796,19,2157,19,7,0,7,Discrimination,2,2157,84,2021-04-29 15:03:31,2021-04-29 16:23:20.956778
4345,20797,5,20797,25,2157,25,8,0,8,Financial Pressure,2,2157,84,2021-04-29 15:03:31,2021-04-29 16:23:20.956778
4346,20798,5,20798,29,2157,29,9,0,9,Faculty & Staff Support,2,2157,84,2021-04-29 15:03:31,2021-04-29 16:23:20.956778
4347,20799,5,20799,33,2157,33,10,0,10,Friendships,2,2157,84,2021-04-29 15:03:31,2021-04-29 16:23:20.956778
4348,20800,4,20800,16,2158,16,6,1,6,Life - School Balance,2,2158,85,2021-04-29 15:03:31,2021-04-29 21:23:08.827718
4349,20801,6,20801,21,2158,21,7,1,7,Discrimination,2,2158,85,2021-04-29 15:03:31,2021-04-29 21:23:08.827718
4350,20802,3,20802,22,2158,22,8,1,8,Financial Pressure,2,2158,85,2021-04-29 15:03:31,2021-04-29 21:23:08.827718
4351,20803,5,20803,26,2158,26,9,1,9,Faculty & Staff Support,2,2158,85,2021-04-29 15:03:31,2021-04-29 21:23:08.827718
4352,20804,5,20804,30,2158,30,10,1,10,Friendships,2,2158,85,2021-04-29 15:03:31,2021-04-29 21:23:08.827718
4353,20805,5,20805,16,2159,16,6,1,6,Life - School Balance,2,2159,86,2021-04-29 15:03:31,2021-04-29 16:28:09.241463
4354,20806,5,20806,20,2159,20,7,1,7,Discrimination,2,2159,86,2021-04-29 15:03:31,2021-04-29 16:28:09.241463
4355,20807,3,20807,24,2159,24,8,1,8,Financial Pressure,2,2159,86,2021-04-29 15:03:31,2021-04-29 16:28:09.241463
4356,20808,5,20808,28,2159,28,9,1,9,Faculty & Staff Support,2,2159,86,2021-04-29 15:03:31,2021-04-29 16:28:09.241463
4357,20809,5,20809,33,2159,33,10,0,10,Friendships,2,2159,86,2021-04-29 15:03:31,2021-04-29 16:28:09.241463
4358,20810,5,20810,16,2160,16,6,1,6,Life - School Balance,2,2160,87,2021-04-29 15:03:32,2021-04-29 20:18:33.494120
4359,20811,4,20811,21,2160,21,7,1,7,Discrimination,2,2160,87,2021-04-29 15:03:32,2021-04-29 20:18:33.494120
4360,20812,2,20812,25,2160,25,8,0,8,Financial Pressure,2,2160,87,2021-04-29 15:03:32,2021-04-29 20:18:33.494120
4361,20813,6,20813,27,2160,27,9,1,9,Faculty & Staff Support,2,2160,87,2021-04-29 15:03:32,2021-04-29 20:18:33.494120
4362,20814,5,20814,30,2160,30,10,1,10,Friendships,2,2160,87,2021-04-29 15:03:32,2021-04-29 20:18:33.494120
4363,20870,2,20870,16,2172,16,6,1,6,Life - School Balance,2,2172,101,2021-04-29 15:03:34,2021-04-29 15:12:36.122276
4364,20871,5,20871,19,2172,19,7,0,7,Discrimination,2,2172,101,2021-04-29 15:03:34,2021-04-29 15:12:36.122276
4365,20872,5,20872,22,2172,22,8,1,8,Financial Pressure,2,2172,101,2021-04-29 15:03:34,2021-04-29 15:12:36.122276
4366,20873,5,20873,29,2172,29,9,0,9,Faculty & Staff Support,2,2172,101,2021-04-29 15:03:34,2021-04-29 15:12:36.122276
4367,20874,5,20874,32,2172,32,10,1,10,Friendships,2,2172,101,2021-04-29 15:03:34,2021-04-29 15:12:36.122276
4368,20880,5,20880,16,2174,16,6,1,6,Life - School Balance,2,2174,104,2021-04-29 15:03:34,2021-04-30 04:12:07.585099
4369,20881,5,20881,19,2174,19,7,0,7,Discrimination,2,2174,104,2021-04-29 15:03:34,2021-04-30 04:12:07.585099
4370,20882,3,20882,23,2174,23,8,1,8,Financial Pressure,2,2174,104,2021-04-29 15:03:34,2021-04-30 04:12:07.585099
4371,20883,6,20883,29,2174,29,9,0,9,Faculty & Staff Support,2,2174,104,2021-04-29 15:03:34,2021-04-30 04:12:07.585099
4372,20884,3,20884,32,2174,32,10,1,10,Friendships,2,2174,104,2021-04-29 15:03:34,2021-04-30 04:12:07.585099
4373,20885,4,20885,16,2175,16,6,1,6,Life - School Balance,2,2175,105,2021-04-29 15:03:34,2021-04-29 15:15:33.619106
4374,20886,3,20886,21,2175,21,7,1,7,Discrimination,2,2175,105,2021-04-29 15:03:34,2021-04-29 15:15:33.619106
4375,20887,6,20887,22,2175,22,8,1,8,Financial Pressure,2,2175,105,2021-04-29 15:03:34,2021-04-29 15:15:33.619106
4376,20888,4,20888,27,2175,27,9,1,9,Faculty & Staff Support,2,2175,105,2021-04-29 15:03:34,2021-04-29 15:15:33.619106
4377,20889,4,20889,32,2175,32,10,1,10,Friendships,2,2175,105,2021-04-29 15:03:34,2021-04-29 15:15:33.619106
4378,21065,4,21065,16,2211,16,6,1,6,Life - School Balance,2,2211,5,2021-05-04 19:05:01,2021-05-04 19:18:35.894947
4379,21066,4,21066,19,2211,19,7,0,7,Discrimination,2,2211,5,2021-05-04 19:05:01,2021-05-04 19:18:35.894947
4380,21067,4,21067,23,2211,23,8,1,8,Financial Pressure,2,2211,5,2021-05-04 19:05:01,2021-05-04 19:18:35.894947
4381,21068,5,21068,27,2211,27,9,1,9,Faculty & Staff Support,2,2211,5,2021-05-04 19:05:01,2021-05-04 19:18:35.894947
4382,21069,4,21069,32,2211,32,10,1,10,Friendships,2,2211,5,2021-05-04 19:05:01,2021-05-04 19:18:35.894947
4383,21070,4,21070,16,2212,16,6,1,6,Life - School Balance,2,2212,6,2021-05-04 19:05:01,2021-05-04 19:44:32.206900
4384,21071,5,21071,19,2212,19,7,0,7,Discrimination,2,2212,6,2021-05-04 19:05:01,2021-05-04 19:44:32.206900
4385,21072,5,21072,23,2212,23,8,1,8,Financial Pressure,2,2212,6,2021-05-04 19:05:01,2021-05-04 19:44:32.206900
4386,21073,5,21073,27,2212,27,9,1,9,Faculty & Staff Support,2,2212,6,2021-05-04 19:05:01,2021-05-04 19:44:32.206900
4387,21074,5,21074,30,2212,30,10,1,10,Friendships,2,2212,6,2021-05-04 19:05:01,2021-05-04 19:44:32.206900
4388,21120,2,21120,16,2222,16,6,1,6,Life - School Balance,2,2222,22,2021-05-04 19:05:03,2021-05-04 19:05:31.810303
4389,21121,4,21121,21,2222,21,7,1,7,Discrimination,2,2222,22,2021-05-04 19:05:03,2021-05-04 19:05:31.810303
4390,21122,6,21122,24,2222,24,8,1,8,Financial Pressure,2,2222,22,2021-05-04 19:05:03,2021-05-04 19:05:31.810303
4391,21123,5,21123,26,2222,26,9,1,9,Faculty & Staff Support,2,2222,22,2021-05-04 19:05:03,2021-05-04 19:05:31.810303
4392,21124,6,21124,31,2222,31,10,1,10,Friendships,2,2222,22,2021-05-04 19:05:03,2021-05-04 19:05:31.810303
4393,21130,3,21130,16,2224,16,6,1,6,Life - School Balance,2,2224,26,2021-05-04 19:05:03,2021-05-04 19:08:52.130227
4394,21131,5,21131,19,2224,19,7,0,7,Discrimination,2,2224,26,2021-05-04 19:05:03,2021-05-04 19:08:52.130227
4395,21132,4,21132,24,2224,24,8,1,8,Financial Pressure,2,2224,26,2021-05-04 19:05:03,2021-05-04 19:08:52.130227
4396,21133,6,21133,29,2224,29,9,0,9,Faculty & Staff Support,2,2224,26,2021-05-04 19:05:03,2021-05-04 19:08:52.130227
4397,21134,5,21134,32,2224,32,10,1,10,Friendships,2,2224,26,2021-05-04 19:05:03,2021-05-04 19:08:52.130227
4398,21150,5,21150,16,2228,16,6,1,6,Life - School Balance,2,2228,31,2021-05-04 19:05:04,2021-05-04 19:05:53.656591
4399,21151,6,21151,21,2228,21,7,1,7,Discrimination,2,2228,31,2021-05-04 19:05:04,2021-05-04 19:05:53.656591
4400,21152,6,21152,22,2228,22,8,1,8,Financial Pressure,2,2228,31,2021-05-04 19:05:04,2021-05-04 19:05:53.656591
4401,21153,2,21153,28,2228,28,9,1,9,Faculty & Staff Support,2,2228,31,2021-05-04 19:05:04,2021-05-04 19:05:53.656591
4402,21154,3,21154,32,2228,32,10,1,10,Friendships,2,2228,31,2021-05-04 19:05:04,2021-05-04 19:05:53.656591
4403,21190,4,21190,16,2236,16,6,1,6,Life - School Balance,2,2236,44,2021-05-04 19:05:05,2021-05-04 20:14:02.813079
4404,21191,4,21191,20,2236,20,7,1,7,Discrimination,2,2236,44,2021-05-04 19:05:05,2021-05-04 20:14:02.813079
4405,21192,4,21192,22,2236,22,8,1,8,Financial Pressure,2,2236,44,2021-05-04 19:05:05,2021-05-04 20:14:02.813079
4406,21193,3,21193,29,2236,29,9,0,9,Faculty & Staff Support,2,2236,44,2021-05-04 19:05:05,2021-05-04 20:14:02.813079
4407,21194,5,21194,33,2236,33,10,0,10,Friendships,2,2236,44,2021-05-04 19:05:05,2021-05-04 20:14:02.813079
4408,21195,5,21195,16,2237,16,6,1,6,Life - School Balance,2,2237,45,2021-05-04 19:05:05,2021-05-04 19:41:32.771277
4409,21196,6,21196,20,2237,20,7,1,7,Discrimination,2,2237,45,2021-05-04 19:05:05,2021-05-04 19:41:32.771277
4410,21197,1,21197,23,2237,23,8,1,8,Financial Pressure,2,2237,45,2021-05-04 19:05:05,2021-05-04 19:41:32.771277
4411,21198,5,21198,28,2237,28,9,1,9,Faculty & Staff Support,2,2237,45,2021-05-04 19:05:05,2021-05-04 19:41:32.771277
4412,21199,5,21199,33,2237,33,10,0,10,Friendships,2,2237,45,2021-05-04 19:05:05,2021-05-04 19:41:32.771277
4413,21230,4,21230,16,2244,16,6,1,6,Life - School Balance,2,2244,54,2021-05-04 19:05:06,2021-05-04 20:33:43.362286
4414,21231,4,21231,20,2244,20,7,1,7,Discrimination,2,2244,54,2021-05-04 19:05:06,2021-05-04 20:33:43.362286
4415,21232,3,21232,22,2244,22,8,1,8,Financial Pressure,2,2244,54,2021-05-04 19:05:06,2021-05-04 20:33:43.362286
4416,21233,6,21233,29,2244,29,9,0,9,Faculty & Staff Support,2,2244,54,2021-05-04 19:05:06,2021-05-04 20:33:43.362286
4417,21234,4,21234,32,2244,32,10,1,10,Friendships,2,2244,54,2021-05-04 19:05:06,2021-05-04 20:33:43.362286
4418,21240,4,21240,16,2246,16,6,1,6,Life - School Balance,2,2246,57,2021-05-04 19:05:07,2021-05-04 19:27:05.990778
4419,21241,6,21241,21,2246,21,7,1,7,Discrimination,2,2246,57,2021-05-04 19:05:07,2021-05-04 19:27:05.990778
4420,21242,3,21242,22,2246,22,8,1,8,Financial Pressure,2,2246,57,2021-05-04 19:05:07,2021-05-04 19:27:05.990778
4421,21243,5,21243,28,2246,28,9,1,9,Faculty & Staff Support,2,2246,57,2021-05-04 19:05:07,2021-05-04 19:27:05.990778
4422,21244,6,21244,30,2246,30,10,1,10,Friendships,2,2246,57,2021-05-04 19:05:07,2021-05-04 19:27:05.990778
4423,21250,1,21250,16,2248,16,6,1,6,Life - School Balance,2,2248,60,2021-05-04 19:05:07,2021-05-04 19:16:38.729927
4424,21251,4,21251,20,2248,20,7,1,7,Discrimination,2,2248,60,2021-05-04 19:05:07,2021-05-04 19:16:38.729927
4425,21252,6,21252,23,2248,23,8,1,8,Financial Pressure,2,2248,60,2021-05-04 19:05:07,2021-05-04 19:16:38.729927
4426,21253,4,21253,28,2248,28,9,1,9,Faculty & Staff Support,2,2248,60,2021-05-04 19:05:07,2021-05-04 19:16:38.729927
4427,21254,4,21254,30,2248,30,10,1,10,Friendships,2,2248,60,2021-05-04 19:05:07,2021-05-04 19:16:38.729927
4428,21335,1,21335,16,2265,16,6,1,6,Life - School Balance,2,2265,78,2021-05-04 19:05:10,2021-05-04 19:42:47.701736
4429,21336,5,21336,21,2265,21,7,1,7,Discrimination,2,2265,78,2021-05-04 19:05:10,2021-05-04 19:42:47.701736
4430,21337,3,21337,23,2265,23,8,1,8,Financial Pressure,2,2265,78,2021-05-04 19:05:10,2021-05-04 19:42:47.701736
4431,21338,5,21338,27,2265,27,9,1,9,Faculty & Staff Support,2,2265,78,2021-05-04 19:05:10,2021-05-04 19:42:47.701736
4432,21339,6,21339,32,2265,32,10,1,10,Friendships,2,2265,78,2021-05-04 19:05:10,2021-05-04 19:42:47.701736
4433,21355,5,21355,16,2269,16,6,1,6,Life - School Balance,2,2269,86,2021-05-04 19:05:10,2021-05-04 20:24:59.150531
4434,21356,5,21356,21,2269,21,7,1,7,Discrimination,2,2269,86,2021-05-04 19:05:10,2021-05-04 20:24:59.150531
4435,21357,3,21357,22,2269,22,8,1,8,Financial Pressure,2,2269,86,2021-05-04 19:05:10,2021-05-04 20:24:59.150531
4436,21358,5,21358,28,2269,28,9,1,9,Faculty & Staff Support,2,2269,86,2021-05-04 19:05:10,2021-05-04 20:24:59.150531
4437,21359,5,21359,31,2269,31,10,1,10,Friendships,2,2269,86,2021-05-04 19:05:10,2021-05-04 20:24:59.150531
4438,21360,5,21360,16,2270,16,6,1,6,Life - School Balance,2,2270,87,2021-05-04 19:05:10,2021-05-04 20:45:58.353295
4439,21361,5,21361,21,2270,21,7,1,7,Discrimination,2,2270,87,2021-05-04 19:05:10,2021-05-04 20:45:58.353295
4440,21362,1,21362,23,2270,23,8,1,8,Financial Pressure,2,2270,87,2021-05-04 19:05:10,2021-05-04 20:45:58.353295
4441,21363,5,21363,29,2270,29,9,0,9,Faculty & Staff Support,2,2270,87,2021-05-04 19:05:10,2021-05-04 20:45:58.353295
4442,21364,6,21364,31,2270,31,10,1,10,Friendships,2,2270,87,2021-05-04 19:05:10,2021-05-04 20:45:58.353295
4443,21370,4,21370,16,2272,16,6,1,6,Life - School Balance,2,2272,89,2021-05-04 19:05:11,2021-05-04 19:27:45.269637
4444,21371,3,21371,21,2272,21,7,1,7,Discrimination,2,2272,89,2021-05-04 19:05:11,2021-05-04 19:27:45.269637
4445,21372,3,21372,23,2272,23,8,1,8,Financial Pressure,2,2272,89,2021-05-04 19:05:11,2021-05-04 19:27:45.269637
4446,21373,6,21373,26,2272,26,9,1,9,Faculty & Staff Support,2,2272,89,2021-05-04 19:05:11,2021-05-04 19:27:45.269637
4447,21374,4,21374,33,2272,33,10,0,10,Friendships,2,2272,89,2021-05-04 19:05:11,2021-05-04 19:27:45.269637
4448,21400,4,21400,16,2278,16,6,1,6,Life - School Balance,2,2278,96,2021-05-04 19:05:12,2021-05-04 19:18:50.281752
4449,21401,6,21401,19,2278,19,7,0,7,Discrimination,2,2278,96,2021-05-04 19:05:12,2021-05-04 19:18:50.281752
4450,21402,6,21402,24,2278,24,8,1,8,Financial Pressure,2,2278,96,2021-05-04 19:05:12,2021-05-04 19:18:50.281752
4451,21403,5,21403,27,2278,27,9,1,9,Faculty & Staff Support,2,2278,96,2021-05-04 19:05:12,2021-05-04 19:18:50.281752
4452,21404,5,21404,32,2278,32,10,1,10,Friendships,2,2278,96,2021-05-04 19:05:12,2021-05-04 19:18:50.281752
4453,21410,6,21410,16,2280,16,6,1,6,Life - School Balance,2,2280,99,2021-05-04 19:05:12,2021-05-04 19:07:11.040896
4454,21411,6,21411,19,2280,19,7,0,7,Discrimination,2,2280,99,2021-05-04 19:05:12,2021-05-04 19:07:11.040896
4455,21412,2,21412,23,2280,23,8,1,8,Financial Pressure,2,2280,99,2021-05-04 19:05:12,2021-05-04 19:07:11.040896
4456,21413,6,21413,28,2280,28,9,1,9,Faculty & Staff Support,2,2280,99,2021-05-04 19:05:12,2021-05-04 19:07:11.040896
4457,21414,6,21414,31,2280,31,10,1,10,Friendships,2,2280,99,2021-05-04 19:05:12,2021-05-04 19:07:11.040896
4458,21420,2,21420,16,2282,16,6,1,6,Life - School Balance,2,2282,101,2021-05-04 19:05:12,2021-05-04 20:04:34.918933
4459,21421,5,21421,21,2282,21,7,1,7,Discrimination,2,2282,101,2021-05-04 19:05:12,2021-05-04 20:04:34.918933
4460,21422,6,21422,23,2282,23,8,1,8,Financial Pressure,2,2282,101,2021-05-04 19:05:12,2021-05-04 20:04:34.918933
4461,21423,5,21423,29,2282,29,9,0,9,Faculty & Staff Support,2,2282,101,2021-05-04 19:05:12,2021-05-04 20:04:34.918933
4462,21424,5,21424,32,2282,32,10,1,10,Friendships,2,2282,101,2021-05-04 19:05:12,2021-05-04 20:04:34.918933
4463,21435,2,21435,16,2285,16,6,1,6,Life - School Balance,2,2285,105,2021-05-04 19:05:13,2021-05-04 19:17:00.205062
4464,21436,3,21436,21,2285,21,7,1,7,Discrimination,2,2285,105,2021-05-04 19:05:13,2021-05-04 19:17:00.205062
4465,21437,6,21437,22,2285,22,8,1,8,Financial Pressure,2,2285,105,2021-05-04 19:05:13,2021-05-04 19:17:00.205062
4466,21438,4,21438,28,2285,28,9,1,9,Faculty & Staff Support,2,2285,105,2021-05-04 19:05:13,2021-05-04 19:17:00.205062
4467,21439,3,21439,33,2285,33,10,0,10,Friendships,2,2285,105,2021-05-04 19:05:13,2021-05-04 19:17:00.205062
4468,21534,4,21534,16,2303,16,6,1,6,Life - School Balance,2,2303,10,2021-05-06 14:05:02,2021-05-06 14:08:34.178588
4469,21535,6,21535,19,2303,19,7,0,7,Discrimination,2,2303,10,2021-05-06 14:05:02,2021-05-06 14:08:34.178588
4470,21536,4,21536,23,2303,23,8,1,8,Financial Pressure,2,2303,10,2021-05-06 14:05:02,2021-05-06 14:08:34.178588
4471,21537,4,21537,28,2303,28,9,1,9,Faculty & Staff Support,2,2303,10,2021-05-06 14:05:02,2021-05-06 14:08:34.178588
4472,21538,5,21538,31,2303,31,10,1,10,Friendships,2,2303,10,2021-05-06 14:05:02,2021-05-06 14:08:34.178588
4473,21554,1,21554,16,2307,16,6,1,6,Life - School Balance,2,2307,17,2021-05-06 14:05:03,2021-05-06 14:05:59.662102
4474,21555,5,21555,20,2307,20,7,1,7,Discrimination,2,2307,17,2021-05-06 14:05:03,2021-05-06 14:05:59.662102
4475,21556,6,21556,24,2307,24,8,1,8,Financial Pressure,2,2307,17,2021-05-06 14:05:03,2021-05-06 14:05:59.662102
4476,21557,4,21557,26,2307,26,9,1,9,Faculty & Staff Support,2,2307,17,2021-05-06 14:05:03,2021-05-06 14:05:59.662102
4477,21558,5,21558,30,2307,30,10,1,10,Friendships,2,2307,17,2021-05-06 14:05:03,2021-05-06 14:05:59.662102
4478,21624,3,21624,16,2321,16,6,1,6,Life - School Balance,2,2321,36,2021-05-06 14:05:05,2021-05-06 19:02:50.321950
4479,21625,3,21625,19,2321,19,7,0,7,Discrimination,2,2321,36,2021-05-06 14:05:05,2021-05-06 19:02:50.321950
4480,21626,6,21626,24,2321,24,8,1,8,Financial Pressure,2,2321,36,2021-05-06 14:05:05,2021-05-06 19:02:50.321950
4481,21627,4,21627,26,2321,26,9,1,9,Faculty & Staff Support,2,2321,36,2021-05-06 14:05:05,2021-05-06 19:02:50.321950
4482,21628,4,21628,31,2321,31,10,1,10,Friendships,2,2321,36,2021-05-06 14:05:05,2021-05-06 19:02:50.321950
4483,21649,5,21649,16,2326,16,6,1,6,Life - School Balance,2,2326,45,2021-05-06 14:05:06,2021-05-06 14:10:01.687704
4484,21650,5,21650,20,2326,20,7,1,7,Discrimination,2,2326,45,2021-05-06 14:05:06,2021-05-06 14:10:01.687704
4485,21651,1,21651,23,2326,23,8,1,8,Financial Pressure,2,2326,45,2021-05-06 14:05:06,2021-05-06 14:10:01.687704
4486,21652,5,21652,26,2326,26,9,1,9,Faculty & Staff Support,2,2326,45,2021-05-06 14:05:06,2021-05-06 14:10:01.687704
4487,21653,5,21653,31,2326,31,10,1,10,Friendships,2,2326,45,2021-05-06 14:05:06,2021-05-06 14:10:01.687704
4488,21669,4,21669,16,2330,16,6,1,6,Life - School Balance,2,2330,49,2021-05-06 14:05:07,2021-05-06 20:17:08.018804
4489,21670,4,21670,19,2330,19,7,0,7,Discrimination,2,2330,49,2021-05-06 14:05:07,2021-05-06 20:17:08.018804
4490,21671,4,21671,23,2330,23,8,1,8,Financial Pressure,2,2330,49,2021-05-06 14:05:07,2021-05-06 20:17:08.018804
4491,21672,5,21672,29,2330,29,9,0,9,Faculty & Staff Support,2,2330,49,2021-05-06 14:05:07,2021-05-06 20:17:08.018804
4492,21673,4,21673,30,2330,30,10,1,10,Friendships,2,2330,49,2021-05-06 14:05:07,2021-05-06 20:17:08.018804
4493,21674,4,21674,16,2331,16,6,1,6,Life - School Balance,2,2331,50,2021-05-06 14:05:07,2021-05-06 15:32:16.907458
4494,21675,3,21675,19,2331,19,7,0,7,Discrimination,2,2331,50,2021-05-06 14:05:07,2021-05-06 15:32:16.907458
4495,21676,6,21676,24,2331,24,8,1,8,Financial Pressure,2,2331,50,2021-05-06 14:05:07,2021-05-06 15:32:16.907458
4496,21677,6,21677,26,2331,26,9,1,9,Faculty & Staff Support,2,2331,50,2021-05-06 14:05:07,2021-05-06 15:32:16.907458
4497,21678,1,21678,31,2331,31,10,1,10,Friendships,2,2331,50,2021-05-06 14:05:07,2021-05-06 15:32:16.907458
4498,21684,4,21684,16,2333,16,6,1,6,Life - School Balance,2,2333,54,2021-05-06 14:05:07,2021-05-06 14:37:08.663794
4499,21685,4,21685,21,2333,21,7,1,7,Discrimination,2,2333,54,2021-05-06 14:05:07,2021-05-06 14:37:08.663794
4500,21686,3,21686,23,2333,23,8,1,8,Financial Pressure,2,2333,54,2021-05-06 14:05:07,2021-05-06 14:37:08.663794
4501,21687,6,21687,29,2333,29,9,0,9,Faculty & Staff Support,2,2333,54,2021-05-06 14:05:07,2021-05-06 14:37:08.663794
4502,21688,5,21688,33,2333,33,10,0,10,Friendships,2,2333,54,2021-05-06 14:05:07,2021-05-06 14:37:08.663794
4503,21689,3,21689,16,2334,16,6,1,6,Life - School Balance,2,2334,55,2021-05-06 14:05:08,2021-05-06 16:47:58.746275
4504,21690,5,21690,19,2334,19,7,0,7,Discrimination,2,2334,55,2021-05-06 14:05:08,2021-05-06 16:47:58.746275
4505,21691,3,21691,25,2334,25,8,0,8,Financial Pressure,2,2334,55,2021-05-06 14:05:08,2021-05-06 16:47:58.746275
4506,21692,5,21692,29,2334,29,9,0,9,Faculty & Staff Support,2,2334,55,2021-05-06 14:05:08,2021-05-06 16:47:58.746275
4507,21693,4,21693,32,2334,32,10,1,10,Friendships,2,2334,55,2021-05-06 14:05:08,2021-05-06 16:47:58.746275
4508,21769,4,21769,16,2350,16,6,1,6,Life - School Balance,2,2350,74,2021-05-06 14:05:10,2021-05-06 14:06:21.495706
4509,21770,6,21770,20,2350,20,7,1,7,Discrimination,2,2350,74,2021-05-06 14:05:10,2021-05-06 14:06:21.495706
4510,21771,3,21771,25,2350,25,8,0,8,Financial Pressure,2,2350,74,2021-05-06 14:05:10,2021-05-06 14:06:21.495706
4511,21772,6,21772,29,2350,29,9,0,9,Faculty & Staff Support,2,2350,74,2021-05-06 14:05:10,2021-05-06 14:06:21.495706
4512,21773,6,21773,30,2350,30,10,1,10,Friendships,2,2350,74,2021-05-06 14:05:10,2021-05-06 14:06:21.495706
4513,21794,3,21794,16,2355,16,6,1,6,Life - School Balance,2,2355,79,2021-05-06 14:05:11,2021-05-06 15:12:27.844725
4514,21795,6,21795,19,2355,19,7,0,7,Discrimination,2,2355,79,2021-05-06 14:05:11,2021-05-06 15:12:27.844725
4515,21796,4,21796,25,2355,25,8,0,8,Financial Pressure,2,2355,79,2021-05-06 14:05:11,2021-05-06 15:12:27.844725
4516,21797,6,21797,28,2355,28,9,1,9,Faculty & Staff Support,2,2355,79,2021-05-06 14:05:11,2021-05-06 15:12:27.844725
4517,21798,5,21798,33,2355,33,10,0,10,Friendships,2,2355,79,2021-05-06 14:05:11,2021-05-06 15:12:27.844725
4518,21799,2,21799,16,2356,16,6,1,6,Life - School Balance,2,2356,84,2021-05-06 14:05:11,2021-05-06 14:14:44.036195
4519,21800,5,21800,20,2356,20,7,1,7,Discrimination,2,2356,84,2021-05-06 14:05:11,2021-05-06 14:14:44.036195
4520,21801,4,21801,24,2356,24,8,1,8,Financial Pressure,2,2356,84,2021-05-06 14:05:11,2021-05-06 14:14:44.036195
4521,21802,4,21802,26,2356,26,9,1,9,Faculty & Staff Support,2,2356,84,2021-05-06 14:05:11,2021-05-06 14:14:44.036195
4522,21803,4,21803,30,2356,30,10,1,10,Friendships,2,2356,84,2021-05-06 14:05:11,2021-05-06 14:14:44.036195
4523,21854,4,21854,16,2367,16,6,1,6,Life - School Balance,2,2367,96,2021-05-06 14:05:13,2021-05-06 14:56:06.528082
4524,21855,6,21855,21,2367,21,7,1,7,Discrimination,2,2367,96,2021-05-06 14:05:13,2021-05-06 14:56:06.528082
4525,21856,6,21856,25,2367,25,8,0,8,Financial Pressure,2,2367,96,2021-05-06 14:05:13,2021-05-06 14:56:06.528082
4526,21857,5,21857,26,2367,26,9,1,9,Faculty & Staff Support,2,2367,96,2021-05-06 14:05:13,2021-05-06 14:56:06.528082
4527,21858,5,21858,30,2367,30,10,1,10,Friendships,2,2367,96,2021-05-06 14:05:13,2021-05-06 14:56:06.528082
4528,2821,6,2821,1,750,1,1,1,1,Factor 1,1,750,1,2021-04-08 14:00:01,2021-04-08 15:36:37.915324
4529,2822,5,2822,2,750,2,2,1,2,Factor 2,1,750,1,2021-04-08 14:00:01,2021-04-08 15:36:37.915324
4530,2823,1,2823,13,750,13,3,1,3,Factor 3,1,750,1,2021-04-08 14:00:01,2021-04-08 15:36:37.915324
4533,20066,5,20066,1,2013,1,1,1,1,Factor 1,1,2013,2,2021-04-27 19:00:02,2021-04-27 20:08:15
4534,20067,2,20067,2,2013,2,2,1,2,Factor 2,1,2013,2,2021-04-27 19:00:02,2021-04-27 20:08:15
4538,20895,5,20895,1,2177,1,1,1,1,Factor 1,1,2177,1,2021-04-29 15:14:03,2021-05-02 04:44:25
4539,20896,5,20896,12,2177,12,2,1,2,Factor 2,1,2177,1,2021-04-29 15:14:03,2021-05-02 04:44:25
4540,20897,4,20897,13,2177,13,3,1,3,Factor 3,1,2177,1,2021-04-29 15:14:03,2021-05-02 04:44:25
4541,20898,5,20898,14,2177,14,4,1,4,Factor 4,1,2177,1,2021-04-29 15:14:03,2021-05-02 04:44:25
4542,20899,2,20899,5,2177,5,5,0,5,Factor 5,1,2177,1,2021-04-29 15:14:03,2021-05-02 04:44:25
4543,20920,5,20920,1,2182,1,1,1,1,Factor 1,1,2182,129,2021-04-29 15:14:04,2021-04-30 15:01:06.574412
4544,20921,6,20921,12,2182,12,2,1,2,Factor 2,1,2182,129,2021-04-29 15:14:04,2021-04-30 15:01:06.574412
4545,20922,4,20922,3,2182,3,3,1,3,Factor 3,1,2182,129,2021-04-29 15:14:04,2021-04-30 15:01:06.574412
4546,20923,4,20923,14,2182,14,4,1,4,Factor 4,1,2182,129,2021-04-29 15:14:04,2021-04-30 15:01:06.574412
4547,20924,6,20924,5,2182,5,5,0,5,Factor 5,1,2182,129,2021-04-29 15:14:04,2021-04-30 15:01:06.574412
4548,21499,4,21499,1,2296,1,1,1,1,Factor 1,1,2296,1,2021-05-06 14:00:02,2021-05-06 16:08:16.349152
4549,21500,4,21500,2,2296,2,2,1,2,Factor 2,1,2296,1,2021-05-06 14:00:02,2021-05-06 16:08:16.349152
4550,21501,4,21501,3,2296,3,3,1,3,Factor 3,1,2296,1,2021-05-06 14:00:02,2021-05-06 16:08:16.349152
4551,21502,2,21502,4,2296,4,4,1,4,Factor 4,1,2296,1,2021-05-06 14:00:02,2021-05-06 16:08:16.349152
4552,21503,1,21503,5,2296,5,5,0,5,Factor 5,1,2296,1,2021-05-06 14:00:02,2021-05-06 16:08:16.349152
4553,20905,2,20905,11,2179,11,1,1,1,Factor 1,1,2179,3,2021-04-29 15:14:04,2021-04-30 16:48:41.234652
4554,20906,5,20906,12,2179,12,2,1,2,Factor 2,1,2179,3,2021-04-29 15:14:04,2021-04-30 16:48:41.234652
4555,20907,2,20907,3,2179,3,3,1,3,Factor 3,1,2179,3,2021-04-29 15:14:04,2021-04-30 16:48:41.234652
4556,20908,4,20908,4,2179,4,4,1,4,Factor 4,1,2179,3,2021-04-29 15:14:04,2021-04-30 16:48:41.234652
4557,20909,2,20909,15,2179,15,5,1,5,Factor 5,1,2179,3,2021-04-29 15:14:04,2021-04-30 16:48:41.234652
4558,20915,6,20915,11,2181,11,1,1,1,Factor 1,1,2181,128,2021-04-29 15:14:04,2021-04-29 15:18:49.914443
4559,20916,5,20916,2,2181,2,2,1,2,Factor 2,1,2181,128,2021-04-29 15:14:04,2021-04-29 15:18:49.914443
4560,20917,4,20917,13,2181,13,3,1,3,Factor 3,1,2181,128,2021-04-29 15:14:04,2021-04-29 15:18:49.914443
4561,20918,4,20918,14,2181,14,4,1,4,Factor 4,1,2181,128,2021-04-29 15:14:04,2021-04-29 15:18:49.914443
4562,20919,4,20919,5,2181,5,5,0,5,Factor 5,1,2181,128,2021-04-29 15:14:04,2021-04-29 15:18:49.914443
4563,100433,5,100433,11,10088,11,1,1,1,Factor 1,1,10088,4,2021-06-08 19:00:02,2021-06-09 16:24:43.800836
4564,100434,2,100434,12,10088,12,2,1,2,Factor 2,1,10088,4,2021-06-08 19:00:02,2021-06-09 16:24:43.800836
4565,100435,5,100435,3,10088,3,3,1,3,Factor 3,1,10088,4,2021-06-08 19:00:02,2021-06-09 16:24:43.800836
4566,100436,2,100436,14,10088,14,4,1,4,Factor 4,1,10088,4,2021-06-08 19:00:02,2021-06-09 16:24:43.800836
4567,100437,3,100437,5,10088,5,5,0,5,Factor 5,1,10088,4,2021-06-08 19:00:02,2021-06-09 16:24:43.800836
4568,102094,5,102094,11,10439,11,1,1,1,Factor 1,1,10439,1,2021-07-15 14:00:01,2021-07-17 18:12:11.343048
4569,102095,2,102095,2,10439,2,2,1,2,Factor 2,1,10439,1,2021-07-15 14:00:01,2021-07-17 18:12:11.343048
4570,102096,5,102096,3,10439,3,3,1,3,Factor 3,1,10439,1,2021-07-15 14:00:01,2021-07-17 18:12:11.343048
4571,102097,2,102097,4,10439,4,4,1,4,Factor 4,1,10439,1,2021-07-15 14:00:01,2021-07-17 18:12:11.343048
4572,102098,2,102098,5,10439,5,5,0,5,Factor 5,1,10439,1,2021-07-15 14:00:01,2021-07-17 18:12:11.343048
4573,10004,4,10004,4,10000,4,4,1,4,Factor 4,1,10000,1,2021-06-01 04:10:52,2021-06-01 05:06:34.584912
4574,100001,5,100001,105,10000,105,24,0,24,Company Administration,5,10000,1,2021-06-01 04:10:52,2021-06-01 05:06:34.584912
4575,100002,2,100002,97,10000,97,23,0,23,Relationship with Co-workers,5,10000,1,2021-06-01 04:10:52,2021-06-01 05:06:34.584912
4576,100003,2,100003,92,10000,92,22,1,22,Benefits and Compensation,5,10000,1,2021-06-01 04:10:52,2021-06-01 05:06:34.584912
4577,4006,5,4006,37,987,37,11,1,11,Compensation and Benefits,3,987,2,2021-04-20 15:07:36,2021-04-20 15:08:12.015196
4578,4007,3,4007,43,987,43,12,1,12,Relationship with Co-Workers,3,987,2,2021-04-20 15:07:36,2021-04-20 15:08:12.015196
4579,4008,4,4008,49,987,49,13,1,13,General Satisfaction,3,987,2,2021-04-20 15:07:36,2021-04-20 15:08:12.015196
4580,4009,2,4009,54,987,54,14,1,14,Relationship with Supervisor,3,987,2,2021-04-20 15:07:36,2021-04-20 15:08:12.015196
4581,4010,4,4010,56,987,56,15,1,15,Company Administration,3,987,2,2021-04-20 15:07:36,2021-04-20 15:08:12.015196
4582,4016,5,4016,37,989,37,11,1,11,Compensation and Benefits,3,989,2,2021-04-20 18:00:02,2021-04-20 18:34:53.438854
4583,4017,4,4017,41,989,41,12,1,12,Relationship with Co-Workers,3,989,2,2021-04-20 18:00:02,2021-04-20 18:34:53.438854
4584,4018,5,4018,49,989,49,13,1,13,General Satisfaction,3,989,2,2021-04-20 18:00:02,2021-04-20 18:34:53.438854
4585,4019,3,4019,54,989,54,14,1,14,Relationship with Supervisor,3,989,2,2021-04-20 18:00:02,2021-04-20 18:34:53.438854
4586,4020,4,4020,57,989,57,15,1,15,Company Administration,3,989,2,2021-04-20 18:00:02,2021-04-20 18:34:53.438854
4587,4041,3,4041,37,994,37,11,1,11,Compensation and Benefits,3,994,111,2021-04-20 18:00:03,2021-04-20 18:48:47.155303
4588,4042,2,4042,39,994,39,12,1,12,Relationship with Co-Workers,3,994,111,2021-04-20 18:00:03,2021-04-20 18:48:47.155303
4589,4043,5,4043,47,994,47,13,1,13,General Satisfaction,3,994,111,2021-04-20 18:00:03,2021-04-20 18:48:47.155303
4590,4044,3,4044,53,994,53,14,1,14,Relationship with Supervisor,3,994,111,2021-04-20 18:00:03,2021-04-20 18:48:47.155303
4591,4045,2,4045,55,994,55,15,1,15,Company Administration,3,994,111,2021-04-20 18:00:03,2021-04-20 18:48:47.155303
4592,4051,5,4051,37,996,37,11,1,11,Compensation and Benefits,3,996,113,2021-04-20 18:00:03,2021-04-20 18:47:21.536945
4593,4052,4,4052,41,996,41,12,1,12,Relationship with Co-Workers,3,996,113,2021-04-20 18:00:03,2021-04-20 18:47:21.536945
4594,4053,2,4053,46,996,46,13,1,13,General Satisfaction,3,996,113,2021-04-20 18:00:03,2021-04-20 18:47:21.536945
4595,4054,4,4054,50,996,50,14,1,14,Relationship with Supervisor,3,996,113,2021-04-20 18:00:03,2021-04-20 18:47:21.536945
4596,4055,5,4055,58,996,58,15,1,15,Company Administration,3,996,113,2021-04-20 18:00:03,2021-04-20 18:47:21.536945
4597,4066,3,4066,37,999,37,11,1,11,Compensation and Benefits,3,999,116,2021-04-20 18:00:04,2021-04-20 18:39:51.085601
4598,4067,4,4067,43,999,43,12,1,12,Relationship with Co-Workers,3,999,116,2021-04-20 18:00:04,2021-04-20 18:39:51.085601
4599,4068,6,4068,49,999,49,13,1,13,General Satisfaction,3,999,116,2021-04-20 18:00:04,2021-04-20 18:39:51.085601
4600,4070,3,4070,57,999,57,15,1,15,Company Administration,3,999,116,2021-04-20 18:00:04,2021-04-20 18:39:51.085601
4601,4069,2,4069,51,999,51,15,1,15,Company Administration,3,999,116,2021-04-20 18:00:04,2021-04-20 18:39:51.085601
4602,20006,5,20006,37,2001,37,11,1,11,Compensation and Benefits,3,2001,107,2021-04-27 18:00:02,2021-04-27 18:14:26.297023
4603,20007,5,20007,40,2001,40,12,1,12,Relationship with Co-Workers,3,2001,107,2021-04-27 18:00:02,2021-04-27 18:14:26.297023
4604,20008,6,20008,46,2001,46,13,1,13,General Satisfaction,3,2001,107,2021-04-27 18:00:02,2021-04-27 18:14:26.297023
4605,20009,4,20009,54,2001,54,14,1,14,Relationship with Supervisor,3,2001,107,2021-04-27 18:00:02,2021-04-27 18:14:26.297023
4606,20010,3,20010,55,2001,55,15,1,15,Company Administration,3,2001,107,2021-04-27 18:00:02,2021-04-27 18:14:26.297023
4607,20026,4,20026,37,2005,37,11,1,11,Compensation and Benefits,3,2005,111,2021-04-27 18:00:03,2021-04-27 18:33:41.929829
4608,20027,3,20027,39,2005,39,12,1,12,Relationship with Co-Workers,3,2005,111,2021-04-27 18:00:03,2021-04-27 18:33:41.929829
4609,20028,4,20028,46,2005,46,13,1,13,General Satisfaction,3,2005,111,2021-04-27 18:00:03,2021-04-27 18:33:41.929829
4610,20030,5,20030,55,2005,55,15,1,15,Company Administration,3,2005,111,2021-04-27 18:00:03,2021-04-27 18:33:41.929829
4611,20029,5,20029,51,2005,51,15,1,15,Company Administration,3,2005,111,2021-04-27 18:00:03,2021-04-27 18:33:41.929829
4612,20945,3,20945,37,2187,37,11,1,11,Compensation and Benefits,3,2187,111,2021-04-29 18:00:03,2021-04-29 18:36:26.167493
4613,20946,4,20946,40,2187,40,12,1,12,Relationship with Co-Workers,3,2187,111,2021-04-29 18:00:03,2021-04-29 18:36:26.167493
4614,20947,4,20947,45,2187,45,13,1,13,General Satisfaction,3,2187,111,2021-04-29 18:00:03,2021-04-29 18:36:26.167493
4615,20948,2,20948,54,2187,54,14,1,14,Relationship with Supervisor,3,2187,111,2021-04-29 18:00:03,2021-04-29 18:36:26.167493
4616,20949,3,20949,58,2187,58,15,1,15,Company Administration,3,2187,111,2021-04-29 18:00:03,2021-04-29 18:36:26.167493
4617,20950,3,20950,37,2188,37,11,1,11,Compensation and Benefits,3,2188,112,2021-04-29 18:00:03,2021-04-29 18:33:34.666268
4618,20951,6,20951,42,2188,42,12,1,12,Relationship with Co-Workers,3,2188,112,2021-04-29 18:00:03,2021-04-29 18:33:34.666268
4619,20952,4,20952,48,2188,48,13,1,13,General Satisfaction,3,2188,112,2021-04-29 18:00:03,2021-04-29 18:33:34.666268
4620,20954,5,20954,58,2188,58,15,1,15,Company Administration,3,2188,112,2021-04-29 18:00:03,2021-04-29 18:33:34.666268
4621,20953,2,20953,52,2188,52,15,1,15,Company Administration,3,2188,112,2021-04-29 18:00:03,2021-04-29 18:33:34.666268
4622,20955,4,20955,37,2189,37,11,1,11,Compensation and Benefits,3,2189,113,2021-04-29 18:00:03,2021-04-29 18:33:55.640147
4623,20956,2,20956,40,2189,40,12,1,12,Relationship with Co-Workers,3,2189,113,2021-04-29 18:00:03,2021-04-29 18:33:55.640147
4624,20957,4,20957,48,2189,48,13,1,13,General Satisfaction,3,2189,113,2021-04-29 18:00:03,2021-04-29 18:33:55.640147
4625,20958,4,20958,54,2189,54,14,1,14,Relationship with Supervisor,3,2189,113,2021-04-29 18:00:03,2021-04-29 18:33:55.640147
4626,20959,3,20959,57,2189,57,15,1,15,Company Administration,3,2189,113,2021-04-29 18:00:03,2021-04-29 18:33:55.640147
4627,20960,4,20960,37,2190,37,11,1,11,Compensation and Benefits,3,2190,114,2021-04-29 18:00:03,2021-04-29 18:39:54.622592
4628,20961,3,20961,42,2190,42,12,1,12,Relationship with Co-Workers,3,2190,114,2021-04-29 18:00:03,2021-04-29 18:39:54.622592
4629,20962,3,20962,47,2190,47,13,1,13,General Satisfaction,3,2190,114,2021-04-29 18:00:03,2021-04-29 18:39:54.622592
4630,20963,4,20963,50,2190,50,14,1,14,Relationship with Supervisor,3,2190,114,2021-04-29 18:00:03,2021-04-29 18:39:54.622592
4631,20964,2,20964,57,2190,57,15,1,15,Company Administration,3,2190,114,2021-04-29 18:00:03,2021-04-29 18:39:54.622592
4632,21005,3,21005,37,2199,37,11,1,11,Compensation and Benefits,3,2199,111,2021-05-04 18:00:04,2021-05-04 18:25:25.822840
4633,21006,3,21006,39,2199,39,12,1,12,Relationship with Co-Workers,3,2199,111,2021-05-04 18:00:04,2021-05-04 18:25:25.822840
4634,21007,3,21007,46,2199,46,13,1,13,General Satisfaction,3,2199,111,2021-05-04 18:00:04,2021-05-04 18:25:25.822840
4635,21009,6,21009,55,2199,55,15,1,15,Company Administration,3,2199,111,2021-05-04 18:00:04,2021-05-04 18:25:25.822840
4636,21008,4,21008,52,2199,52,15,1,15,Company Administration,3,2199,111,2021-05-04 18:00:04,2021-05-04 18:25:25.822840
4637,21030,3,21030,37,2204,37,11,1,11,Compensation and Benefits,3,2204,116,2021-05-04 18:00:05,2021-05-04 18:54:01.159667
4638,21031,4,21031,41,2204,41,12,1,12,Relationship with Co-Workers,3,2204,116,2021-05-04 18:00:05,2021-05-04 18:54:01.159667
4639,21032,4,21032,45,2204,45,13,1,13,General Satisfaction,3,2204,116,2021-05-04 18:00:05,2021-05-04 18:54:01.159667
4640,21033,4,21033,54,2204,54,14,1,14,Relationship with Supervisor,3,2204,116,2021-05-04 18:00:05,2021-05-04 18:54:01.159667
4641,21034,4,21034,56,2204,56,15,1,15,Company Administration,3,2204,116,2021-05-04 18:00:05,2021-05-04 18:54:01.159667
4642,21035,5,21035,37,2205,37,11,1,11,Compensation and Benefits,3,2205,117,2021-05-04 18:00:05,2021-05-04 18:22:55.102808
4643,21036,5,21036,40,2205,40,12,1,12,Relationship with Co-Workers,3,2205,117,2021-05-04 18:00:05,2021-05-04 18:22:55.102808
4644,21039,5,21039,58,2205,58,15,1,15,Company Administration,3,2205,117,2021-05-04 18:00:05,2021-05-04 18:22:55.102808
4645,21037,2,21037,44,2205,44,15,1,15,Company Administration,3,2205,117,2021-05-04 18:00:05,2021-05-04 18:22:55.102808
4646,21038,5,21038,51,2205,51,15,1,15,Company Administration,3,2205,117,2021-05-04 18:00:05,2021-05-04 18:22:55.102808
4647,21899,4,21899,37,2376,37,11,1,11,Compensation and Benefits,3,2376,107,2021-05-06 18:00:02,2021-05-06 18:39:43.183051
4648,21900,4,21900,41,2376,41,12,1,12,Relationship with Co-Workers,3,2376,107,2021-05-06 18:00:02,2021-05-06 18:39:43.183051
4649,21902,3,21902,53,2376,53,14,1,14,Relationship with Supervisor,3,2376,107,2021-05-06 18:00:02,2021-05-06 18:39:43.183051
4650,21901,3,21901,44,2376,44,15,1,15,Company Administration,3,2376,107,2021-05-06 18:00:02,2021-05-06 18:39:43.183051
4651,21903,3,21903,55,2376,55,15,1,15,Company Administration,3,2376,107,2021-05-06 18:00:02,2021-05-06 18:39:43.183051
4652,21919,3,21919,37,2380,37,11,1,11,Compensation and Benefits,3,2380,111,2021-05-06 18:00:03,2021-05-06 18:42:12.066478
4653,21920,4,21920,41,2380,41,12,1,12,Relationship with Co-Workers,3,2380,111,2021-05-06 18:00:03,2021-05-06 18:42:12.066478
4654,21921,4,21921,45,2380,45,13,1,13,General Satisfaction,3,2380,111,2021-05-06 18:00:03,2021-05-06 18:42:12.066478
4655,21923,5,21923,55,2380,55,15,1,15,Company Administration,3,2380,111,2021-05-06 18:00:03,2021-05-06 18:42:12.066478
4656,21922,2,21922,52,2380,52,15,1,15,Company Administration,3,2380,111,2021-05-06 18:00:03,2021-05-06 18:42:12.066478
4657,21929,4,21929,37,2382,37,11,1,11,Compensation and Benefits,3,2382,113,2021-05-06 18:00:04,2021-05-06 18:45:58.855837
4658,21930,1,21930,42,2382,42,12,1,12,Relationship with Co-Workers,3,2382,113,2021-05-06 18:00:04,2021-05-06 18:45:58.855837
4659,21931,3,21931,48,2382,48,13,1,13,General Satisfaction,3,2382,113,2021-05-06 18:00:04,2021-05-06 18:45:58.855837
4660,21932,2,21932,50,2382,50,14,1,14,Relationship with Supervisor,3,2382,113,2021-05-06 18:00:04,2021-05-06 18:45:58.855837
4661,21933,5,21933,56,2382,56,15,1,15,Company Administration,3,2382,113,2021-05-06 18:00:04,2021-05-06 18:45:58.855837
4662,21959,5,21959,37,2388,37,11,1,11,Compensation and Benefits,3,2388,107,2021-05-11 18:00:02,2021-05-11 18:32:01.484356
4663,21960,4,21960,41,2388,41,12,1,12,Relationship with Co-Workers,3,2388,107,2021-05-11 18:00:02,2021-05-11 18:32:01.484356
4664,21961,5,21961,47,2388,47,13,1,13,General Satisfaction,3,2388,107,2021-05-11 18:00:02,2021-05-11 18:32:01.484356
4665,21963,3,21963,55,2388,55,15,1,15,Company Administration,3,2388,107,2021-05-11 18:00:02,2021-05-11 18:32:01.484356
4666,21962,5,21962,52,2388,52,15,1,15,Company Administration,3,2388,107,2021-05-11 18:00:02,2021-05-11 18:32:01.484356
4667,22014,6,22014,37,2399,37,11,1,11,Compensation and Benefits,3,2399,118,2021-05-11 18:00:06,2021-05-11 18:45:56.440915
4668,22015,4,22015,40,2399,40,12,1,12,Relationship with Co-Workers,3,2399,118,2021-05-11 18:00:06,2021-05-11 18:45:56.440915
4669,22016,4,22016,45,2399,45,13,1,13,General Satisfaction,3,2399,118,2021-05-11 18:00:06,2021-05-11 18:45:56.440915
4670,22017,1,22017,53,2399,53,14,1,14,Relationship with Supervisor,3,2399,118,2021-05-11 18:00:06,2021-05-11 18:45:56.440915
4671,22018,3,22018,57,2399,57,15,1,15,Company Administration,3,2399,118,2021-05-11 18:00:06,2021-05-11 18:45:56.440915
4672,22123,5,22123,37,2419,37,11,1,11,Compensation and Benefits,3,2419,109,2021-05-13 18:00:02,2021-05-13 18:33:21.276589
4673,22124,4,22124,40,2419,40,12,1,12,Relationship with Co-Workers,3,2419,109,2021-05-13 18:00:02,2021-05-13 18:33:21.276589
4674,22125,5,22125,45,2419,45,13,1,13,General Satisfaction,3,2419,109,2021-05-13 18:00:02,2021-05-13 18:33:21.276589
4675,22127,2,22127,56,2419,56,15,1,15,Company Administration,3,2419,109,2021-05-13 18:00:02,2021-05-13 18:33:21.276589
4676,22126,5,22126,51,2419,51,15,1,15,Company Administration,3,2419,109,2021-05-13 18:00:02,2021-05-13 18:33:21.276589
4677,22198,3,22198,37,2434,37,11,1,11,Compensation and Benefits,3,2434,112,2021-05-18 18:00:04,2021-05-18 18:41:15.432367
4678,22199,2,22199,40,2434,40,12,1,12,Relationship with Co-Workers,3,2434,112,2021-05-18 18:00:04,2021-05-18 18:41:15.432367
4679,22200,1,22200,47,2434,47,13,1,13,General Satisfaction,3,2434,112,2021-05-18 18:00:04,2021-05-18 18:41:15.432367
4680,22202,1,22202,58,2434,58,15,1,15,Company Administration,3,2434,112,2021-05-18 18:00:04,2021-05-18 18:41:15.432367
4681,22201,1,22201,52,2434,52,15,1,15,Company Administration,3,2434,112,2021-05-18 18:00:04,2021-05-18 18:41:15.432367
4682,22442,4,22442,37,2481,37,11,1,11,Compensation and Benefits,3,2481,118,2021-05-25 18:00:03,2021-05-25 18:45:00.019197
4683,22443,3,22443,41,2481,41,12,1,12,Relationship with Co-Workers,3,2481,118,2021-05-25 18:00:03,2021-05-25 18:45:00.019197
4684,22444,5,22444,49,2481,49,13,1,13,General Satisfaction,3,2481,118,2021-05-25 18:00:03,2021-05-25 18:45:00.019197
4685,22445,4,22445,50,2481,50,14,1,14,Relationship with Supervisor,3,2481,118,2021-05-25 18:00:03,2021-05-25 18:45:00.019197
4686,22446,5,22446,55,2481,55,15,1,15,Company Administration,3,2481,118,2021-05-25 18:00:03,2021-05-25 18:45:00.019197
4687,22556,2,22556,37,2502,37,11,1,11,Compensation and Benefits,3,2502,110,2021-05-27 18:00:02,2021-05-27 18:29:46.053537
4688,22557,5,22557,41,2502,41,12,1,12,Relationship with Co-Workers,3,2502,110,2021-05-27 18:00:02,2021-05-27 18:29:46.053537
4689,22558,1,22558,46,2502,46,13,1,13,General Satisfaction,3,2502,110,2021-05-27 18:00:02,2021-05-27 18:29:46.053537
4690,22560,6,22560,55,2502,55,15,1,15,Company Administration,3,2502,110,2021-05-27 18:00:02,2021-05-27 18:29:46.053537
4691,22559,1,22559,51,2502,51,15,1,15,Company Administration,3,2502,110,2021-05-27 18:00:02,2021-05-27 18:29:46.053537
4692,22576,4,22576,37,2506,37,11,1,11,Compensation and Benefits,3,2506,114,2021-05-27 18:00:03,2021-05-27 18:41:39.417658
4693,22577,3,22577,39,2506,39,12,1,12,Relationship with Co-Workers,3,2506,114,2021-05-27 18:00:03,2021-05-27 18:41:39.417658
4694,22578,5,22578,48,2506,48,13,1,13,General Satisfaction,3,2506,114,2021-05-27 18:00:03,2021-05-27 18:41:39.417658
4695,22580,3,22580,58,2506,58,15,1,15,Company Administration,3,2506,114,2021-05-27 18:00:03,2021-05-27 18:41:39.417658
4696,22579,3,22579,52,2506,52,15,1,15,Company Administration,3,2506,114,2021-05-27 18:00:03,2021-05-27 18:41:39.417658
4697,22596,4,22596,37,2510,37,11,1,11,Compensation and Benefits,3,2510,118,2021-05-27 18:00:04,2021-05-27 20:28:24.499479
4698,22597,3,22597,42,2510,42,12,1,12,Relationship with Co-Workers,3,2510,118,2021-05-27 18:00:04,2021-05-27 20:28:24.499479
4699,22598,4,22598,49,2510,49,13,1,13,General Satisfaction,3,2510,118,2021-05-27 18:00:04,2021-05-27 20:28:24.499479
4700,22599,3,22599,53,2510,53,14,1,14,Relationship with Supervisor,3,2510,118,2021-05-27 18:00:04,2021-05-27 20:28:24.499479
4701,22600,5,22600,56,2510,56,15,1,15,Company Administration,3,2510,118,2021-05-27 18:00:04,2021-05-27 20:28:24.499479
4702,100202,6,100202,37,10037,37,11,1,11,Compensation and Benefits,3,10037,107,2021-06-03 18:00:01,2021-06-03 18:21:35.350464
4703,100203,4,100203,39,10037,39,12,1,12,Relationship with Co-Workers,3,10037,107,2021-06-03 18:00:01,2021-06-03 18:21:35.350464
4704,100205,2,100205,53,10037,53,14,1,14,Relationship with Supervisor,3,10037,107,2021-06-03 18:00:01,2021-06-03 18:21:35.350464
4705,100206,3,100206,56,10037,56,15,1,15,Company Administration,3,10037,107,2021-06-03 18:00:01,2021-06-03 18:21:35.350464
4706,100204,4,100204,44,10037,44,15,1,15,Company Administration,3,10037,107,2021-06-03 18:00:01,2021-06-03 18:21:35.350464
4707,100207,5,100207,37,10038,37,11,1,11,Compensation and Benefits,3,10038,108,2021-06-03 18:00:02,2021-06-03 18:40:52.003480
4708,100208,4,100208,42,10038,42,12,1,12,Relationship with Co-Workers,3,10038,108,2021-06-03 18:00:02,2021-06-03 18:40:52.003480
4709,100209,4,100209,49,10038,49,13,1,13,General Satisfaction,3,10038,108,2021-06-03 18:00:02,2021-06-03 18:40:52.003480
4710,100210,2,100210,54,10038,54,14,1,14,Relationship with Supervisor,3,10038,108,2021-06-03 18:00:02,2021-06-03 18:40:52.003480
4711,100211,5,100211,58,10038,58,15,1,15,Company Administration,3,10038,108,2021-06-03 18:00:02,2021-06-03 18:40:52.003480
4712,100383,1,100383,37,10078,37,11,1,11,Compensation and Benefits,3,10078,112,2021-06-08 18:00:02,2021-06-09 02:04:09.565435
4713,100384,1,100384,40,10078,40,12,1,12,Relationship with Co-Workers,3,10078,112,2021-06-08 18:00:02,2021-06-09 02:04:09.565435
4714,100385,1,100385,49,10078,49,13,1,13,General Satisfaction,3,10078,112,2021-06-08 18:00:02,2021-06-09 02:04:09.565435
4715,100386,1,100386,53,10078,53,14,1,14,Relationship with Supervisor,3,10078,112,2021-06-08 18:00:02,2021-06-09 02:04:09.565435
4716,100387,1,100387,57,10078,57,15,1,15,Company Administration,3,10078,112,2021-06-08 18:00:02,2021-06-09 02:04:09.565435
4717,100408,5,100408,37,10083,37,11,1,11,Compensation and Benefits,3,10083,117,2021-06-08 18:00:03,2021-06-08 21:45:59.921209
4718,100409,5,100409,40,10083,40,12,1,12,Relationship with Co-Workers,3,10083,117,2021-06-08 18:00:03,2021-06-08 21:45:59.921209
4719,100410,5,100410,48,10083,48,13,1,13,General Satisfaction,3,10083,117,2021-06-08 18:00:03,2021-06-08 21:45:59.921209
4720,100412,5,100412,58,10083,58,15,1,15,Company Administration,3,10083,117,2021-06-08 18:00:03,2021-06-08 21:45:59.921209
4721,100411,2,100411,52,10083,52,15,1,15,Company Administration,3,10083,117,2021-06-08 18:00:03,2021-06-08 21:45:59.921209
4722,100413,4,100413,37,10084,37,11,1,11,Compensation and Benefits,3,10084,118,2021-06-08 18:00:04,2021-06-08 18:45:31.553070
4723,100414,4,100414,39,10084,39,12,1,12,Relationship with Co-Workers,3,10084,118,2021-06-08 18:00:04,2021-06-08 18:45:31.553070
4724,100415,3,100415,46,10084,46,13,1,13,General Satisfaction,3,10084,118,2021-06-08 18:00:04,2021-06-08 18:45:31.553070
4725,100417,4,100417,55,10084,55,15,1,15,Company Administration,3,10084,118,2021-06-08 18:00:04,2021-06-08 18:45:31.553070
4726,100416,5,100416,52,10084,52,15,1,15,Company Administration,3,10084,118,2021-06-08 18:00:04,2021-06-08 18:45:31.553070
4727,100629,1,100629,37,10130,37,11,1,11,Compensation and Benefits,3,10130,112,2021-06-10 18:00:03,2021-06-10 18:05:59.316659
4728,100630,1,100630,39,10130,39,12,1,12,Relationship with Co-Workers,3,10130,112,2021-06-10 18:00:03,2021-06-10 18:05:59.316659
4729,100631,1,100631,49,10130,49,13,1,13,General Satisfaction,3,10130,112,2021-06-10 18:00:03,2021-06-10 18:05:59.316659
4730,100632,1,100632,54,10130,54,14,1,14,Relationship with Supervisor,3,10130,112,2021-06-10 18:00:03,2021-06-10 18:05:59.316659
4731,100633,1,100633,58,10130,58,15,1,15,Company Administration,3,10130,112,2021-06-10 18:00:03,2021-06-10 18:05:59.316659
4732,100634,3,100634,37,10131,37,11,1,11,Compensation and Benefits,3,10131,113,2021-06-10 18:00:03,2021-06-10 18:36:25.164855
4733,100635,5,100635,43,10131,43,12,1,12,Relationship with Co-Workers,3,10131,113,2021-06-10 18:00:03,2021-06-10 18:36:25.164855
4734,100636,5,100636,45,10131,45,13,1,13,General Satisfaction,3,10131,113,2021-06-10 18:00:03,2021-06-10 18:36:25.164855
4735,100637,4,100637,53,10131,53,14,1,14,Relationship with Supervisor,3,10131,113,2021-06-10 18:00:03,2021-06-10 18:36:25.164855
4736,100638,6,100638,56,10131,56,15,1,15,Company Administration,3,10131,113,2021-06-10 18:00:03,2021-06-10 18:36:25.164855
4737,100664,5,100664,37,10137,37,11,1,11,Compensation and Benefits,3,10137,107,2021-06-15 18:00:02,2021-06-15 18:01:14.894229
4738,100665,4,100665,41,10137,41,12,1,12,Relationship with Co-Workers,3,10137,107,2021-06-15 18:00:02,2021-06-15 18:01:14.894229
4739,100666,5,100666,45,10137,45,13,1,13,General Satisfaction,3,10137,107,2021-06-15 18:00:02,2021-06-15 18:01:14.894229
4740,100668,5,100668,57,10137,57,15,1,15,Company Administration,3,10137,107,2021-06-15 18:00:02,2021-06-15 18:01:14.894229
4741,100667,5,100667,51,10137,51,15,1,15,Company Administration,3,10137,107,2021-06-15 18:00:02,2021-06-15 18:01:14.894229
4742,100674,4,100674,37,10139,37,11,1,11,Compensation and Benefits,3,10139,109,2021-06-15 18:00:04,2021-06-15 18:00:52.613870
4743,100675,4,100675,41,10139,41,12,1,12,Relationship with Co-Workers,3,10139,109,2021-06-15 18:00:04,2021-06-15 18:00:52.613870
4744,100676,1,100676,46,10139,46,13,1,13,General Satisfaction,3,10139,109,2021-06-15 18:00:04,2021-06-15 18:00:52.613870
4745,100677,3,100677,50,10139,50,14,1,14,Relationship with Supervisor,3,10139,109,2021-06-15 18:00:04,2021-06-15 18:00:52.613870
4746,100678,3,100678,58,10139,58,15,1,15,Company Administration,3,10139,109,2021-06-15 18:00:04,2021-06-15 18:00:52.613870
4747,100714,5,100714,37,10147,37,11,1,11,Compensation and Benefits,3,10147,117,2021-06-15 18:00:05,2021-06-15 18:00:55.540476
4748,100715,2,100715,42,10147,42,12,1,12,Relationship with Co-Workers,3,10147,117,2021-06-15 18:00:05,2021-06-15 18:00:55.540476
4749,100716,5,100716,45,10147,45,13,1,13,General Satisfaction,3,10147,117,2021-06-15 18:00:05,2021-06-15 18:00:55.540476
4750,100717,1,100717,54,10147,54,14,1,14,Relationship with Supervisor,3,10147,117,2021-06-15 18:00:05,2021-06-15 18:00:55.540476
4751,100718,1,100718,56,10147,56,15,1,15,Company Administration,3,10147,117,2021-06-15 18:00:05,2021-06-15 18:00:55.540476
4752,100918,4,100918,37,10191,37,11,1,11,Compensation and Benefits,3,10191,107,2021-06-17 18:00:01,2021-06-17 19:43:22.276549
4753,100919,4,100919,41,10191,41,12,1,12,Relationship with Co-Workers,3,10191,107,2021-06-17 18:00:01,2021-06-17 19:43:22.276549
4754,100921,3,100921,53,10191,53,14,1,14,Relationship with Supervisor,3,10191,107,2021-06-17 18:00:01,2021-06-17 19:43:22.276549
4755,100922,4,100922,58,10191,58,15,1,15,Company Administration,3,10191,107,2021-06-17 18:00:01,2021-06-17 19:43:22.276549
4756,100920,3,100920,44,10191,44,15,1,15,Company Administration,3,10191,107,2021-06-17 18:00:01,2021-06-17 19:43:22.276549
4757,100938,4,100938,37,10195,37,11,1,11,Compensation and Benefits,3,10195,111,2021-06-17 18:00:02,2021-06-17 19:39:27.265868
4758,100939,5,100939,43,10195,43,12,1,12,Relationship with Co-Workers,3,10195,111,2021-06-17 18:00:02,2021-06-17 19:39:27.265868
4759,100940,3,100940,46,10195,46,13,1,13,General Satisfaction,3,10195,111,2021-06-17 18:00:02,2021-06-17 19:39:27.265868
4760,100941,5,100941,54,10195,54,14,1,14,Relationship with Supervisor,3,10195,111,2021-06-17 18:00:02,2021-06-17 19:39:27.265868
4761,100942,2,100942,58,10195,58,15,1,15,Company Administration,3,10195,111,2021-06-17 18:00:02,2021-06-17 19:39:27.265868
4762,100968,5,100968,37,10201,37,11,1,11,Compensation and Benefits,3,10201,117,2021-06-17 18:00:03,2021-06-17 18:01:07.817887
4763,100969,2,100969,43,10201,43,12,1,12,Relationship with Co-Workers,3,10201,117,2021-06-17 18:00:03,2021-06-17 18:01:07.817887
4764,100970,4,100970,46,10201,46,13,1,13,General Satisfaction,3,10201,117,2021-06-17 18:00:03,2021-06-17 18:01:07.817887
4765,100972,2,100972,56,10201,56,15,1,15,Company Administration,3,10201,117,2021-06-17 18:00:03,2021-06-17 18:01:07.817887
4766,100971,5,100971,51,10201,51,15,1,15,Company Administration,3,10201,117,2021-06-17 18:00:03,2021-06-17 18:01:07.817887
4767,100973,5,100973,37,10202,37,11,1,11,Compensation and Benefits,3,10202,118,2021-06-17 18:00:03,2021-06-17 18:44:23.638563
4768,100974,4,100974,42,10202,42,12,1,12,Relationship with Co-Workers,3,10202,118,2021-06-17 18:00:03,2021-06-17 18:44:23.638563
4769,100975,5,100975,48,10202,48,13,1,13,General Satisfaction,3,10202,118,2021-06-17 18:00:03,2021-06-17 18:44:23.638563
4770,100976,4,100976,53,10202,53,14,1,14,Relationship with Supervisor,3,10202,118,2021-06-17 18:00:03,2021-06-17 18:44:23.638563
4771,100977,4,100977,56,10202,56,15,1,15,Company Administration,3,10202,118,2021-06-17 18:00:03,2021-06-17 18:44:23.638563
4772,100993,3,100993,37,10206,37,11,1,11,Compensation and Benefits,3,10206,110,2021-06-22 18:00:03,2021-06-22 18:22:19.707491
4773,100994,2,100994,43,10206,43,12,1,12,Relationship with Co-Workers,3,10206,110,2021-06-22 18:00:03,2021-06-22 18:22:19.707491
4774,100995,1,100995,46,10206,46,13,1,13,General Satisfaction,3,10206,110,2021-06-22 18:00:03,2021-06-22 18:22:19.707491
4775,100996,2,100996,53,10206,53,14,1,14,Relationship with Supervisor,3,10206,110,2021-06-22 18:00:03,2021-06-22 18:22:19.707491
4776,100997,6,100997,55,10206,55,15,1,15,Company Administration,3,10206,110,2021-06-22 18:00:03,2021-06-22 18:22:19.707491
4777,101008,4,101008,37,10209,37,11,1,11,Compensation and Benefits,3,10209,113,2021-06-22 18:00:04,2021-06-22 18:39:38.037776
4778,101009,5,101009,43,10209,43,12,1,12,Relationship with Co-Workers,3,10209,113,2021-06-22 18:00:04,2021-06-22 18:39:38.037776
4779,101010,4,101010,48,10209,48,13,1,13,General Satisfaction,3,10209,113,2021-06-22 18:00:04,2021-06-22 18:39:38.037776
4780,101011,2,101011,53,10209,53,14,1,14,Relationship with Supervisor,3,10209,113,2021-06-22 18:00:04,2021-06-22 18:39:38.037776
4781,101012,1,101012,57,10209,57,15,1,15,Company Administration,3,10209,113,2021-06-22 18:00:04,2021-06-22 18:39:38.037776
4782,101018,4,101018,37,10211,37,11,1,11,Compensation and Benefits,3,10211,115,2021-06-22 18:00:04,2021-06-22 18:03:53.531064
4783,101019,2,101019,43,10211,43,12,1,12,Relationship with Co-Workers,3,10211,115,2021-06-22 18:00:04,2021-06-22 18:03:53.531064
4784,101021,2,101021,54,10211,54,14,1,14,Relationship with Supervisor,3,10211,115,2021-06-22 18:00:04,2021-06-22 18:03:53.531064
4785,101022,4,101022,57,10211,57,15,1,15,Company Administration,3,10211,115,2021-06-22 18:00:04,2021-06-22 18:03:53.531064
4786,101020,2,101020,44,10211,44,15,1,15,Company Administration,3,10211,115,2021-06-22 18:00:04,2021-06-22 18:03:53.531064
4787,101237,4,101237,37,10258,37,11,1,11,Compensation and Benefits,3,10258,108,2021-06-24 18:00:02,2021-06-24 18:01:07.431197
4788,101238,3,101238,42,10258,42,12,1,12,Relationship with Co-Workers,3,10258,108,2021-06-24 18:00:02,2021-06-24 18:01:07.431197
4789,101240,4,101240,50,10258,50,14,1,14,Relationship with Supervisor,3,10258,108,2021-06-24 18:00:02,2021-06-24 18:01:07.431197
4790,101241,4,101241,58,10258,58,15,1,15,Company Administration,3,10258,108,2021-06-24 18:00:02,2021-06-24 18:01:07.431197
4791,101239,3,101239,44,10258,44,15,1,15,Company Administration,3,10258,108,2021-06-24 18:00:02,2021-06-24 18:01:07.431197
4792,101242,5,101242,37,10259,37,11,1,11,Compensation and Benefits,3,10259,109,2021-06-24 18:00:02,2021-06-24 18:00:36.720383
4793,101243,4,101243,39,10259,39,12,1,12,Relationship with Co-Workers,3,10259,109,2021-06-24 18:00:02,2021-06-24 18:00:36.720383
4794,101244,5,101244,48,10259,48,13,1,13,General Satisfaction,3,10259,109,2021-06-24 18:00:02,2021-06-24 18:00:36.720383
4795,101245,3,101245,54,10259,54,14,1,14,Relationship with Supervisor,3,10259,109,2021-06-24 18:00:02,2021-06-24 18:00:36.720383
4796,101246,4,101246,58,10259,58,15,1,15,Company Administration,3,10259,109,2021-06-24 18:00:02,2021-06-24 18:00:36.720383
4797,101257,2,101257,37,10262,37,11,1,11,Compensation and Benefits,3,10262,112,2021-06-24 18:00:03,2021-06-24 18:00:28.896105
4798,101258,2,101258,41,10262,41,12,1,12,Relationship with Co-Workers,3,10262,112,2021-06-24 18:00:03,2021-06-24 18:00:28.896105
4799,101259,1,101259,48,10262,48,13,1,13,General Satisfaction,3,10262,112,2021-06-24 18:00:03,2021-06-24 18:00:28.896105
4800,101260,1,101260,50,10262,50,14,1,14,Relationship with Supervisor,3,10262,112,2021-06-24 18:00:03,2021-06-24 18:00:28.896105
4801,101261,1,101261,58,10262,58,15,1,15,Company Administration,3,10262,112,2021-06-24 18:00:03,2021-06-24 18:00:28.896105
4802,101267,4,101267,37,10264,37,11,1,11,Compensation and Benefits,3,10264,114,2021-06-24 18:00:03,2021-06-24 18:47:55.714813
4803,101268,4,101268,42,10264,42,12,1,12,Relationship with Co-Workers,3,10264,114,2021-06-24 18:00:03,2021-06-24 18:47:55.714813
4804,101270,4,101270,53,10264,53,14,1,14,Relationship with Supervisor,3,10264,114,2021-06-24 18:00:03,2021-06-24 18:47:55.714813
4805,101269,4,101269,44,10264,44,15,1,15,Company Administration,3,10264,114,2021-06-24 18:00:03,2021-06-24 18:47:55.714813
4806,101271,5,101271,55,10264,55,15,1,15,Company Administration,3,10264,114,2021-06-24 18:00:03,2021-06-24 18:47:55.714813
4807,101327,5,101327,37,10276,37,11,1,11,Compensation and Benefits,3,10276,114,2021-06-29 18:00:04,2021-06-29 18:33:07.664131
4808,101328,4,101328,43,10276,43,12,1,12,Relationship with Co-Workers,3,10276,114,2021-06-29 18:00:04,2021-06-29 18:33:07.664131
4809,101329,5,101329,45,10276,45,13,1,13,General Satisfaction,3,10276,114,2021-06-29 18:00:04,2021-06-29 18:33:07.664131
4810,101330,4,101330,54,10276,54,14,1,14,Relationship with Supervisor,3,10276,114,2021-06-29 18:00:04,2021-06-29 18:33:07.664131
4811,101331,3,101331,57,10276,57,15,1,15,Company Administration,3,10276,114,2021-06-29 18:00:04,2021-06-29 18:33:07.664131
4812,101337,1,101337,37,10278,37,11,1,11,Compensation and Benefits,3,10278,116,2021-06-29 18:00:04,2021-06-29 18:32:13.591620
4813,101338,4,101338,43,10278,43,12,1,12,Relationship with Co-Workers,3,10278,116,2021-06-29 18:00:04,2021-06-29 18:32:13.591620
4814,101339,3,101339,46,10278,46,13,1,13,General Satisfaction,3,10278,116,2021-06-29 18:00:04,2021-06-29 18:32:13.591620
4815,101340,3,101340,50,10278,50,14,1,14,Relationship with Supervisor,3,10278,116,2021-06-29 18:00:04,2021-06-29 18:32:13.591620
4816,101341,3,101341,57,10278,57,15,1,15,Company Administration,3,10278,116,2021-06-29 18:00:04,2021-06-29 18:32:13.591620
4817,101347,4,101347,37,10280,37,11,1,11,Compensation and Benefits,3,10280,118,2021-06-29 18:00:04,2021-06-29 18:33:22.911793
4818,101348,4,101348,43,10280,43,12,1,12,Relationship with Co-Workers,3,10280,118,2021-06-29 18:00:04,2021-06-29 18:33:22.911793
4819,101350,4,101350,50,10280,50,14,1,14,Relationship with Supervisor,3,10280,118,2021-06-29 18:00:04,2021-06-29 18:33:22.911793
4820,101351,3,101351,58,10280,58,15,1,15,Company Administration,3,10280,118,2021-06-29 18:00:04,2021-06-29 18:33:22.911793
4821,101349,3,101349,44,10280,44,15,1,15,Company Administration,3,10280,118,2021-06-29 18:00:04,2021-06-29 18:33:22.911793
4822,101556,2,101556,37,10325,37,11,1,11,Compensation and Benefits,3,10325,109,2021-07-01 18:00:02,2021-07-01 18:01:08.725799
4823,101557,4,101557,42,10325,42,12,1,12,Relationship with Co-Workers,3,10325,109,2021-07-01 18:00:02,2021-07-01 18:01:08.725799
4824,101558,4,101558,49,10325,49,13,1,13,General Satisfaction,3,10325,109,2021-07-01 18:00:02,2021-07-01 18:01:08.725799
4825,101560,3,101560,56,10325,56,15,1,15,Company Administration,3,10325,109,2021-07-01 18:00:02,2021-07-01 18:01:08.725799
4826,101559,4,101559,51,10325,51,15,1,15,Company Administration,3,10325,109,2021-07-01 18:00:02,2021-07-01 18:01:08.725799
4827,101586,6,101586,37,10331,37,11,1,11,Compensation and Benefits,3,10331,115,2021-07-01 18:00:04,2021-07-01 18:03:24.521760
4828,101587,6,101587,39,10331,39,12,1,12,Relationship with Co-Workers,3,10331,115,2021-07-01 18:00:04,2021-07-01 18:03:24.521760
4829,101588,6,101588,47,10331,47,13,1,13,General Satisfaction,3,10331,115,2021-07-01 18:00:04,2021-07-01 18:03:24.521760
4830,101589,1,101589,54,10331,54,14,1,14,Relationship with Supervisor,3,10331,115,2021-07-01 18:00:04,2021-07-01 18:03:24.521760
4831,101590,1,101590,56,10331,56,15,1,15,Company Administration,3,10331,115,2021-07-01 18:00:04,2021-07-01 18:03:24.521760
4832,101591,2,101591,37,10332,37,11,1,11,Compensation and Benefits,3,10332,116,2021-07-01 18:00:04,2021-07-01 18:33:07.177364
4833,101592,3,101592,39,10332,39,12,1,12,Relationship with Co-Workers,3,10332,116,2021-07-01 18:00:04,2021-07-01 18:33:07.177364
4834,101593,4,101593,49,10332,49,13,1,13,General Satisfaction,3,10332,116,2021-07-01 18:00:04,2021-07-01 18:33:07.177364
4835,101595,3,101595,57,10332,57,15,1,15,Company Administration,3,10332,116,2021-07-01 18:00:04,2021-07-01 18:33:07.177364
4836,101594,3,101594,51,10332,51,15,1,15,Company Administration,3,10332,116,2021-07-01 18:00:04,2021-07-01 18:33:07.177364
4837,101596,5,101596,37,10333,37,11,1,11,Compensation and Benefits,3,10333,117,2021-07-01 18:00:04,2021-07-01 18:41:16.674424
4838,101597,4,101597,39,10333,39,12,1,12,Relationship with Co-Workers,3,10333,117,2021-07-01 18:00:04,2021-07-01 18:41:16.674424
4839,101598,5,101598,45,10333,45,13,1,13,General Satisfaction,3,10333,117,2021-07-01 18:00:04,2021-07-01 18:41:16.674424
4840,101599,5,101599,53,10333,53,14,1,14,Relationship with Supervisor,3,10333,117,2021-07-01 18:00:04,2021-07-01 18:41:16.674424
4841,101600,4,101600,56,10333,56,15,1,15,Company Administration,3,10333,117,2021-07-01 18:00:04,2021-07-01 18:41:16.674424
4842,101646,6,101646,37,10343,37,11,1,11,Compensation and Benefits,3,10343,115,2021-07-06 18:00:04,2021-07-06 18:03:55.347953
4843,101647,6,101647,41,10343,41,12,1,12,Relationship with Co-Workers,3,10343,115,2021-07-06 18:00:04,2021-07-06 18:03:55.347953
4844,101648,6,101648,49,10343,49,13,1,13,General Satisfaction,3,10343,115,2021-07-06 18:00:04,2021-07-06 18:03:55.347953
4845,101649,1,101649,54,10343,54,14,1,14,Relationship with Supervisor,3,10343,115,2021-07-06 18:00:04,2021-07-06 18:03:55.347953
4846,101650,1,101650,55,10343,55,15,1,15,Company Administration,3,10343,115,2021-07-06 18:00:04,2021-07-06 18:03:55.347953
4847,101875,4,101875,37,10392,37,11,1,11,Compensation and Benefits,3,10392,110,2021-07-08 18:00:02,2021-07-08 18:34:51.928379
4848,101876,5,101876,40,10392,40,12,1,12,Relationship with Co-Workers,3,10392,110,2021-07-08 18:00:02,2021-07-08 18:34:51.928379
4849,101879,6,101879,58,10392,58,15,1,15,Company Administration,3,10392,110,2021-07-08 18:00:02,2021-07-08 18:34:51.928379
4850,101877,2,101877,44,10392,44,15,1,15,Company Administration,3,10392,110,2021-07-08 18:00:02,2021-07-08 18:34:51.928379
4851,101878,6,101878,51,10392,51,15,1,15,Company Administration,3,10392,110,2021-07-08 18:00:02,2021-07-08 18:34:51.928379
4852,102540,4,102540,37,10543,37,11,1,11,Compensation and Benefits,3,10543,108,2021-08-10 18:00:02,2021-08-10 18:08:38.420000
4853,102541,3,102541,40,10543,40,12,1,12,Relationship with Co-Workers,3,10543,108,2021-08-10 18:00:02,2021-08-10 18:08:38.420000
4854,102542,4,102542,47,10543,47,13,1,13,General Satisfaction,3,10543,108,2021-08-10 18:00:02,2021-08-10 18:08:38.420000
4855,102543,4,102543,50,10543,50,14,1,14,Relationship with Supervisor,3,10543,108,2021-08-10 18:00:02,2021-08-10 18:08:38.420000
4856,102544,4,102544,52,10543,52,15,1,15,Company Administration,3,10543,108,2021-08-10 18:00:02,2021-08-10 18:08:38.420000
4857,102545,5,102545,34,10543,34,26,1,26,Direct Questions,3,10543,108,2021-08-10 18:00:02,2021-08-10 18:08:38.420000
4858,102582,1,102582,37,10550,37,11,1,11,Compensation and Benefits,3,10550,116,2021-08-10 18:00:03,2021-08-10 23:16:31.917550
4859,102583,3,102583,42,10550,42,12,1,12,Relationship with Co-Workers,3,10550,116,2021-08-10 18:00:03,2021-08-10 23:16:31.917550
4860,102584,2,102584,46,10550,46,13,1,13,General Satisfaction,3,10550,116,2021-08-10 18:00:03,2021-08-10 23:16:31.917550
4861,102585,2,102585,123,10550,123,14,1,14,Relationship with Supervisor,3,10550,116,2021-08-10 18:00:03,2021-08-10 23:16:31.917550
4862,102586,5,102586,116,10550,116,15,1,15,Company Administration,3,10550,116,2021-08-10 18:00:03,2021-08-10 23:16:31.917550
4863,102587,4,102587,35,10550,35,26,1,26,Direct Questions,3,10550,116,2021-08-10 18:00:03,2021-08-10 23:16:31.917550
4864,102770,5,102770,37,10591,37,11,1,11,Compensation and Benefits,3,10591,110,2021-08-12 18:00:02,2021-08-12 21:25:24.873166
4865,102771,2,102771,43,10591,43,12,1,12,Relationship with Co-Workers,3,10591,110,2021-08-12 18:00:02,2021-08-12 21:25:24.873166
4866,102772,2,102772,47,10591,47,13,1,13,General Satisfaction,3,10591,110,2021-08-12 18:00:02,2021-08-12 21:25:24.873166
4867,102773,6,102773,121,10591,121,14,1,14,Relationship with Supervisor,3,10591,110,2021-08-12 18:00:02,2021-08-12 21:25:24.873166
4868,102774,5,102774,51,10591,51,15,1,15,Company Administration,3,10591,110,2021-08-12 18:00:02,2021-08-12 21:25:24.873166
4869,102775,1,102775,34,10591,34,26,1,26,Direct Questions,3,10591,110,2021-08-12 18:00:02,2021-08-12 21:25:24.873166
4870,102794,4,102794,37,10595,37,11,1,11,Compensation and Benefits,3,10595,115,2021-08-12 18:00:02,2021-08-12 18:12:03.333049
4871,102795,4,102795,43,10595,43,12,1,12,Relationship with Co-Workers,3,10595,115,2021-08-12 18:00:02,2021-08-12 18:12:03.333049
4872,102796,5,102796,49,10595,49,13,1,13,General Satisfaction,3,10595,115,2021-08-12 18:00:02,2021-08-12 18:12:03.333049
4873,102797,5,102797,120,10595,120,14,1,14,Relationship with Supervisor,3,10595,115,2021-08-12 18:00:02,2021-08-12 18:12:03.333049
4874,102798,5,102798,44,10595,44,15,1,15,Company Administration,3,10595,115,2021-08-12 18:00:02,2021-08-12 18:12:03.333049
4875,102799,5,102799,34,10595,34,26,1,26,Direct Questions,3,10595,115,2021-08-12 18:00:02,2021-08-12 18:12:03.333049
4876,102854,4,102854,37,10605,37,11,1,11,Compensation and Benefits,3,10605,111,2021-08-17 18:00:02,2021-08-18 00:14:12.512065
4877,102855,3,102855,39,10605,39,12,1,12,Relationship with Co-Workers,3,10605,111,2021-08-17 18:00:02,2021-08-18 00:14:12.512065
4878,102856,4,102856,118,10605,118,13,1,13,General Satisfaction,3,10605,111,2021-08-17 18:00:02,2021-08-18 00:14:12.512065
4879,102857,5,102857,122,10605,122,14,1,14,Relationship with Supervisor,3,10605,111,2021-08-17 18:00:02,2021-08-18 00:14:12.512065
4880,102858,5,102858,51,10605,51,15,1,15,Company Administration,3,10605,111,2021-08-17 18:00:02,2021-08-18 00:14:12.512065
4881,102859,5,102859,35,10605,35,26,1,26,Direct Questions,3,10605,111,2021-08-17 18:00:02,2021-08-18 00:14:12.512065
4882,102872,5,102872,37,10608,37,11,1,11,Compensation and Benefits,3,10608,115,2021-08-17 18:00:03,2021-08-17 18:00:43.766041
4883,102873,5,102873,40,10608,40,12,1,12,Relationship with Co-Workers,3,10608,115,2021-08-17 18:00:03,2021-08-17 18:00:43.766041
4884,102874,5,102874,117,10608,117,13,1,13,General Satisfaction,3,10608,115,2021-08-17 18:00:03,2021-08-17 18:00:43.766041
4885,102875,5,102875,120,10608,120,14,1,14,Relationship with Supervisor,3,10608,115,2021-08-17 18:00:03,2021-08-17 18:00:43.766041
4886,102876,5,102876,115,10608,115,15,1,15,Company Administration,3,10608,115,2021-08-17 18:00:03,2021-08-17 18:00:43.766041
4887,102877,5,102877,34,10608,34,26,1,26,Direct Questions,3,10608,115,2021-08-17 18:00:03,2021-08-17 18:00:43.766041
4888,102890,5,102890,37,10611,37,11,1,11,Compensation and Benefits,3,10611,118,2021-08-17 18:00:03,2021-08-17 20:51:55.791936
4889,102891,4,102891,41,10611,41,12,1,12,Relationship with Co-Workers,3,10611,118,2021-08-17 18:00:03,2021-08-17 20:51:55.791936
4890,102892,4,102892,117,10611,117,13,1,13,General Satisfaction,3,10611,118,2021-08-17 18:00:03,2021-08-17 20:51:55.791936
4891,102893,3,102893,53,10611,53,14,1,14,Relationship with Supervisor,3,10611,118,2021-08-17 18:00:03,2021-08-17 20:51:55.791936
4892,102894,4,102894,115,10611,115,15,1,15,Company Administration,3,10611,118,2021-08-17 18:00:03,2021-08-17 20:51:55.791936
4893,102895,6,102895,34,10611,34,26,1,26,Direct Questions,3,10611,118,2021-08-17 18:00:03,2021-08-17 20:51:55.791936
4894,103072,4,103072,37,10651,37,11,1,11,Compensation and Benefits,3,10651,111,2021-08-19 18:00:02,2021-08-19 20:50:03.749165
4895,103073,4,103073,111,10651,111,12,1,12,Relationship with Co-Workers,3,10651,111,2021-08-19 18:00:02,2021-08-19 20:50:03.749165
4896,103074,5,103074,46,10651,46,13,1,13,General Satisfaction,3,10651,111,2021-08-19 18:00:02,2021-08-19 20:50:03.749165
4897,103075,6,103075,122,10651,122,14,1,14,Relationship with Supervisor,3,10651,111,2021-08-19 18:00:02,2021-08-19 20:50:03.749165
4898,103076,3,103076,44,10651,44,15,1,15,Company Administration,3,10651,111,2021-08-19 18:00:02,2021-08-19 20:50:03.749165
4899,103077,4,103077,34,10651,34,26,1,26,Direct Questions,3,10651,111,2021-08-19 18:00:02,2021-08-19 20:50:03.749165
4900,103090,5,103090,37,10654,37,11,1,11,Compensation and Benefits,3,10654,115,2021-08-19 18:00:03,2021-08-19 18:04:50.796308
4901,103091,5,103091,113,10654,113,12,1,12,Relationship with Co-Workers,3,10654,115,2021-08-19 18:00:03,2021-08-19 18:04:50.796308
4902,103092,5,103092,118,10654,118,13,1,13,General Satisfaction,3,10654,115,2021-08-19 18:00:03,2021-08-19 18:04:50.796308
4903,103093,2,103093,50,10654,50,14,1,14,Relationship with Supervisor,3,10654,115,2021-08-19 18:00:03,2021-08-19 18:04:50.796308
4904,103094,5,103094,51,10654,51,15,1,15,Company Administration,3,10654,115,2021-08-19 18:00:03,2021-08-19 18:04:50.796308
4905,103095,5,103095,36,10654,36,26,1,26,Direct Questions,3,10654,115,2021-08-19 18:00:03,2021-08-19 18:04:50.796308
4906,103156,3,103156,37,10665,37,11,1,11,Compensation and Benefits,3,10665,113,2021-08-24 18:00:02,2021-08-25 14:15:08.098766
4907,103157,4,103157,39,10665,39,12,1,12,Relationship with Co-Workers,3,10665,113,2021-08-24 18:00:02,2021-08-25 14:15:08.098766
4908,103158,3,103158,119,10665,119,13,1,13,General Satisfaction,3,10665,113,2021-08-24 18:00:02,2021-08-25 14:15:08.098766
4909,103159,4,103159,121,10665,121,14,1,14,Relationship with Supervisor,3,10665,113,2021-08-24 18:00:02,2021-08-25 14:15:08.098766
4910,103160,6,103160,51,10665,51,15,1,15,Company Administration,3,10665,113,2021-08-24 18:00:02,2021-08-25 14:15:08.098766
4911,103161,5,103161,36,10665,36,26,1,26,Direct Questions,3,10665,113,2021-08-24 18:00:02,2021-08-25 14:15:08.098766
4912,103186,5,103186,37,10670,37,11,1,11,Compensation and Benefits,3,10670,118,2021-08-24 18:00:03,2021-08-24 20:46:54.291383
4913,103187,4,103187,41,10670,41,12,1,12,Relationship with Co-Workers,3,10670,118,2021-08-24 18:00:03,2021-08-24 20:46:54.291383
4914,103188,4,103188,119,10670,119,13,1,13,General Satisfaction,3,10670,118,2021-08-24 18:00:03,2021-08-24 20:46:54.291383
4915,103189,2,103189,54,10670,54,14,1,14,Relationship with Supervisor,3,10670,118,2021-08-24 18:00:03,2021-08-24 20:46:54.291383
4916,103190,3,103190,56,10670,56,15,1,15,Company Administration,3,10670,118,2021-08-24 18:00:03,2021-08-24 20:46:54.291383
4917,103191,6,103191,34,10670,34,26,1,26,Direct Questions,3,10670,118,2021-08-24 18:00:03,2021-08-24 20:46:54.291383
4918,103244,4,103244,37,10681,37,11,1,11,Compensation and Benefits,3,10681,107,2021-08-26 18:00:01,2021-08-26 19:02:32.450644
4919,103245,3,103245,42,10681,42,12,1,12,Relationship with Co-Workers,3,10681,107,2021-08-26 18:00:01,2021-08-26 19:02:32.450644
4920,103246,3,103246,119,10681,119,13,1,13,General Satisfaction,3,10681,107,2021-08-26 18:00:01,2021-08-26 19:02:32.450644
4921,103247,5,103247,122,10681,122,14,1,14,Relationship with Supervisor,3,10681,107,2021-08-26 18:00:01,2021-08-26 19:02:32.450644
4922,103248,5,103248,114,10681,114,15,1,15,Company Administration,3,10681,107,2021-08-26 18:00:01,2021-08-26 19:02:32.450644
4923,103249,1,103249,34,10681,34,26,1,26,Direct Questions,3,10681,107,2021-08-26 18:00:01,2021-08-26 19:02:32.450644
4924,103250,4,103250,37,10682,37,11,1,11,Compensation and Benefits,3,10682,108,2021-08-26 18:00:02,2021-08-26 18:00:47.174568
4925,103251,3,103251,112,10682,112,12,1,12,Relationship with Co-Workers,3,10682,108,2021-08-26 18:00:02,2021-08-26 18:00:47.174568
4926,103252,4,103252,118,10682,118,13,1,13,General Satisfaction,3,10682,108,2021-08-26 18:00:02,2021-08-26 18:00:47.174568
4927,103253,5,103253,123,10682,123,14,1,14,Relationship with Supervisor,3,10682,108,2021-08-26 18:00:02,2021-08-26 18:00:47.174568
4928,103254,4,103254,114,10682,114,15,1,15,Company Administration,3,10682,108,2021-08-26 18:00:02,2021-08-26 18:00:47.174568
4929,103255,6,103255,34,10682,34,26,1,26,Direct Questions,3,10682,108,2021-08-26 18:00:02,2021-08-26 18:00:47.174568
4930,103256,2,103256,37,10683,37,11,1,11,Compensation and Benefits,3,10683,109,2021-08-26 18:00:02,2021-08-26 18:06:49.845589
4931,103257,5,103257,39,10683,39,12,1,12,Relationship with Co-Workers,3,10683,109,2021-08-26 18:00:02,2021-08-26 18:06:49.845589
4932,103258,5,103258,47,10683,47,13,1,13,General Satisfaction,3,10683,109,2021-08-26 18:00:02,2021-08-26 18:06:49.845589
4933,103259,5,103259,122,10683,122,14,1,14,Relationship with Supervisor,3,10683,109,2021-08-26 18:00:02,2021-08-26 18:06:49.845589
4934,103260,3,103260,55,10683,55,15,1,15,Company Administration,3,10683,109,2021-08-26 18:00:02,2021-08-26 18:06:49.845589
4935,103261,5,103261,35,10683,35,26,1,26,Direct Questions,3,10683,109,2021-08-26 18:00:02,2021-08-26 18:06:49.845589
4936,103268,4,103268,37,10685,37,11,1,11,Compensation and Benefits,3,10685,111,2021-08-26 18:00:02,2021-08-26 18:33:07.325772
4937,103269,4,103269,112,10685,112,12,1,12,Relationship with Co-Workers,3,10685,111,2021-08-26 18:00:02,2021-08-26 18:33:07.325772
4938,103270,3,103270,117,10685,117,13,1,13,General Satisfaction,3,10685,111,2021-08-26 18:00:02,2021-08-26 18:33:07.325772
4939,103271,4,103271,53,10685,53,14,1,14,Relationship with Supervisor,3,10685,111,2021-08-26 18:00:02,2021-08-26 18:33:07.325772
4940,103272,4,103272,115,10685,115,15,1,15,Company Administration,3,10685,111,2021-08-26 18:00:02,2021-08-26 18:33:07.325772
4941,103273,4,103273,34,10685,34,26,1,26,Direct Questions,3,10685,111,2021-08-26 18:00:02,2021-08-26 18:33:07.325772
4942,103346,4,103346,37,10698,37,11,1,11,Compensation and Benefits,3,10698,111,2021-08-31 18:00:02,2021-08-31 18:35:25.639422
4943,103347,4,103347,113,10698,113,12,1,12,Relationship with Co-Workers,3,10698,111,2021-08-31 18:00:02,2021-08-31 18:35:25.639422
4944,103348,4,103348,119,10698,119,13,1,13,General Satisfaction,3,10698,111,2021-08-31 18:00:02,2021-08-31 18:35:25.639422
4945,103349,4,103349,53,10698,53,14,1,14,Relationship with Supervisor,3,10698,111,2021-08-31 18:00:02,2021-08-31 18:35:25.639422
4946,103350,3,103350,115,10698,115,15,1,15,Company Administration,3,10698,111,2021-08-31 18:00:02,2021-08-31 18:35:25.639422
4947,103351,4,103351,34,10698,34,26,1,26,Direct Questions,3,10698,111,2021-08-31 18:00:02,2021-08-31 18:35:25.639422
4948,103358,4,103358,37,10700,37,11,1,11,Compensation and Benefits,3,10700,114,2021-08-31 18:00:03,2021-09-01 02:47:51.191423
4949,103359,3,103359,41,10700,41,12,1,12,Relationship with Co-Workers,3,10700,114,2021-08-31 18:00:03,2021-09-01 02:47:51.191423
4950,103360,4,103360,48,10700,48,13,1,13,General Satisfaction,3,10700,114,2021-08-31 18:00:03,2021-09-01 02:47:51.191423
4951,103361,4,103361,121,10700,121,14,1,14,Relationship with Supervisor,3,10700,114,2021-08-31 18:00:03,2021-09-01 02:47:51.191423
4952,103362,4,103362,55,10700,55,15,1,15,Company Administration,3,10700,114,2021-08-31 18:00:03,2021-09-01 02:47:51.191423
4953,103363,4,103363,35,10700,35,26,1,26,Direct Questions,3,10700,114,2021-08-31 18:00:03,2021-09-01 02:47:51.191423
4954,103440,4,103440,37,10715,37,11,1,11,Compensation and Benefits,3,10715,108,2021-09-02 18:00:02,2021-09-02 18:01:02.864203
4955,103441,3,103441,43,10715,43,12,1,12,Relationship with Co-Workers,3,10715,108,2021-09-02 18:00:02,2021-09-02 18:01:02.864203
4956,103442,5,103442,48,10715,48,13,1,13,General Satisfaction,3,10715,108,2021-09-02 18:00:02,2021-09-02 18:01:02.864203
4957,103443,3,103443,121,10715,121,14,1,14,Relationship with Supervisor,3,10715,108,2021-09-02 18:00:02,2021-09-02 18:01:02.864203
4958,103444,4,103444,56,10715,56,15,1,15,Company Administration,3,10715,108,2021-09-02 18:00:02,2021-09-02 18:01:02.864203
4959,103445,6,103445,35,10715,35,26,1,26,Direct Questions,3,10715,108,2021-09-02 18:00:02,2021-09-02 18:01:02.864203
4960,103446,3,103446,37,10716,37,11,1,11,Compensation and Benefits,3,10716,109,2021-09-02 18:00:02,2021-09-02 18:13:15.688215
4961,103447,3,103447,43,10716,43,12,1,12,Relationship with Co-Workers,3,10716,109,2021-09-02 18:00:02,2021-09-02 18:13:15.688215
4962,103448,4,103448,118,10716,118,13,1,13,General Satisfaction,3,10716,109,2021-09-02 18:00:02,2021-09-02 18:13:15.688215
4963,103449,2,103449,123,10716,123,14,1,14,Relationship with Supervisor,3,10716,109,2021-09-02 18:00:02,2021-09-02 18:13:15.688215
4964,103450,3,103450,52,10716,52,15,1,15,Company Administration,3,10716,109,2021-09-02 18:00:02,2021-09-02 18:13:15.688215
4965,103451,5,103451,36,10716,36,26,1,26,Direct Questions,3,10716,109,2021-09-02 18:00:02,2021-09-02 18:13:15.688215
4966,103452,4,103452,37,10717,37,11,1,11,Compensation and Benefits,3,10717,110,2021-09-02 18:00:02,2021-09-02 18:33:00.453112
4967,103453,5,103453,112,10717,112,12,1,12,Relationship with Co-Workers,3,10717,110,2021-09-02 18:00:02,2021-09-02 18:33:00.453112
4968,103454,5,103454,47,10717,47,13,1,13,General Satisfaction,3,10717,110,2021-09-02 18:00:02,2021-09-02 18:33:00.453112
4969,103455,6,103455,121,10717,121,14,1,14,Relationship with Supervisor,3,10717,110,2021-09-02 18:00:02,2021-09-02 18:33:00.453112
4970,103456,6,103456,55,10717,55,15,1,15,Company Administration,3,10717,110,2021-09-02 18:00:02,2021-09-02 18:33:00.453112
4971,103457,1,103457,35,10717,35,26,1,26,Direct Questions,3,10717,110,2021-09-02 18:00:02,2021-09-02 18:33:00.453112
4972,103488,4,103488,37,10723,37,11,1,11,Compensation and Benefits,3,10723,117,2021-09-02 18:00:04,2021-09-03 03:32:42.690971
4973,103489,5,103489,39,10723,39,12,1,12,Relationship with Co-Workers,3,10723,117,2021-09-02 18:00:04,2021-09-03 03:32:42.690971
4974,103490,5,103490,119,10723,119,13,1,13,General Satisfaction,3,10723,117,2021-09-02 18:00:04,2021-09-03 03:32:42.690971
4975,103491,5,103491,122,10723,122,14,1,14,Relationship with Supervisor,3,10723,117,2021-09-02 18:00:04,2021-09-03 03:32:42.690971
4976,103492,5,103492,114,10723,114,15,1,15,Company Administration,3,10723,117,2021-09-02 18:00:04,2021-09-03 03:32:42.690971
4977,103493,6,103493,36,10723,36,26,1,26,Direct Questions,3,10723,117,2021-09-02 18:00:04,2021-09-03 03:32:42.690971
4978,103624,4,103624,37,10747,37,11,1,11,Compensation and Benefits,3,10747,108,2021-09-09 18:00:01,2021-09-09 18:01:07.463084
4979,103625,4,103625,111,10747,111,12,1,12,Relationship with Co-Workers,3,10747,108,2021-09-09 18:00:01,2021-09-09 18:01:07.463084
4980,103626,4,103626,49,10747,49,13,1,13,General Satisfaction,3,10747,108,2021-09-09 18:00:01,2021-09-09 18:01:07.463084
4981,103627,4,103627,54,10747,54,14,1,14,Relationship with Supervisor,3,10747,108,2021-09-09 18:00:01,2021-09-09 18:01:07.463084
4982,103628,4,103628,116,10747,116,15,1,15,Company Administration,3,10747,108,2021-09-09 18:00:01,2021-09-09 18:01:07.463084
4983,103629,6,103629,34,10747,34,26,1,26,Direct Questions,3,10747,108,2021-09-09 18:00:01,2021-09-09 18:01:07.463084
4984,103732,4,103732,37,10765,37,11,1,11,Compensation and Benefits,3,10765,115,2021-09-14 18:00:03,2021-09-14 18:05:11.149251
4985,103733,3,103733,43,10765,43,12,1,12,Relationship with Co-Workers,3,10765,115,2021-09-14 18:00:03,2021-09-14 18:05:11.149251
4986,103734,4,103734,47,10765,47,13,1,13,General Satisfaction,3,10765,115,2021-09-14 18:00:03,2021-09-14 18:05:11.149251
4987,103735,1,103735,50,10765,50,14,1,14,Relationship with Supervisor,3,10765,115,2021-09-14 18:00:03,2021-09-14 18:05:11.149251
4988,103736,5,103736,56,10765,56,15,1,15,Company Administration,3,10765,115,2021-09-14 18:00:03,2021-09-14 18:05:11.149251
4989,103737,5,103737,35,10765,35,26,1,26,Direct Questions,3,10765,115,2021-09-14 18:00:03,2021-09-14 18:05:11.149251
4990,103850,1,103850,37,10786,37,11,1,11,Compensation and Benefits,3,10786,116,2021-09-16 18:00:03,2021-09-16 18:31:30.383525
4991,103851,2,103851,41,10786,41,12,1,12,Relationship with Co-Workers,3,10786,116,2021-09-16 18:00:03,2021-09-16 18:31:30.383525
4992,103852,2,103852,46,10786,46,13,1,13,General Satisfaction,3,10786,116,2021-09-16 18:00:03,2021-09-16 18:31:30.383525
4993,103853,2,103853,122,10786,122,14,1,14,Relationship with Supervisor,3,10786,116,2021-09-16 18:00:03,2021-09-16 18:31:30.383525
4994,103854,2,103854,115,10786,115,15,1,15,Company Administration,3,10786,116,2021-09-16 18:00:03,2021-09-16 18:31:30.383525
4995,103855,4,103855,34,10786,34,26,1,26,Direct Questions,3,10786,116,2021-09-16 18:00:03,2021-09-16 18:31:30.383525
4996,103856,5,103856,37,10787,37,11,1,11,Compensation and Benefits,3,10787,117,2021-09-16 18:00:03,2021-09-16 18:10:59.736270
4997,103857,4,103857,40,10787,40,12,1,12,Relationship with Co-Workers,3,10787,117,2021-09-16 18:00:03,2021-09-16 18:10:59.736270
4998,103858,5,103858,118,10787,118,13,1,13,General Satisfaction,3,10787,117,2021-09-16 18:00:03,2021-09-16 18:10:59.736270
4999,103859,4,103859,50,10787,50,14,1,14,Relationship with Supervisor,3,10787,117,2021-09-16 18:00:03,2021-09-16 18:10:59.736270
5000,103860,5,103860,115,10787,115,15,1,15,Company Administration,3,10787,117,2021-09-16 18:00:03,2021-09-16 18:10:59.736270
5001,103861,1,103861,35,10787,35,26,1,26,Direct Questions,3,10787,117,2021-09-16 18:00:03,2021-09-16 18:10:59.736270
5002,103916,4,103916,37,10797,37,11,1,11,Compensation and Benefits,3,10797,115,2021-09-21 18:00:03,2021-09-21 18:00:47.255157
5003,103917,5,103917,111,10797,111,12,1,12,Relationship with Co-Workers,3,10797,115,2021-09-21 18:00:03,2021-09-21 18:00:47.255157
5004,103918,5,103918,45,10797,45,13,1,13,General Satisfaction,3,10797,115,2021-09-21 18:00:03,2021-09-21 18:00:47.255157
5005,103919,6,103919,123,10797,123,14,1,14,Relationship with Supervisor,3,10797,115,2021-09-21 18:00:03,2021-09-21 18:00:47.255157
5006,103920,6,103920,56,10797,56,15,1,15,Company Administration,3,10797,115,2021-09-21 18:00:03,2021-09-21 18:00:47.255157
5007,103921,6,103921,34,10797,34,26,1,26,Direct Questions,3,10797,115,2021-09-21 18:00:03,2021-09-21 18:00:47.255157
5008,103934,5,103934,37,10800,37,11,1,11,Compensation and Benefits,3,10800,118,2021-09-21 18:00:03,2021-09-21 19:35:22.930242
5009,103935,3,103935,43,10800,43,12,1,12,Relationship with Co-Workers,3,10800,118,2021-09-21 18:00:03,2021-09-21 19:35:22.930242
5010,103936,4,103936,47,10800,47,13,1,13,General Satisfaction,3,10800,118,2021-09-21 18:00:03,2021-09-21 19:35:22.930242
5011,103937,2,103937,120,10800,120,14,1,14,Relationship with Supervisor,3,10800,118,2021-09-21 18:00:03,2021-09-21 19:35:22.930242
5012,103938,4,103938,55,10800,55,15,1,15,Company Administration,3,10800,118,2021-09-21 18:00:03,2021-09-21 19:35:22.930242
5013,103939,6,103939,36,10800,36,26,1,26,Direct Questions,3,10800,118,2021-09-21 18:00:03,2021-09-21 19:35:22.930242
5014,103992,4,103992,37,10811,37,11,1,11,Compensation and Benefits,3,10811,108,2021-09-23 18:00:01,2021-09-23 18:03:42.315842
5015,103993,4,103993,39,10811,39,12,1,12,Relationship with Co-Workers,3,10811,108,2021-09-23 18:00:01,2021-09-23 18:03:42.315842
5016,103994,4,103994,45,10811,45,13,1,13,General Satisfaction,3,10811,108,2021-09-23 18:00:01,2021-09-23 18:03:42.315842
5017,103995,3,103995,50,10811,50,14,1,14,Relationship with Supervisor,3,10811,108,2021-09-23 18:00:01,2021-09-23 18:03:42.315842
5018,103996,4,103996,115,10811,115,15,1,15,Company Administration,3,10811,108,2021-09-23 18:00:01,2021-09-23 18:03:42.315842
5019,103997,6,103997,36,10811,36,26,1,26,Direct Questions,3,10811,108,2021-09-23 18:00:01,2021-09-23 18:03:42.315842
5020,104040,5,104040,37,10819,37,11,1,11,Compensation and Benefits,3,10819,117,2021-09-23 18:00:03,2021-09-23 20:02:42.622940
5021,104041,4,104041,43,10819,43,12,1,12,Relationship with Co-Workers,3,10819,117,2021-09-23 18:00:03,2021-09-23 20:02:42.622940
5022,104042,4,104042,48,10819,48,13,1,13,General Satisfaction,3,10819,117,2021-09-23 18:00:03,2021-09-23 20:02:42.622940
5023,104043,4,104043,120,10819,120,14,1,14,Relationship with Supervisor,3,10819,117,2021-09-23 18:00:03,2021-09-23 20:02:42.622940
5024,104044,4,104044,116,10819,116,15,1,15,Company Administration,3,10819,117,2021-09-23 18:00:03,2021-09-23 20:02:42.622940
5025,104045,5,104045,36,10819,36,26,1,26,Direct Questions,3,10819,117,2021-09-23 18:00:03,2021-09-23 20:02:42.622940
5026,104046,4,104046,37,10820,37,11,1,11,Compensation and Benefits,3,10820,118,2021-09-23 18:00:04,2021-09-23 18:58:17.859714
5027,104047,4,104047,40,10820,40,12,1,12,Relationship with Co-Workers,3,10820,118,2021-09-23 18:00:04,2021-09-23 18:58:17.859714
5028,104048,3,104048,49,10820,49,13,1,13,General Satisfaction,3,10820,118,2021-09-23 18:00:04,2021-09-23 18:58:17.859714
5029,104049,5,104049,123,10820,123,14,1,14,Relationship with Supervisor,3,10820,118,2021-09-23 18:00:04,2021-09-23 18:58:17.859714
5030,104050,5,104050,114,10820,114,15,1,15,Company Administration,3,10820,118,2021-09-23 18:00:04,2021-09-23 18:58:17.859714
5031,104051,6,104051,34,10820,34,26,1,26,Direct Questions,3,10820,118,2021-09-23 18:00:04,2021-09-23 18:58:17.859714
5032,104088,4,104088,37,10827,37,11,1,11,Compensation and Benefits,3,10827,113,2021-09-28 18:00:03,2021-09-28 18:46:45.858108
5033,104089,2,104089,112,10827,112,12,1,12,Relationship with Co-Workers,3,10827,113,2021-09-28 18:00:03,2021-09-28 18:46:45.858108
5034,104090,5,104090,49,10827,49,13,1,13,General Satisfaction,3,10827,113,2021-09-28 18:00:03,2021-09-28 18:46:45.858108
5035,104091,1,104091,50,10827,50,14,1,14,Relationship with Supervisor,3,10827,113,2021-09-28 18:00:03,2021-09-28 18:46:45.858108
5036,104092,4,104092,115,10827,115,15,1,15,Company Administration,3,10827,113,2021-09-28 18:00:03,2021-09-28 18:46:45.858108
5037,104093,4,104093,34,10827,34,26,1,26,Direct Questions,3,10827,113,2021-09-28 18:00:03,2021-09-28 18:46:45.858108
5038,104112,5,104112,37,10831,37,11,1,11,Compensation and Benefits,3,10831,117,2021-09-28 18:00:03,2021-09-28 18:33:09.219998
5039,104113,5,104113,113,10831,113,12,1,12,Relationship with Co-Workers,3,10831,117,2021-09-28 18:00:03,2021-09-28 18:33:09.219998
5040,104114,5,104114,46,10831,46,13,1,13,General Satisfaction,3,10831,117,2021-09-28 18:00:03,2021-09-28 18:33:09.219998
5041,104115,4,104115,54,10831,54,14,1,14,Relationship with Supervisor,3,10831,117,2021-09-28 18:00:03,2021-09-28 18:33:09.219998
5042,104116,4,104116,51,10831,51,15,1,15,Company Administration,3,10831,117,2021-09-28 18:00:03,2021-09-28 18:33:09.219998
5043,104117,5,104117,34,10831,34,26,1,26,Direct Questions,3,10831,117,2021-09-28 18:00:03,2021-09-28 18:33:09.219998
5044,104124,5,104124,37,10833,37,11,1,11,Compensation and Benefits,3,10833,156,2021-09-28 18:00:04,2021-09-28 23:56:07.147178
5045,104125,6,104125,112,10833,112,12,1,12,Relationship with Co-Workers,3,10833,156,2021-09-28 18:00:04,2021-09-28 23:56:07.147178
5046,104126,6,104126,48,10833,48,13,1,13,General Satisfaction,3,10833,156,2021-09-28 18:00:04,2021-09-28 23:56:07.147178
5047,104127,6,104127,54,10833,54,14,1,14,Relationship with Supervisor,3,10833,156,2021-09-28 18:00:04,2021-09-28 23:56:07.147178
5048,104128,6,104128,114,10833,114,15,1,15,Company Administration,3,10833,156,2021-09-28 18:00:04,2021-09-28 23:56:07.147178
5049,104129,6,104129,36,10833,36,26,1,26,Direct Questions,3,10833,156,2021-09-28 18:00:04,2021-09-28 23:56:07.147178
5050,104188,4,104188,37,10845,37,11,1,11,Compensation and Benefits,3,10845,107,2021-09-30 18:00:01,2021-09-30 18:50:18.028883
5051,104189,6,104189,113,10845,113,12,1,12,Relationship with Co-Workers,3,10845,107,2021-09-30 18:00:01,2021-09-30 18:50:18.028883
5052,104190,5,104190,119,10845,119,13,1,13,General Satisfaction,3,10845,107,2021-09-30 18:00:01,2021-09-30 18:50:18.028883
5053,104191,4,104191,53,10845,53,14,1,14,Relationship with Supervisor,3,10845,107,2021-09-30 18:00:01,2021-09-30 18:50:18.028883
5054,104192,6,104192,57,10845,57,15,1,15,Company Administration,3,10845,107,2021-09-30 18:00:01,2021-09-30 18:50:18.028883
5055,104193,6,104193,36,10845,36,26,1,26,Direct Questions,3,10845,107,2021-09-30 18:00:01,2021-09-30 18:50:18.028883
5056,104224,4,104224,37,10851,37,11,1,11,Compensation and Benefits,3,10851,114,2021-09-30 18:00:03,2021-09-30 20:51:39.430831
5057,104225,5,104225,39,10851,39,12,1,12,Relationship with Co-Workers,3,10851,114,2021-09-30 18:00:03,2021-09-30 20:51:39.430831
5058,104226,4,104226,118,10851,118,13,1,13,General Satisfaction,3,10851,114,2021-09-30 18:00:03,2021-09-30 20:51:39.430831
5059,104227,4,104227,122,10851,122,14,1,14,Relationship with Supervisor,3,10851,114,2021-09-30 18:00:03,2021-09-30 20:51:39.430831
5060,104228,4,104228,44,10851,44,15,1,15,Company Administration,3,10851,114,2021-09-30 18:00:03,2021-09-30 20:51:39.430831
5061,104229,4,104229,34,10851,34,26,1,26,Direct Questions,3,10851,114,2021-09-30 18:00:03,2021-09-30 20:51:39.430831
5062,104242,5,104242,37,10854,37,11,1,11,Compensation and Benefits,3,10854,117,2021-09-30 18:00:03,2021-09-30 18:26:35.700196
5063,104243,4,104243,40,10854,40,12,1,12,Relationship with Co-Workers,3,10854,117,2021-09-30 18:00:03,2021-09-30 18:26:35.700196
5064,104244,4,104244,48,10854,48,13,1,13,General Satisfaction,3,10854,117,2021-09-30 18:00:03,2021-09-30 18:26:35.700196
5065,104245,4,104245,120,10854,120,14,1,14,Relationship with Supervisor,3,10854,117,2021-09-30 18:00:03,2021-09-30 18:26:35.700196
5066,104246,4,104246,116,10854,116,15,1,15,Company Administration,3,10854,117,2021-09-30 18:00:03,2021-09-30 18:26:35.700196
5067,104247,1,104247,35,10854,35,26,1,26,Direct Questions,3,10854,117,2021-09-30 18:00:03,2021-09-30 18:26:35.700196
5068,104272,3,104272,37,10859,37,11,1,11,Compensation and Benefits,3,10859,159,2021-09-30 18:00:05,2021-09-30 18:33:15.200343
5069,104273,4,104273,39,10859,39,12,1,12,Relationship with Co-Workers,3,10859,159,2021-09-30 18:00:05,2021-09-30 18:33:15.200343
5070,104274,4,104274,119,10859,119,13,1,13,General Satisfaction,3,10859,159,2021-09-30 18:00:05,2021-09-30 18:33:15.200343
5071,104275,4,104275,121,10859,121,14,1,14,Relationship with Supervisor,3,10859,159,2021-09-30 18:00:05,2021-09-30 18:33:15.200343
5072,104276,6,104276,56,10859,56,15,1,15,Company Administration,3,10859,159,2021-09-30 18:00:05,2021-09-30 18:33:15.200343
5073,104277,1,104277,35,10859,35,26,1,26,Direct Questions,3,10859,159,2021-09-30 18:00:05,2021-09-30 18:33:15.200343
5074,104290,4,104290,37,10862,37,11,1,11,Compensation and Benefits,3,10862,108,2021-10-05 18:00:02,2021-10-05 18:03:30.738685
5075,104291,3,104291,41,10862,41,12,1,12,Relationship with Co-Workers,3,10862,108,2021-10-05 18:00:02,2021-10-05 18:03:30.738685
5076,104292,4,104292,118,10862,118,13,1,13,General Satisfaction,3,10862,108,2021-10-05 18:00:02,2021-10-05 18:03:30.738685
5077,104293,4,104293,122,10862,122,14,1,14,Relationship with Supervisor,3,10862,108,2021-10-05 18:00:02,2021-10-05 18:03:30.738685
5078,104294,3,104294,56,10862,56,15,1,15,Company Administration,3,10862,108,2021-10-05 18:00:02,2021-10-05 18:03:30.738685
5079,104295,6,104295,34,10862,34,26,1,26,Direct Questions,3,10862,108,2021-10-05 18:00:02,2021-10-05 18:03:30.738685
5080,104302,5,104302,37,10864,37,11,1,11,Compensation and Benefits,3,10864,110,2021-10-05 18:00:02,2021-10-05 18:35:39.963277
5081,104303,5,104303,112,10864,112,12,1,12,Relationship with Co-Workers,3,10864,110,2021-10-05 18:00:02,2021-10-05 18:35:39.963277
5082,104304,6,104304,118,10864,118,13,1,13,General Satisfaction,3,10864,110,2021-10-05 18:00:02,2021-10-05 18:35:39.963277
5083,104305,6,104305,53,10864,53,14,1,14,Relationship with Supervisor,3,10864,110,2021-10-05 18:00:02,2021-10-05 18:35:39.963277
5084,104306,1,104306,44,10864,44,15,1,15,Company Administration,3,10864,110,2021-10-05 18:00:02,2021-10-05 18:35:39.963277
5085,104307,1,104307,34,10864,34,26,1,26,Direct Questions,3,10864,110,2021-10-05 18:00:02,2021-10-05 18:35:39.963277
5086,104344,5,104344,37,10871,37,11,1,11,Compensation and Benefits,3,10871,118,2021-10-05 18:00:04,2021-10-05 18:41:25.701235
5087,104345,3,104345,42,10871,42,12,1,12,Relationship with Co-Workers,3,10871,118,2021-10-05 18:00:04,2021-10-05 18:41:25.701235
5088,104346,3,104346,119,10871,119,13,1,13,General Satisfaction,3,10871,118,2021-10-05 18:00:04,2021-10-05 18:41:25.701235
5089,104347,5,104347,123,10871,123,14,1,14,Relationship with Supervisor,3,10871,118,2021-10-05 18:00:04,2021-10-05 18:41:25.701235
5090,104348,4,104348,58,10871,58,15,1,15,Company Administration,3,10871,118,2021-10-05 18:00:04,2021-10-05 18:41:25.701235
5091,104349,6,104349,34,10871,34,26,1,26,Direct Questions,3,10871,118,2021-10-05 18:00:04,2021-10-05 18:41:25.701235
5092,104374,5,104374,37,10876,37,11,1,11,Compensation and Benefits,3,10876,160,2021-10-05 18:00:05,2021-10-05 18:41:09.125000
5093,104375,5,104375,112,10876,112,12,1,12,Relationship with Co-Workers,3,10876,160,2021-10-05 18:00:05,2021-10-05 18:41:09.125000
5094,104376,6,104376,117,10876,117,13,1,13,General Satisfaction,3,10876,160,2021-10-05 18:00:05,2021-10-05 18:41:09.125000
5095,104377,5,104377,120,10876,120,14,1,14,Relationship with Supervisor,3,10876,160,2021-10-05 18:00:05,2021-10-05 18:41:09.125000
5096,104378,5,104378,116,10876,116,15,1,15,Company Administration,3,10876,160,2021-10-05 18:00:05,2021-10-05 18:41:09.125000
5097,104379,5,104379,36,10876,36,26,1,26,Direct Questions,3,10876,160,2021-10-05 18:00:05,2021-10-05 18:41:09.125000
5098,4046,4,4046,38,995,38,11,1,11,Compensation and Benefits,3,995,112,2021-04-20 18:00:03,2021-04-20 18:01:09.365023
5099,4047,4,4047,42,995,42,12,1,12,Relationship with Co-Workers,3,995,112,2021-04-20 18:00:03,2021-04-20 18:01:09.365023
5100,4048,5,4048,45,995,45,13,1,13,General Satisfaction,3,995,112,2021-04-20 18:00:03,2021-04-20 18:01:09.365023
5101,4050,2,4050,55,995,55,15,1,15,Company Administration,3,995,112,2021-04-20 18:00:03,2021-04-20 18:01:09.365023
5102,4049,5,4049,52,995,52,15,1,15,Company Administration,3,995,112,2021-04-20 18:00:03,2021-04-20 18:01:09.365023
5103,4076,5,4076,38,1001,38,11,1,11,Compensation and Benefits,3,1001,118,2021-04-20 18:00:04,2021-04-20 18:01:40.554286
5104,4077,4,4077,43,1001,43,12,1,12,Relationship with Co-Workers,3,1001,118,2021-04-20 18:00:04,2021-04-20 18:01:40.554286
5105,4078,3,4078,46,1001,46,13,1,13,General Satisfaction,3,1001,118,2021-04-20 18:00:04,2021-04-20 18:01:40.554286
5106,4079,4,4079,50,1001,50,14,1,14,Relationship with Supervisor,3,1001,118,2021-04-20 18:00:04,2021-04-20 18:01:40.554286
5107,4080,5,4080,58,1001,58,15,1,15,Company Administration,3,1001,118,2021-04-20 18:00:04,2021-04-20 18:01:40.554286
5108,4921,4,4921,38,1170,38,11,1,11,Compensation and Benefits,3,1170,116,2021-04-22 18:00:04,2021-04-22 18:35:42.301369
5109,4922,4,4922,43,1170,43,12,1,12,Relationship with Co-Workers,3,1170,116,2021-04-22 18:00:04,2021-04-22 18:35:42.301369
5110,4923,4,4923,48,1170,48,13,1,13,General Satisfaction,3,1170,116,2021-04-22 18:00:04,2021-04-22 18:35:42.301369
5111,4924,4,4924,50,1170,50,14,1,14,Relationship with Supervisor,3,1170,116,2021-04-22 18:00:04,2021-04-22 18:35:42.301369
5112,4925,3,4925,56,1170,56,15,1,15,Company Administration,3,1170,116,2021-04-22 18:00:04,2021-04-22 18:35:42.301369
5113,20011,4,20011,38,2002,38,11,1,11,Compensation and Benefits,3,2002,108,2021-04-27 18:00:03,2021-04-27 18:02:07.768471
5114,20012,4,20012,40,2002,40,12,1,12,Relationship with Co-Workers,3,2002,108,2021-04-27 18:00:03,2021-04-27 18:02:07.768471
5115,20013,5,20013,49,2002,49,13,1,13,General Satisfaction,3,2002,108,2021-04-27 18:00:03,2021-04-27 18:02:07.768471
5116,20014,4,20014,53,2002,53,14,1,14,Relationship with Supervisor,3,2002,108,2021-04-27 18:00:03,2021-04-27 18:02:07.768471
5117,20015,4,20015,56,2002,56,15,1,15,Company Administration,3,2002,108,2021-04-27 18:00:03,2021-04-27 18:02:07.768471
5118,20036,3,20036,38,2007,38,11,1,11,Compensation and Benefits,3,2007,113,2021-04-27 18:00:04,2021-04-27 18:12:51.888204
5119,20037,1,20037,39,2007,39,12,1,12,Relationship with Co-Workers,3,2007,113,2021-04-27 18:00:04,2021-04-27 18:12:51.888204
5120,20038,4,20038,47,2007,47,13,1,13,General Satisfaction,3,2007,113,2021-04-27 18:00:04,2021-04-27 18:12:51.888204
5121,20039,4,20039,53,2007,53,14,1,14,Relationship with Supervisor,3,2007,113,2021-04-27 18:00:04,2021-04-27 18:12:51.888204
5122,20040,5,20040,56,2007,56,15,1,15,Company Administration,3,2007,113,2021-04-27 18:00:04,2021-04-27 18:12:51.888204
5123,20985,5,20985,38,2195,38,11,1,11,Compensation and Benefits,3,2195,107,2021-05-04 18:00:02,2021-05-04 18:57:32.282994
5124,20986,3,20986,43,2195,43,12,1,12,Relationship with Co-Workers,3,2195,107,2021-05-04 18:00:02,2021-05-04 18:57:32.282994
5125,20988,2,20988,50,2195,50,14,1,14,Relationship with Supervisor,3,2195,107,2021-05-04 18:00:02,2021-05-04 18:57:32.282994
5126,20989,4,20989,57,2195,57,15,1,15,Company Administration,3,2195,107,2021-05-04 18:00:02,2021-05-04 18:57:32.282994
5127,20987,4,20987,44,2195,44,15,1,15,Company Administration,3,2195,107,2021-05-04 18:00:02,2021-05-04 18:57:32.282994
5128,20990,4,20990,38,2196,38,11,1,11,Compensation and Benefits,3,2196,108,2021-05-04 18:00:03,2021-05-04 18:00:58.192507
5129,20991,3,20991,42,2196,42,12,1,12,Relationship with Co-Workers,3,2196,108,2021-05-04 18:00:03,2021-05-04 18:00:58.192507
5130,20992,4,20992,48,2196,48,13,1,13,General Satisfaction,3,2196,108,2021-05-04 18:00:03,2021-05-04 18:00:58.192507
5131,20994,4,20994,56,2196,56,15,1,15,Company Administration,3,2196,108,2021-05-04 18:00:03,2021-05-04 18:00:58.192507
5132,20993,4,20993,52,2196,52,15,1,15,Company Administration,3,2196,108,2021-05-04 18:00:03,2021-05-04 18:00:58.192507
5133,21000,2,21000,38,2198,38,11,1,11,Compensation and Benefits,3,2198,110,2021-05-04 18:00:04,2021-05-04 18:30:11.388817
5134,21001,5,21001,41,2198,41,12,1,12,Relationship with Co-Workers,3,2198,110,2021-05-04 18:00:04,2021-05-04 18:30:11.388817
5135,21002,4,21002,46,2198,46,13,1,13,General Satisfaction,3,2198,110,2021-05-04 18:00:04,2021-05-04 18:30:11.388817
5136,21003,2,21003,54,2198,54,14,1,14,Relationship with Supervisor,3,2198,110,2021-05-04 18:00:04,2021-05-04 18:30:11.388817
5137,21004,2,21004,56,2198,56,15,1,15,Company Administration,3,2198,110,2021-05-04 18:00:04,2021-05-04 18:30:11.388817
5138,21015,4,21015,38,2201,38,11,1,11,Compensation and Benefits,3,2201,113,2021-05-04 18:00:04,2021-05-04 18:36:28.977541
5139,21016,5,21016,43,2201,43,12,1,12,Relationship with Co-Workers,3,2201,113,2021-05-04 18:00:04,2021-05-04 18:36:28.977541
5140,21017,4,21017,49,2201,49,13,1,13,General Satisfaction,3,2201,113,2021-05-04 18:00:04,2021-05-04 18:36:28.977541
5141,21018,2,21018,53,2201,53,14,1,14,Relationship with Supervisor,3,2201,113,2021-05-04 18:00:04,2021-05-04 18:36:28.977541
5142,21019,3,21019,55,2201,55,15,1,15,Company Administration,3,2201,113,2021-05-04 18:00:04,2021-05-04 18:36:28.977541
5143,21040,5,21040,38,2206,38,11,1,11,Compensation and Benefits,3,2206,118,2021-05-04 18:00:05,2021-05-04 18:43:44.838653
5144,21041,5,21041,41,2206,41,12,1,12,Relationship with Co-Workers,3,2206,118,2021-05-04 18:00:05,2021-05-04 18:43:44.838653
5145,21042,4,21042,47,2206,47,13,1,13,General Satisfaction,3,2206,118,2021-05-04 18:00:05,2021-05-04 18:43:44.838653
5146,21044,5,21044,58,2206,58,15,1,15,Company Administration,3,2206,118,2021-05-04 18:00:05,2021-05-04 18:43:44.838653
5147,21043,3,21043,52,2206,52,15,1,15,Company Administration,3,2206,118,2021-05-04 18:00:05,2021-05-04 18:43:44.838653
5148,21909,5,21909,38,2378,38,11,1,11,Compensation and Benefits,3,2378,109,2021-05-06 18:00:02,2021-05-06 18:38:35.840354
5149,21910,4,21910,43,2378,43,12,1,12,Relationship with Co-Workers,3,2378,109,2021-05-06 18:00:02,2021-05-06 18:38:35.840354
5150,21911,4,21911,46,2378,46,13,1,13,General Satisfaction,3,2378,109,2021-05-06 18:00:02,2021-05-06 18:38:35.840354
5151,21912,3,21912,50,2378,50,14,1,14,Relationship with Supervisor,3,2378,109,2021-05-06 18:00:02,2021-05-06 18:38:35.840354
5152,21913,3,21913,56,2378,56,15,1,15,Company Administration,3,2378,109,2021-05-06 18:00:02,2021-05-06 18:38:35.840354
5153,21924,2,21924,38,2381,38,11,1,11,Compensation and Benefits,3,2381,112,2021-05-06 18:00:04,2021-05-06 18:45:17.211378
5154,21925,2,21925,40,2381,40,12,1,12,Relationship with Co-Workers,3,2381,112,2021-05-06 18:00:04,2021-05-06 18:45:17.211378
5155,21926,2,21926,46,2381,46,13,1,13,General Satisfaction,3,2381,112,2021-05-06 18:00:04,2021-05-06 18:45:17.211378
5156,21927,2,21927,53,2381,53,14,1,14,Relationship with Supervisor,3,2381,112,2021-05-06 18:00:04,2021-05-06 18:45:17.211378
5157,21928,6,21928,56,2381,56,15,1,15,Company Administration,3,2381,112,2021-05-06 18:00:04,2021-05-06 18:45:17.211378
5158,21939,4,21939,38,2384,38,11,1,11,Compensation and Benefits,3,2384,115,2021-05-06 18:00:04,2021-05-06 18:03:49.620753
5159,21940,3,21940,41,2384,41,12,1,12,Relationship with Co-Workers,3,2384,115,2021-05-06 18:00:04,2021-05-06 18:03:49.620753
5160,21941,4,21941,45,2384,45,13,1,13,General Satisfaction,3,2384,115,2021-05-06 18:00:04,2021-05-06 18:03:49.620753
5161,21943,4,21943,57,2384,57,15,1,15,Company Administration,3,2384,115,2021-05-06 18:00:04,2021-05-06 18:03:49.620753
5162,21942,4,21942,51,2384,51,15,1,15,Company Administration,3,2384,115,2021-05-06 18:00:04,2021-05-06 18:03:49.620753
5163,21964,4,21964,38,2389,38,11,1,11,Compensation and Benefits,3,2389,108,2021-05-11 18:00:04,2021-05-11 18:08:59.146753
5164,21965,4,21965,41,2389,41,12,1,12,Relationship with Co-Workers,3,2389,108,2021-05-11 18:00:04,2021-05-11 18:08:59.146753
5165,21967,4,21967,53,2389,53,14,1,14,Relationship with Supervisor,3,2389,108,2021-05-11 18:00:04,2021-05-11 18:08:59.146753
5166,21968,3,21968,56,2389,56,15,1,15,Company Administration,3,2389,108,2021-05-11 18:00:04,2021-05-11 18:08:59.146753
5167,21966,2,21966,44,2389,44,15,1,15,Company Administration,3,2389,108,2021-05-11 18:00:04,2021-05-11 18:08:59.146753
5168,21969,2,21969,38,2390,38,11,1,11,Compensation and Benefits,3,2390,109,2021-05-11 18:00:04,2021-05-11 18:35:51.619263
5169,21970,3,21970,39,2390,39,12,1,12,Relationship with Co-Workers,3,2390,109,2021-05-11 18:00:04,2021-05-11 18:35:51.619263
5170,21971,6,21971,49,2390,49,13,1,13,General Satisfaction,3,2390,109,2021-05-11 18:00:04,2021-05-11 18:35:51.619263
5171,21973,3,21973,56,2390,56,15,1,15,Company Administration,3,2390,109,2021-05-11 18:00:04,2021-05-11 18:35:51.619263
5172,21972,3,21972,52,2390,52,15,1,15,Company Administration,3,2390,109,2021-05-11 18:00:04,2021-05-11 18:35:51.619263
5173,22113,5,22113,38,2417,38,11,1,11,Compensation and Benefits,3,2417,107,2021-05-13 18:00:01,2021-05-13 18:02:18.719168
5174,22114,4,22114,41,2417,41,12,1,12,Relationship with Co-Workers,3,2417,107,2021-05-13 18:00:01,2021-05-13 18:02:18.719168
5175,22116,2,22116,50,2417,50,14,1,14,Relationship with Supervisor,3,2417,107,2021-05-13 18:00:01,2021-05-13 18:02:18.719168
5176,22117,5,22117,58,2417,58,15,1,15,Company Administration,3,2417,107,2021-05-13 18:00:01,2021-05-13 18:02:18.719168
5177,22115,4,22115,44,2417,44,15,1,15,Company Administration,3,2417,107,2021-05-13 18:00:01,2021-05-13 18:02:18.719168
5178,22133,4,22133,38,2421,38,11,1,11,Compensation and Benefits,3,2421,111,2021-05-13 18:00:02,2021-05-13 18:33:47.305856
5179,22134,5,22134,42,2421,42,12,1,12,Relationship with Co-Workers,3,2421,111,2021-05-13 18:00:02,2021-05-13 18:33:47.305856
5180,22135,4,22135,47,2421,47,13,1,13,General Satisfaction,3,2421,111,2021-05-13 18:00:02,2021-05-13 18:33:47.305856
5181,22136,3,22136,54,2421,54,14,1,14,Relationship with Supervisor,3,2421,111,2021-05-13 18:00:02,2021-05-13 18:33:47.305856
5182,22137,3,22137,58,2421,58,15,1,15,Company Administration,3,2421,111,2021-05-13 18:00:02,2021-05-13 18:33:47.305856
5183,22138,4,22138,38,2422,38,11,1,11,Compensation and Benefits,3,2422,112,2021-05-13 18:00:02,2021-05-13 20:37:14.603124
5184,22139,3,22139,39,2422,39,12,1,12,Relationship with Co-Workers,3,2422,112,2021-05-13 18:00:02,2021-05-13 20:37:14.603124
5185,22140,5,22140,48,2422,48,13,1,13,General Satisfaction,3,2422,112,2021-05-13 18:00:02,2021-05-13 20:37:14.603124
5186,22141,3,22141,53,2422,53,14,1,14,Relationship with Supervisor,3,2422,112,2021-05-13 18:00:02,2021-05-13 20:37:14.603124
5187,22142,5,22142,56,2422,56,15,1,15,Company Administration,3,2422,112,2021-05-13 18:00:02,2021-05-13 20:37:14.603124
5188,22143,4,22143,38,2423,38,11,1,11,Compensation and Benefits,3,2423,113,2021-05-13 18:00:02,2021-05-13 18:37:08.760836
5189,22144,5,22144,43,2423,43,12,1,12,Relationship with Co-Workers,3,2423,113,2021-05-13 18:00:02,2021-05-13 18:37:08.760836
5190,22145,6,22145,47,2423,47,13,1,13,General Satisfaction,3,2423,113,2021-05-13 18:00:02,2021-05-13 18:37:08.760836
5191,22146,3,22146,50,2423,50,14,1,14,Relationship with Supervisor,3,2423,113,2021-05-13 18:00:02,2021-05-13 18:37:08.760836
5192,22147,5,22147,55,2423,55,15,1,15,Company Administration,3,2423,113,2021-05-13 18:00:02,2021-05-13 18:37:08.760836
5193,22148,5,22148,38,2424,38,11,1,11,Compensation and Benefits,3,2424,114,2021-05-13 18:00:03,2021-05-13 18:33:11.841990
5194,22149,5,22149,39,2424,39,12,1,12,Relationship with Co-Workers,3,2424,114,2021-05-13 18:00:03,2021-05-13 18:33:11.841990
5195,22150,6,22150,48,2424,48,13,1,13,General Satisfaction,3,2424,114,2021-05-13 18:00:03,2021-05-13 18:33:11.841990
5196,22152,3,22152,55,2424,55,15,1,15,Company Administration,3,2424,114,2021-05-13 18:00:03,2021-05-13 18:33:11.841990
5197,22151,5,22151,52,2424,52,15,1,15,Company Administration,3,2424,114,2021-05-13 18:00:03,2021-05-13 18:33:11.841990
5198,22163,5,22163,38,2427,38,11,1,11,Compensation and Benefits,3,2427,117,2021-05-13 18:00:03,2021-05-13 18:31:06.548012
5199,22164,4,22164,40,2427,40,12,1,12,Relationship with Co-Workers,3,2427,117,2021-05-13 18:00:03,2021-05-13 18:31:06.548012
5200,22165,5,22165,47,2427,47,13,1,13,General Satisfaction,3,2427,117,2021-05-13 18:00:03,2021-05-13 18:31:06.548012
5201,22167,5,22167,57,2427,57,15,1,15,Company Administration,3,2427,117,2021-05-13 18:00:03,2021-05-13 18:31:06.548012
5202,22166,5,22166,51,2427,51,15,1,15,Company Administration,3,2427,117,2021-05-13 18:00:03,2021-05-13 18:31:06.548012
5203,22228,3,22228,38,2440,38,11,1,11,Compensation and Benefits,3,2440,118,2021-05-18 18:00:05,2021-05-18 18:48:12.118287
5204,22229,4,22229,40,2440,40,12,1,12,Relationship with Co-Workers,3,2440,118,2021-05-18 18:00:05,2021-05-18 18:48:12.118287
5205,22230,4,22230,49,2440,49,13,1,13,General Satisfaction,3,2440,118,2021-05-18 18:00:05,2021-05-18 18:48:12.118287
5206,22231,3,22231,53,2440,53,14,1,14,Relationship with Supervisor,3,2440,118,2021-05-18 18:00:05,2021-05-18 18:48:12.118287
5207,22232,4,22232,55,2440,55,15,1,15,Company Administration,3,2440,118,2021-05-18 18:00:05,2021-05-18 18:48:12.118287
5208,22342,5,22342,38,2461,38,11,1,11,Compensation and Benefits,3,2461,110,2021-05-20 18:00:02,2021-05-20 18:32:56.989202
5209,22343,5,22343,40,2461,40,12,1,12,Relationship with Co-Workers,3,2461,110,2021-05-20 18:00:02,2021-05-20 18:32:56.989202
5210,22344,6,22344,48,2461,48,13,1,13,General Satisfaction,3,2461,110,2021-05-20 18:00:02,2021-05-20 18:32:56.989202
5211,22345,5,22345,50,2461,50,14,1,14,Relationship with Supervisor,3,2461,110,2021-05-20 18:00:02,2021-05-20 18:32:56.989202
5212,22346,3,22346,56,2461,56,15,1,15,Company Administration,3,2461,110,2021-05-20 18:00:02,2021-05-20 18:32:56.989202
5213,22347,4,22347,38,2462,38,11,1,11,Compensation and Benefits,3,2462,111,2021-05-20 18:00:02,2021-05-20 18:35:28.884438
5214,22348,5,22348,42,2462,42,12,1,12,Relationship with Co-Workers,3,2462,111,2021-05-20 18:00:02,2021-05-20 18:35:28.884438
5215,22349,6,22349,48,2462,48,13,1,13,General Satisfaction,3,2462,111,2021-05-20 18:00:02,2021-05-20 18:35:28.884438
5216,22351,2,22351,57,2462,57,15,1,15,Company Administration,3,2462,111,2021-05-20 18:00:02,2021-05-20 18:35:28.884438
5217,22350,4,22350,52,2462,52,15,1,15,Company Administration,3,2462,111,2021-05-20 18:00:02,2021-05-20 18:35:28.884438
5218,22382,4,22382,38,2469,38,11,1,11,Compensation and Benefits,3,2469,118,2021-05-20 18:00:04,2021-05-20 18:49:53.013862
5219,22383,3,22383,41,2469,41,12,1,12,Relationship with Co-Workers,3,2469,118,2021-05-20 18:00:04,2021-05-20 18:49:53.013862
5220,22384,3,22384,46,2469,46,13,1,13,General Satisfaction,3,2469,118,2021-05-20 18:00:04,2021-05-20 18:49:53.013862
5221,22386,3,22386,58,2469,58,15,1,15,Company Administration,3,2469,118,2021-05-20 18:00:04,2021-05-20 18:49:53.013862
5222,22385,6,22385,51,2469,51,15,1,15,Company Administration,3,2469,118,2021-05-20 18:00:04,2021-05-20 18:49:53.013862
5223,22397,4,22397,38,2472,38,11,1,11,Compensation and Benefits,3,2472,109,2021-05-25 18:00:02,2021-05-25 18:33:55.928425
5224,22398,1,22398,39,2472,39,12,1,12,Relationship with Co-Workers,3,2472,109,2021-05-25 18:00:02,2021-05-25 18:33:55.928425
5225,22399,4,22399,49,2472,49,13,1,13,General Satisfaction,3,2472,109,2021-05-25 18:00:02,2021-05-25 18:33:55.928425
5226,22400,1,22400,53,2472,53,14,1,14,Relationship with Supervisor,3,2472,109,2021-05-25 18:00:02,2021-05-25 18:33:55.928425
5227,22401,1,22401,57,2472,57,15,1,15,Company Administration,3,2472,109,2021-05-25 18:00:02,2021-05-25 18:33:55.928425
5228,22437,5,22437,38,2480,38,11,1,11,Compensation and Benefits,3,2480,117,2021-05-25 18:00:03,2021-05-25 18:02:06.005351
5229,22438,5,22438,40,2480,40,12,1,12,Relationship with Co-Workers,3,2480,117,2021-05-25 18:00:03,2021-05-25 18:02:06.005351
5230,22439,5,22439,47,2480,47,13,1,13,General Satisfaction,3,2480,117,2021-05-25 18:00:03,2021-05-25 18:02:06.005351
5231,22441,2,22441,55,2480,55,15,1,15,Company Administration,3,2480,117,2021-05-25 18:00:03,2021-05-25 18:02:06.005351
5232,22440,2,22440,52,2480,52,15,1,15,Company Administration,3,2480,117,2021-05-25 18:00:03,2021-05-25 18:02:06.005351
5233,22566,1,22566,38,2504,38,11,1,11,Compensation and Benefits,3,2504,112,2021-05-27 18:00:03,2021-05-27 18:03:23.641930
5234,22567,1,22567,40,2504,40,12,1,12,Relationship with Co-Workers,3,2504,112,2021-05-27 18:00:03,2021-05-27 18:03:23.641930
5235,22568,1,22568,45,2504,45,13,1,13,General Satisfaction,3,2504,112,2021-05-27 18:00:03,2021-05-27 18:03:23.641930
5236,22569,1,22569,50,2504,50,14,1,14,Relationship with Supervisor,3,2504,112,2021-05-27 18:00:03,2021-05-27 18:03:23.641930
5237,22570,1,22570,58,2504,58,15,1,15,Company Administration,3,2504,112,2021-05-27 18:00:03,2021-05-27 18:03:23.641930
5238,100014,4,100014,38,10003,38,11,1,11,Compensation and Benefits,3,10003,109,2021-06-01 18:00:02,2021-06-01 18:14:22.366192
5239,100015,3,100015,39,10003,39,12,1,12,Relationship with Co-Workers,3,10003,109,2021-06-01 18:00:02,2021-06-01 18:14:22.366192
5240,100017,2,100017,53,10003,53,14,1,14,Relationship with Supervisor,3,10003,109,2021-06-01 18:00:02,2021-06-01 18:14:22.366192
5241,100016,4,100016,44,10003,44,15,1,15,Company Administration,3,10003,109,2021-06-01 18:00:02,2021-06-01 18:14:22.366192
5242,100018,4,100018,55,10003,55,15,1,15,Company Administration,3,10003,109,2021-06-01 18:00:02,2021-06-01 18:14:22.366192
5243,100044,4,100044,38,10009,38,11,1,11,Compensation and Benefits,3,10009,115,2021-06-01 18:00:03,2021-06-01 18:00:42.979763
5244,100045,4,100045,41,10009,41,12,1,12,Relationship with Co-Workers,3,10009,115,2021-06-01 18:00:03,2021-06-01 18:00:42.979763
5245,100046,4,100046,49,10009,49,13,1,13,General Satisfaction,3,10009,115,2021-06-01 18:00:03,2021-06-01 18:00:42.979763
5246,100047,2,100047,54,10009,54,14,1,14,Relationship with Supervisor,3,10009,115,2021-06-01 18:00:03,2021-06-01 18:00:42.979763
5247,100048,2,100048,55,10009,55,15,1,15,Company Administration,3,10009,115,2021-06-01 18:00:03,2021-06-01 18:00:42.979763
5248,100049,3,100049,38,10010,38,11,1,11,Compensation and Benefits,3,10010,116,2021-06-01 18:00:03,2021-06-01 20:35:37.861140
5249,100050,3,100050,42,10010,42,12,1,12,Relationship with Co-Workers,3,10010,116,2021-06-01 18:00:03,2021-06-01 20:35:37.861140
5250,100051,4,100051,47,10010,47,13,1,13,General Satisfaction,3,10010,116,2021-06-01 18:00:03,2021-06-01 20:35:37.861140
5251,100052,4,100052,54,10010,54,14,1,14,Relationship with Supervisor,3,10010,116,2021-06-01 18:00:03,2021-06-01 20:35:37.861140
5252,100053,4,100053,58,10010,58,15,1,15,Company Administration,3,10010,116,2021-06-01 18:00:03,2021-06-01 20:35:37.861140
5253,100059,4,100059,38,10012,38,11,1,11,Compensation and Benefits,3,10012,118,2021-06-01 18:00:03,2021-06-01 18:44:17.580150
5254,100060,4,100060,42,10012,42,12,1,12,Relationship with Co-Workers,3,10012,118,2021-06-01 18:00:03,2021-06-01 18:44:17.580150
5255,100061,4,100061,49,10012,49,13,1,13,General Satisfaction,3,10012,118,2021-06-01 18:00:03,2021-06-01 18:44:17.580150
5256,100063,4,100063,57,10012,57,15,1,15,Company Administration,3,10012,118,2021-06-01 18:00:03,2021-06-01 18:44:17.580150
5257,100062,4,100062,51,10012,51,15,1,15,Company Administration,3,10012,118,2021-06-01 18:00:03,2021-06-01 18:44:17.580150
5258,100217,3,100217,38,10040,38,11,1,11,Compensation and Benefits,3,10040,110,2021-06-03 18:00:02,2021-06-03 18:33:04.981080
5259,100218,4,100218,40,10040,40,12,1,12,Relationship with Co-Workers,3,10040,110,2021-06-03 18:00:02,2021-06-03 18:33:04.981080
5260,100219,1,100219,47,10040,47,13,1,13,General Satisfaction,3,10040,110,2021-06-03 18:00:02,2021-06-03 18:33:04.981080
5261,100221,3,100221,56,10040,56,15,1,15,Company Administration,3,10040,110,2021-06-03 18:00:02,2021-06-03 18:33:04.981080
5262,100220,6,100220,52,10040,52,15,1,15,Company Administration,3,10040,110,2021-06-03 18:00:02,2021-06-03 18:33:04.981080
5263,100232,5,100232,38,10043,38,11,1,11,Compensation and Benefits,3,10043,113,2021-06-03 18:00:03,2021-06-03 18:35:53.253071
5264,100233,5,100233,42,10043,42,12,1,12,Relationship with Co-Workers,3,10043,113,2021-06-03 18:00:03,2021-06-03 18:35:53.253071
5265,100234,1,100234,46,10043,46,13,1,13,General Satisfaction,3,10043,113,2021-06-03 18:00:03,2021-06-03 18:35:53.253071
5266,100236,2,100236,57,10043,57,15,1,15,Company Administration,3,10043,113,2021-06-03 18:00:03,2021-06-03 18:35:53.253071
5267,100235,5,100235,52,10043,52,15,1,15,Company Administration,3,10043,113,2021-06-03 18:00:03,2021-06-03 18:35:53.253071
5268,100237,4,100237,38,10044,38,11,1,11,Compensation and Benefits,3,10044,114,2021-06-03 18:00:03,2021-06-03 18:02:18.781027
5269,100238,4,100238,42,10044,42,12,1,12,Relationship with Co-Workers,3,10044,114,2021-06-03 18:00:03,2021-06-03 18:02:18.781027
5270,100239,4,100239,45,10044,45,13,1,13,General Satisfaction,3,10044,114,2021-06-03 18:00:03,2021-06-03 18:02:18.781027
5271,100240,4,100240,50,10044,50,14,1,14,Relationship with Supervisor,3,10044,114,2021-06-03 18:00:03,2021-06-03 18:02:18.781027
5272,100241,5,100241,55,10044,55,15,1,15,Company Administration,3,10044,114,2021-06-03 18:00:03,2021-06-03 18:02:18.781027
5273,100242,4,100242,38,10045,38,11,1,11,Compensation and Benefits,3,10045,115,2021-06-03 18:00:04,2021-06-03 18:01:44.989980
5274,100243,4,100243,39,10045,39,12,1,12,Relationship with Co-Workers,3,10045,115,2021-06-03 18:00:04,2021-06-03 18:01:44.989980
5275,100245,4,100245,53,10045,53,14,1,14,Relationship with Supervisor,3,10045,115,2021-06-03 18:00:04,2021-06-03 18:01:44.989980
5276,100246,4,100246,57,10045,57,15,1,15,Company Administration,3,10045,115,2021-06-03 18:00:04,2021-06-03 18:01:44.989980
5277,100244,3,100244,44,10045,44,15,1,15,Company Administration,3,10045,115,2021-06-03 18:00:04,2021-06-03 18:01:44.989980
5278,100252,5,100252,38,10047,38,11,1,11,Compensation and Benefits,3,10047,117,2021-06-03 18:00:05,2021-06-04 01:47:06.382224
5279,100253,5,100253,40,10047,40,12,1,12,Relationship with Co-Workers,3,10047,117,2021-06-03 18:00:05,2021-06-04 01:47:06.382224
5280,100254,5,100254,45,10047,45,13,1,13,General Satisfaction,3,10047,117,2021-06-03 18:00:05,2021-06-04 01:47:06.382224
5281,100255,5,100255,50,10047,50,14,1,14,Relationship with Supervisor,3,10047,117,2021-06-03 18:00:05,2021-06-04 01:47:06.382224
5282,100256,5,100256,57,10047,57,15,1,15,Company Administration,3,10047,117,2021-06-03 18:00:05,2021-06-04 01:47:06.382224
5283,100257,4,100257,38,10048,38,11,1,11,Compensation and Benefits,3,10048,118,2021-06-03 18:00:05,2021-06-03 19:58:56.251301
5284,100258,4,100258,43,10048,43,12,1,12,Relationship with Co-Workers,3,10048,118,2021-06-03 18:00:05,2021-06-03 19:58:56.251301
5285,100259,4,100259,47,10048,47,13,1,13,General Satisfaction,3,10048,118,2021-06-03 18:00:05,2021-06-03 19:58:56.251301
5286,100260,3,100260,50,10048,50,14,1,14,Relationship with Supervisor,3,10048,118,2021-06-03 18:00:05,2021-06-03 19:58:56.251301
5287,100261,5,100261,55,10048,55,15,1,15,Company Administration,3,10048,118,2021-06-03 18:00:05,2021-06-03 19:58:56.251301
5288,100358,5,100358,38,10073,38,11,1,11,Compensation and Benefits,3,10073,107,2021-06-08 18:00:01,2021-06-08 18:18:37.480161
5289,100359,2,100359,43,10073,43,12,1,12,Relationship with Co-Workers,3,10073,107,2021-06-08 18:00:01,2021-06-08 18:18:37.480161
5290,100360,4,100360,47,10073,47,13,1,13,General Satisfaction,3,10073,107,2021-06-08 18:00:01,2021-06-08 18:18:37.480161
5291,100361,2,100361,53,10073,53,14,1,14,Relationship with Supervisor,3,10073,107,2021-06-08 18:00:01,2021-06-08 18:18:37.480161
5292,100362,5,100362,58,10073,58,15,1,15,Company Administration,3,10073,107,2021-06-08 18:00:01,2021-06-08 18:18:37.480161
5293,100368,4,100368,38,10075,38,11,1,11,Compensation and Benefits,3,10075,109,2021-06-08 18:00:02,2021-06-08 18:13:43.255518
5294,100369,5,100369,41,10075,41,12,1,12,Relationship with Co-Workers,3,10075,109,2021-06-08 18:00:02,2021-06-08 18:13:43.255518
5295,100370,4,100370,47,10075,47,13,1,13,General Satisfaction,3,10075,109,2021-06-08 18:00:02,2021-06-08 18:13:43.255518
5296,100372,3,100372,55,10075,55,15,1,15,Company Administration,3,10075,109,2021-06-08 18:00:02,2021-06-08 18:13:43.255518
5297,100371,4,100371,52,10075,52,15,1,15,Company Administration,3,10075,109,2021-06-08 18:00:02,2021-06-08 18:13:43.255518
5298,100388,4,100388,38,10079,38,11,1,11,Compensation and Benefits,3,10079,113,2021-06-08 18:00:03,2021-06-08 18:41:04.607016
5299,100389,5,100389,42,10079,42,12,1,12,Relationship with Co-Workers,3,10079,113,2021-06-08 18:00:03,2021-06-08 18:41:04.607016
5300,100390,5,100390,45,10079,45,13,1,13,General Satisfaction,3,10079,113,2021-06-08 18:00:03,2021-06-08 18:41:04.607016
5301,100391,4,100391,53,10079,53,14,1,14,Relationship with Supervisor,3,10079,113,2021-06-08 18:00:03,2021-06-08 18:41:04.607016
5302,100392,6,100392,56,10079,56,15,1,15,Company Administration,3,10079,113,2021-06-08 18:00:03,2021-06-08 18:41:04.607016
5303,100619,3,100619,38,10128,38,11,1,11,Compensation and Benefits,3,10128,110,2021-06-10 18:00:02,2021-06-10 18:34:36.554399
5304,100620,6,100620,41,10128,41,12,1,12,Relationship with Co-Workers,3,10128,110,2021-06-10 18:00:02,2021-06-10 18:34:36.554399
5305,100621,6,100621,48,10128,48,13,1,13,General Satisfaction,3,10128,110,2021-06-10 18:00:02,2021-06-10 18:34:36.554399
5306,100622,1,100622,53,10128,53,14,1,14,Relationship with Supervisor,3,10128,110,2021-06-10 18:00:02,2021-06-10 18:34:36.554399
5307,100623,1,100623,57,10128,57,15,1,15,Company Administration,3,10128,110,2021-06-10 18:00:02,2021-06-10 18:34:36.554399
5308,100669,4,100669,38,10138,38,11,1,11,Compensation and Benefits,3,10138,108,2021-06-15 18:00:03,2021-06-15 18:02:57.509836
5309,100670,3,100670,41,10138,41,12,1,12,Relationship with Co-Workers,3,10138,108,2021-06-15 18:00:03,2021-06-15 18:02:57.509836
5310,100671,4,100671,45,10138,45,13,1,13,General Satisfaction,3,10138,108,2021-06-15 18:00:03,2021-06-15 18:02:57.509836
5311,100673,3,100673,56,10138,56,15,1,15,Company Administration,3,10138,108,2021-06-15 18:00:03,2021-06-15 18:02:57.509836
5312,100672,4,100672,51,10138,51,15,1,15,Company Administration,3,10138,108,2021-06-15 18:00:03,2021-06-15 18:02:57.509836
5313,100679,3,100679,38,10140,38,11,1,11,Compensation and Benefits,3,10140,110,2021-06-15 18:00:04,2021-06-15 18:01:31.355000
5314,100680,4,100680,39,10140,39,12,1,12,Relationship with Co-Workers,3,10140,110,2021-06-15 18:00:04,2021-06-15 18:01:31.355000
5315,100681,1,100681,46,10140,46,13,1,13,General Satisfaction,3,10140,110,2021-06-15 18:00:04,2021-06-15 18:01:31.355000
5316,100682,6,100682,54,10140,54,14,1,14,Relationship with Supervisor,3,10140,110,2021-06-15 18:00:04,2021-06-15 18:01:31.355000
5317,100683,2,100683,56,10140,56,15,1,15,Company Administration,3,10140,110,2021-06-15 18:00:04,2021-06-15 18:01:31.355000
5318,100689,1,100689,38,10142,38,11,1,11,Compensation and Benefits,3,10142,112,2021-06-15 18:00:04,2021-06-15 18:00:55.150900
5319,100690,1,100690,41,10142,41,12,1,12,Relationship with Co-Workers,3,10142,112,2021-06-15 18:00:04,2021-06-15 18:00:55.150900
5320,100691,1,100691,47,10142,47,13,1,13,General Satisfaction,3,10142,112,2021-06-15 18:00:04,2021-06-15 18:00:55.150900
5321,100692,1,100692,50,10142,50,14,1,14,Relationship with Supervisor,3,10142,112,2021-06-15 18:00:04,2021-06-15 18:00:55.150900
5322,100693,1,100693,58,10142,58,15,1,15,Company Administration,3,10142,112,2021-06-15 18:00:04,2021-06-15 18:00:55.150900
5323,100963,3,100963,38,10200,38,11,1,11,Compensation and Benefits,3,10200,116,2021-06-17 18:00:03,2021-06-17 18:31:34.434354
5324,100964,3,100964,41,10200,41,12,1,12,Relationship with Co-Workers,3,10200,116,2021-06-17 18:00:03,2021-06-17 18:31:34.434354
5325,100965,4,100965,49,10200,49,13,1,13,General Satisfaction,3,10200,116,2021-06-17 18:00:03,2021-06-17 18:31:34.434354
5326,100967,3,100967,58,10200,58,15,1,15,Company Administration,3,10200,116,2021-06-17 18:00:03,2021-06-17 18:31:34.434354
5327,100966,3,100966,51,10200,51,15,1,15,Company Administration,3,10200,116,2021-06-17 18:00:03,2021-06-17 18:31:34.434354
5328,100988,5,100988,38,10205,38,11,1,11,Compensation and Benefits,3,10205,109,2021-06-22 18:00:03,2021-06-22 18:01:50.508337
5329,100989,4,100989,39,10205,39,12,1,12,Relationship with Co-Workers,3,10205,109,2021-06-22 18:00:03,2021-06-22 18:01:50.508337
5330,100992,2,100992,56,10205,56,15,1,15,Company Administration,3,10205,109,2021-06-22 18:00:03,2021-06-22 18:01:50.508337
5331,100990,3,100990,44,10205,44,15,1,15,Company Administration,3,10205,109,2021-06-22 18:00:03,2021-06-22 18:01:50.508337
5332,100991,3,100991,52,10205,52,15,1,15,Company Administration,3,10205,109,2021-06-22 18:00:03,2021-06-22 18:01:50.508337
5333,100998,4,100998,38,10207,38,11,1,11,Compensation and Benefits,3,10207,111,2021-06-22 18:00:03,2021-06-22 18:39:17.385128
5334,100999,3,100999,39,10207,39,12,1,12,Relationship with Co-Workers,3,10207,111,2021-06-22 18:00:03,2021-06-22 18:39:17.385128
5335,101001,3,101001,54,10207,54,14,1,14,Relationship with Supervisor,3,10207,111,2021-06-22 18:00:03,2021-06-22 18:39:17.385128
5336,101002,2,101002,57,10207,57,15,1,15,Company Administration,3,10207,111,2021-06-22 18:00:03,2021-06-22 18:39:17.385128
5337,101000,4,101000,44,10207,44,15,1,15,Company Administration,3,10207,111,2021-06-22 18:00:03,2021-06-22 18:39:17.385128
5338,101003,1,101003,38,10208,38,11,1,11,Compensation and Benefits,3,10208,112,2021-06-22 18:00:04,2021-06-22 18:17:33.070328
5339,101004,1,101004,40,10208,40,12,1,12,Relationship with Co-Workers,3,10208,112,2021-06-22 18:00:04,2021-06-22 18:17:33.070328
5340,101005,1,101005,46,10208,46,13,1,13,General Satisfaction,3,10208,112,2021-06-22 18:00:04,2021-06-22 18:17:33.070328
5341,101007,1,101007,58,10208,58,15,1,15,Company Administration,3,10208,112,2021-06-22 18:00:04,2021-06-22 18:17:33.070328
5342,101006,1,101006,52,10208,52,15,1,15,Company Administration,3,10208,112,2021-06-22 18:00:04,2021-06-22 18:17:33.070328
5343,101262,3,101262,38,10263,38,11,1,11,Compensation and Benefits,3,10263,113,2021-06-24 18:00:03,2021-06-24 22:04:10.996362
5344,101263,1,101263,39,10263,39,12,1,12,Relationship with Co-Workers,3,10263,113,2021-06-24 18:00:03,2021-06-24 22:04:10.996362
5345,101264,4,101264,48,10263,48,13,1,13,General Satisfaction,3,10263,113,2021-06-24 18:00:03,2021-06-24 22:04:10.996362
5346,101265,2,101265,50,10263,50,14,1,14,Relationship with Supervisor,3,10263,113,2021-06-24 18:00:03,2021-06-24 22:04:10.996362
5347,101266,1,101266,57,10263,57,15,1,15,Company Administration,3,10263,113,2021-06-24 18:00:03,2021-06-24 22:04:10.996362
5348,101272,4,101272,38,10265,38,11,1,11,Compensation and Benefits,3,10265,115,2021-06-24 18:00:03,2021-06-24 18:09:53.105217
5349,101273,4,101273,40,10265,40,12,1,12,Relationship with Co-Workers,3,10265,115,2021-06-24 18:00:03,2021-06-24 18:09:53.105217
5350,101274,4,101274,49,10265,49,13,1,13,General Satisfaction,3,10265,115,2021-06-24 18:00:03,2021-06-24 18:09:53.105217
5351,101275,3,101275,54,10265,54,14,1,14,Relationship with Supervisor,3,10265,115,2021-06-24 18:00:03,2021-06-24 18:09:53.105217
5352,101276,3,101276,56,10265,56,15,1,15,Company Administration,3,10265,115,2021-06-24 18:00:03,2021-06-24 18:09:53.105217
5353,101277,3,101277,38,10266,38,11,1,11,Compensation and Benefits,3,10266,116,2021-06-24 18:00:04,2021-06-24 22:21:45.054173
5354,101278,4,101278,43,10266,43,12,1,12,Relationship with Co-Workers,3,10266,116,2021-06-24 18:00:04,2021-06-24 22:21:45.054173
5355,101279,3,101279,45,10266,45,13,1,13,General Satisfaction,3,10266,116,2021-06-24 18:00:04,2021-06-24 22:21:45.054173
5356,101281,3,101281,57,10266,57,15,1,15,Company Administration,3,10266,116,2021-06-24 18:00:04,2021-06-24 22:21:45.054173
5357,101280,3,101280,52,10266,52,15,1,15,Company Administration,3,10266,116,2021-06-24 18:00:04,2021-06-24 22:21:45.054173
5358,101282,5,101282,38,10267,38,11,1,11,Compensation and Benefits,3,10267,117,2021-06-24 18:00:04,2021-06-24 18:27:47.592105
5359,101283,2,101283,43,10267,43,12,1,12,Relationship with Co-Workers,3,10267,117,2021-06-24 18:00:04,2021-06-24 18:27:47.592105
5360,101284,5,101284,48,10267,48,13,1,13,General Satisfaction,3,10267,117,2021-06-24 18:00:04,2021-06-24 18:27:47.592105
5361,101285,5,101285,50,10267,50,14,1,14,Relationship with Supervisor,3,10267,117,2021-06-24 18:00:04,2021-06-24 18:27:47.592105
5362,101286,1,101286,55,10267,55,15,1,15,Company Administration,3,10267,117,2021-06-24 18:00:04,2021-06-24 18:27:47.592105
5363,101307,2,101307,38,10272,38,11,1,11,Compensation and Benefits,3,10272,110,2021-06-29 18:00:03,2021-06-29 18:02:33.629019
5364,101308,5,101308,40,10272,40,12,1,12,Relationship with Co-Workers,3,10272,110,2021-06-29 18:00:03,2021-06-29 18:02:33.629019
5365,101309,4,101309,44,10272,44,15,1,15,Company Administration,3,10272,110,2021-06-29 18:00:03,2021-06-29 18:02:33.629019
5366,101311,5,101311,55,10272,55,15,1,15,Company Administration,3,10272,110,2021-06-29 18:00:03,2021-06-29 18:02:33.629019
5367,101310,5,101310,52,10272,52,15,1,15,Company Administration,3,10272,110,2021-06-29 18:00:03,2021-06-29 18:02:33.629019
5368,101551,4,101551,38,10324,38,11,1,11,Compensation and Benefits,3,10324,108,2021-07-01 18:00:02,2021-07-01 18:01:00.450419
5369,101552,3,101552,41,10324,41,12,1,12,Relationship with Co-Workers,3,10324,108,2021-07-01 18:00:02,2021-07-01 18:01:00.450419
5370,101553,4,101553,48,10324,48,13,1,13,General Satisfaction,3,10324,108,2021-07-01 18:00:02,2021-07-01 18:01:00.450419
5371,101555,3,101555,55,10324,55,15,1,15,Company Administration,3,10324,108,2021-07-01 18:00:02,2021-07-01 18:01:00.450419
5372,101554,2,101554,52,10324,52,15,1,15,Company Administration,3,10324,108,2021-07-01 18:00:02,2021-07-01 18:01:00.450419
5373,101561,4,101561,38,10326,38,11,1,11,Compensation and Benefits,3,10326,110,2021-07-01 18:00:03,2021-07-01 18:41:44.486402
5374,101562,5,101562,40,10326,40,12,1,12,Relationship with Co-Workers,3,10326,110,2021-07-01 18:00:03,2021-07-01 18:41:44.486402
5375,101563,5,101563,47,10326,47,13,1,13,General Satisfaction,3,10326,110,2021-07-01 18:00:03,2021-07-01 18:41:44.486402
5376,101565,2,101565,55,10326,55,15,1,15,Company Administration,3,10326,110,2021-07-01 18:00:03,2021-07-01 18:41:44.486402
5377,101564,5,101564,51,10326,51,15,1,15,Company Administration,3,10326,110,2021-07-01 18:00:03,2021-07-01 18:41:44.486402
5378,101566,4,101566,38,10327,38,11,1,11,Compensation and Benefits,3,10327,111,2021-07-01 18:00:03,2021-07-01 18:42:56.885337
5379,101567,4,101567,42,10327,42,12,1,12,Relationship with Co-Workers,3,10327,111,2021-07-01 18:00:03,2021-07-01 18:42:56.885337
5380,101568,4,101568,46,10327,46,13,1,13,General Satisfaction,3,10327,111,2021-07-01 18:00:03,2021-07-01 18:42:56.885337
5381,101569,4,101569,53,10327,53,14,1,14,Relationship with Supervisor,3,10327,111,2021-07-01 18:00:03,2021-07-01 18:42:56.885337
5382,101570,4,101570,57,10327,57,15,1,15,Company Administration,3,10327,111,2021-07-01 18:00:03,2021-07-01 18:42:56.885337
5383,101576,3,101576,38,10329,38,11,1,11,Compensation and Benefits,3,10329,113,2021-07-01 18:00:03,2021-07-01 23:50:46.386254
5384,101577,5,101577,42,10329,42,12,1,12,Relationship with Co-Workers,3,10329,113,2021-07-01 18:00:03,2021-07-01 23:50:46.386254
5385,101578,5,101578,47,10329,47,13,1,13,General Satisfaction,3,10329,113,2021-07-01 18:00:03,2021-07-01 23:50:46.386254
5386,101579,5,101579,54,10329,54,14,1,14,Relationship with Supervisor,3,10329,113,2021-07-01 18:00:03,2021-07-01 23:50:46.386254
5387,101580,1,101580,57,10329,57,15,1,15,Company Administration,3,10329,113,2021-07-01 18:00:03,2021-07-01 23:50:46.386254
5388,101651,2,101651,38,10344,38,11,1,11,Compensation and Benefits,3,10344,116,2021-07-06 18:00:04,2021-07-06 20:50:04.301403
5389,101652,4,101652,43,10344,43,12,1,12,Relationship with Co-Workers,3,10344,116,2021-07-06 18:00:04,2021-07-06 20:50:04.301403
5390,101653,4,101653,49,10344,49,13,1,13,General Satisfaction,3,10344,116,2021-07-06 18:00:04,2021-07-06 20:50:04.301403
5391,101654,3,101654,54,10344,54,14,1,14,Relationship with Supervisor,3,10344,116,2021-07-06 18:00:04,2021-07-06 20:50:04.301403
5392,101655,2,101655,58,10344,58,15,1,15,Company Administration,3,10344,116,2021-07-06 18:00:04,2021-07-06 20:50:04.301403
5393,101860,4,101860,38,10389,38,11,1,11,Compensation and Benefits,3,10389,107,2021-07-08 18:00:01,2021-07-08 20:48:23.362479
5394,101861,2,101861,43,10389,43,12,1,12,Relationship with Co-Workers,3,10389,107,2021-07-08 18:00:01,2021-07-08 20:48:23.362479
5395,101863,4,101863,53,10389,53,14,1,14,Relationship with Supervisor,3,10389,107,2021-07-08 18:00:01,2021-07-08 20:48:23.362479
5396,101864,3,101864,56,10389,56,15,1,15,Company Administration,3,10389,107,2021-07-08 18:00:01,2021-07-08 20:48:23.362479
5397,101862,3,101862,44,10389,44,15,1,15,Company Administration,3,10389,107,2021-07-08 18:00:01,2021-07-08 20:48:23.362479
5398,101910,5,101910,38,10399,38,11,1,11,Compensation and Benefits,3,10399,117,2021-07-08 18:00:03,2021-07-08 18:31:50.851128
5399,101911,3,101911,42,10399,42,12,1,12,Relationship with Co-Workers,3,10399,117,2021-07-08 18:00:03,2021-07-08 18:31:50.851128
5400,101912,5,101912,48,10399,48,13,1,13,General Satisfaction,3,10399,117,2021-07-08 18:00:03,2021-07-08 18:31:50.851128
5401,101914,2,101914,55,10399,55,15,1,15,Company Administration,3,10399,117,2021-07-08 18:00:03,2021-07-08 18:31:50.851128
5402,101913,5,101913,51,10399,51,15,1,15,Company Administration,3,10399,117,2021-07-08 18:00:03,2021-07-08 18:31:50.851128
5403,101915,5,101915,38,10400,38,11,1,11,Compensation and Benefits,3,10400,118,2021-07-08 18:00:03,2021-07-08 18:40:32.925117
5404,101916,4,101916,41,10400,41,12,1,12,Relationship with Co-Workers,3,10400,118,2021-07-08 18:00:03,2021-07-08 18:40:32.925117
5405,101917,3,101917,46,10400,46,13,1,13,General Satisfaction,3,10400,118,2021-07-08 18:00:03,2021-07-08 18:40:32.925117
5406,101918,4,101918,50,10400,50,14,1,14,Relationship with Supervisor,3,10400,118,2021-07-08 18:00:03,2021-07-08 18:40:32.925117
5407,101919,3,101919,55,10400,55,15,1,15,Company Administration,3,10400,118,2021-07-08 18:00:03,2021-07-08 18:40:32.925117
5408,102534,3,102534,38,10542,38,11,1,11,Compensation and Benefits,3,10542,107,2021-08-10 18:00:01,2021-08-10 19:30:06.853541
5409,102535,5,102535,111,10542,111,12,1,12,Relationship with Co-Workers,3,10542,107,2021-08-10 18:00:01,2021-08-10 19:30:06.853541
5410,102536,4,102536,45,10542,45,13,1,13,General Satisfaction,3,10542,107,2021-08-10 18:00:01,2021-08-10 19:30:06.853541
5411,102537,3,102537,53,10542,53,14,1,14,Relationship with Supervisor,3,10542,107,2021-08-10 18:00:01,2021-08-10 19:30:06.853541
5412,102538,3,102538,115,10542,115,15,1,15,Company Administration,3,10542,107,2021-08-10 18:00:01,2021-08-10 19:30:06.853541
5413,102539,2,102539,34,10542,34,26,1,26,Direct Questions,3,10542,107,2021-08-10 18:00:01,2021-08-10 19:30:06.853541
5414,102570,3,102570,38,10548,38,11,1,11,Compensation and Benefits,3,10548,114,2021-08-10 18:00:03,2021-08-10 18:34:57.856622
5415,102571,4,102571,113,10548,113,12,1,12,Relationship with Co-Workers,3,10548,114,2021-08-10 18:00:03,2021-08-10 18:34:57.856622
5416,102572,4,102572,49,10548,49,13,1,13,General Satisfaction,3,10548,114,2021-08-10 18:00:03,2021-08-10 18:34:57.856622
5417,102573,2,102573,50,10548,50,14,1,14,Relationship with Supervisor,3,10548,114,2021-08-10 18:00:03,2021-08-10 18:34:57.856622
5418,102574,3,102574,52,10548,52,15,1,15,Company Administration,3,10548,114,2021-08-10 18:00:03,2021-08-10 18:34:57.856622
5419,102575,4,102575,34,10548,34,26,1,26,Direct Questions,3,10548,114,2021-08-10 18:00:03,2021-08-10 18:34:57.856622
5420,102576,5,102576,38,10549,38,11,1,11,Compensation and Benefits,3,10549,115,2021-08-10 18:00:03,2021-08-10 18:08:12.994825
5421,102577,4,102577,40,10549,40,12,1,12,Relationship with Co-Workers,3,10549,115,2021-08-10 18:00:03,2021-08-10 18:08:12.994825
5422,102578,5,102578,48,10549,48,13,1,13,General Satisfaction,3,10549,115,2021-08-10 18:00:03,2021-08-10 18:08:12.994825
5423,102579,3,102579,121,10549,121,14,1,14,Relationship with Supervisor,3,10549,115,2021-08-10 18:00:03,2021-08-10 18:08:12.994825
5424,102580,6,102580,51,10549,51,15,1,15,Company Administration,3,10549,115,2021-08-10 18:00:03,2021-08-10 18:08:12.994825
5425,102581,5,102581,35,10549,35,26,1,26,Direct Questions,3,10549,115,2021-08-10 18:00:03,2021-08-10 18:08:12.994825
5426,102788,3,102788,38,10594,38,11,1,11,Compensation and Benefits,3,10594,114,2021-08-12 18:00:02,2021-08-12 18:35:44.151288
5427,102789,5,102789,43,10594,43,12,1,12,Relationship with Co-Workers,3,10594,114,2021-08-12 18:00:02,2021-08-12 18:35:44.151288
5428,102790,4,102790,49,10594,49,13,1,13,General Satisfaction,3,10594,114,2021-08-12 18:00:02,2021-08-12 18:35:44.151288
5429,102791,4,102791,123,10594,123,14,1,14,Relationship with Supervisor,3,10594,114,2021-08-12 18:00:02,2021-08-12 18:35:44.151288
5430,102792,3,102792,116,10594,116,15,1,15,Company Administration,3,10594,114,2021-08-12 18:00:02,2021-08-12 18:35:44.151288
5431,102793,5,102793,35,10594,35,26,1,26,Direct Questions,3,10594,114,2021-08-12 18:00:02,2021-08-12 18:35:44.151288
5432,102800,1,102800,38,10596,38,11,1,11,Compensation and Benefits,3,10596,116,2021-08-12 18:00:02,2021-08-12 18:39:29.809612
5433,102801,3,102801,111,10596,111,12,1,12,Relationship with Co-Workers,3,10596,116,2021-08-12 18:00:02,2021-08-12 18:39:29.809612
5434,102802,3,102802,118,10596,118,13,1,13,General Satisfaction,3,10596,116,2021-08-12 18:00:02,2021-08-12 18:39:29.809612
5435,102803,1,102803,50,10596,50,14,1,14,Relationship with Supervisor,3,10596,116,2021-08-12 18:00:02,2021-08-12 18:39:29.809612
5436,102804,2,102804,58,10596,58,15,1,15,Company Administration,3,10596,116,2021-08-12 18:00:02,2021-08-12 18:39:29.809612
5437,102805,5,102805,35,10596,35,26,1,26,Direct Questions,3,10596,116,2021-08-12 18:00:02,2021-08-12 18:39:29.809612
5438,102836,4,102836,38,10602,38,11,1,11,Compensation and Benefits,3,10602,108,2021-08-17 18:00:02,2021-08-17 21:23:41.445786
5439,102837,3,102837,43,10602,43,12,1,12,Relationship with Co-Workers,3,10602,108,2021-08-17 18:00:02,2021-08-17 21:23:41.445786
5440,102838,4,102838,45,10602,45,13,1,13,General Satisfaction,3,10602,108,2021-08-17 18:00:02,2021-08-17 21:23:41.445786
5441,102839,4,102839,123,10602,123,14,1,14,Relationship with Supervisor,3,10602,108,2021-08-17 18:00:02,2021-08-17 21:23:41.445786
5442,102840,4,102840,55,10602,55,15,1,15,Company Administration,3,10602,108,2021-08-17 18:00:02,2021-08-17 21:23:41.445786
5443,102841,4,102841,35,10602,35,26,1,26,Direct Questions,3,10602,108,2021-08-17 18:00:02,2021-08-17 21:23:41.445786
5444,102848,2,102848,38,10604,38,11,1,11,Compensation and Benefits,3,10604,110,2021-08-17 18:00:02,2021-08-17 18:38:37.269174
5445,102849,5,102849,113,10604,113,12,1,12,Relationship with Co-Workers,3,10604,110,2021-08-17 18:00:02,2021-08-17 18:38:37.269174
5446,102850,2,102850,119,10604,119,13,1,13,General Satisfaction,3,10604,110,2021-08-17 18:00:02,2021-08-17 18:38:37.269174
5447,102851,6,102851,123,10604,123,14,1,14,Relationship with Supervisor,3,10604,110,2021-08-17 18:00:02,2021-08-17 18:38:37.269174
5448,102852,5,102852,57,10604,57,15,1,15,Company Administration,3,10604,110,2021-08-17 18:00:02,2021-08-17 18:38:37.269174
5449,102853,1,102853,35,10604,35,26,1,26,Direct Questions,3,10604,110,2021-08-17 18:00:02,2021-08-17 18:38:37.269174
5450,102860,3,102860,38,10606,38,11,1,11,Compensation and Benefits,3,10606,113,2021-08-17 18:00:02,2021-08-17 18:40:28.252200
5451,102861,4,102861,39,10606,39,12,1,12,Relationship with Co-Workers,3,10606,113,2021-08-17 18:00:02,2021-08-17 18:40:28.252200
5452,102862,5,102862,45,10606,45,13,1,13,General Satisfaction,3,10606,113,2021-08-17 18:00:02,2021-08-17 18:40:28.252200
5453,102863,2,102863,120,10606,120,14,1,14,Relationship with Supervisor,3,10606,113,2021-08-17 18:00:02,2021-08-17 18:40:28.252200
5454,102864,2,102864,56,10606,56,15,1,15,Company Administration,3,10606,113,2021-08-17 18:00:02,2021-08-17 18:40:28.252200
5455,102865,5,102865,34,10606,34,26,1,26,Direct Questions,3,10606,113,2021-08-17 18:00:02,2021-08-17 18:40:28.252200
5456,103066,4,103066,38,10650,38,11,1,11,Compensation and Benefits,3,10650,110,2021-08-19 18:00:02,2021-08-19 19:27:28.612404
5457,103067,6,103067,113,10650,113,12,1,12,Relationship with Co-Workers,3,10650,110,2021-08-19 18:00:02,2021-08-19 19:27:28.612404
5458,103068,3,103068,49,10650,49,13,1,13,General Satisfaction,3,10650,110,2021-08-19 18:00:02,2021-08-19 19:27:28.612404
5459,103069,6,103069,122,10650,122,14,1,14,Relationship with Supervisor,3,10650,110,2021-08-19 18:00:02,2021-08-19 19:27:28.612404
5460,103070,6,103070,55,10650,55,15,1,15,Company Administration,3,10650,110,2021-08-19 18:00:02,2021-08-19 19:27:28.612404
5461,103071,1,103071,36,10650,36,26,1,26,Direct Questions,3,10650,110,2021-08-19 18:00:02,2021-08-19 19:27:28.612404
5462,103144,3,103144,38,10663,38,11,1,11,Compensation and Benefits,3,10663,110,2021-08-24 18:00:02,2021-08-24 18:40:12.415421
5463,103145,1,103145,42,10663,42,12,1,12,Relationship with Co-Workers,3,10663,110,2021-08-24 18:00:02,2021-08-24 18:40:12.415421
5464,103146,5,103146,46,10663,46,13,1,13,General Satisfaction,3,10663,110,2021-08-24 18:00:02,2021-08-24 18:40:12.415421
5465,103147,5,103147,54,10663,54,14,1,14,Relationship with Supervisor,3,10663,110,2021-08-24 18:00:02,2021-08-24 18:40:12.415421
5466,103148,6,103148,114,10663,114,15,1,15,Company Administration,3,10663,110,2021-08-24 18:00:02,2021-08-24 18:40:12.415421
5467,103149,5,103149,34,10663,34,26,1,26,Direct Questions,3,10663,110,2021-08-24 18:00:02,2021-08-24 18:40:12.415421
5468,103162,3,103162,38,10666,38,11,1,11,Compensation and Benefits,3,10666,114,2021-08-24 18:00:02,2021-08-24 21:05:30.496574
5469,103163,3,103163,40,10666,40,12,1,12,Relationship with Co-Workers,3,10666,114,2021-08-24 18:00:02,2021-08-24 21:05:30.496574
5470,103164,4,103164,48,10666,48,13,1,13,General Satisfaction,3,10666,114,2021-08-24 18:00:02,2021-08-24 21:05:30.496574
5471,103165,3,103165,123,10666,123,14,1,14,Relationship with Supervisor,3,10666,114,2021-08-24 18:00:02,2021-08-24 21:05:30.496574
5472,103166,4,103166,44,10666,44,15,1,15,Company Administration,3,10666,114,2021-08-24 18:00:02,2021-08-24 21:05:30.496574
5473,103167,5,103167,34,10666,34,26,1,26,Direct Questions,3,10666,114,2021-08-24 18:00:02,2021-08-24 21:05:30.496574
5474,103262,2,103262,38,10684,38,11,1,11,Compensation and Benefits,3,10684,110,2021-08-26 18:00:02,2021-08-26 18:31:20.504044
5475,103263,6,103263,111,10684,111,12,1,12,Relationship with Co-Workers,3,10684,110,2021-08-26 18:00:02,2021-08-26 18:31:20.504044
5476,103264,6,103264,48,10684,48,13,1,13,General Satisfaction,3,10684,110,2021-08-26 18:00:02,2021-08-26 18:31:20.504044
5477,103265,6,103265,123,10684,123,14,1,14,Relationship with Supervisor,3,10684,110,2021-08-26 18:00:02,2021-08-26 18:31:20.504044
5478,103266,6,103266,58,10684,58,15,1,15,Company Administration,3,10684,110,2021-08-26 18:00:02,2021-08-26 18:31:20.504044
5479,103267,1,103267,35,10684,35,26,1,26,Direct Questions,3,10684,110,2021-08-26 18:00:02,2021-08-26 18:31:20.504044
5480,103280,3,103280,38,10687,38,11,1,11,Compensation and Benefits,3,10687,114,2021-08-26 18:00:03,2021-08-26 18:43:25.599133
5481,103281,4,103281,41,10687,41,12,1,12,Relationship with Co-Workers,3,10687,114,2021-08-26 18:00:03,2021-08-26 18:43:25.599133
5482,103282,4,103282,48,10687,48,13,1,13,General Satisfaction,3,10687,114,2021-08-26 18:00:03,2021-08-26 18:43:25.599133
5483,103283,4,103283,122,10687,122,14,1,14,Relationship with Supervisor,3,10687,114,2021-08-26 18:00:03,2021-08-26 18:43:25.599133
5484,103284,4,103284,116,10687,116,15,1,15,Company Administration,3,10687,114,2021-08-26 18:00:03,2021-08-26 18:43:25.599133
5485,103285,5,103285,36,10687,36,26,1,26,Direct Questions,3,10687,114,2021-08-26 18:00:03,2021-08-26 18:43:25.599133
5486,103328,4,103328,38,10695,38,11,1,11,Compensation and Benefits,3,10695,108,2021-08-31 18:00:02,2021-08-31 18:02:01.235480
5487,103329,4,103329,111,10695,111,12,1,12,Relationship with Co-Workers,3,10695,108,2021-08-31 18:00:02,2021-08-31 18:02:01.235480
5488,103330,4,103330,117,10695,117,13,1,13,General Satisfaction,3,10695,108,2021-08-31 18:00:02,2021-08-31 18:02:01.235480
5489,103331,5,103331,122,10695,122,14,1,14,Relationship with Supervisor,3,10695,108,2021-08-31 18:00:02,2021-08-31 18:02:01.235480
5490,103332,4,103332,56,10695,56,15,1,15,Company Administration,3,10695,108,2021-08-31 18:00:02,2021-08-31 18:02:01.235480
5491,103333,6,103333,35,10695,35,26,1,26,Direct Questions,3,10695,108,2021-08-31 18:00:02,2021-08-31 18:02:01.235480
5492,103334,3,103334,38,10696,38,11,1,11,Compensation and Benefits,3,10696,109,2021-08-31 18:00:02,2021-08-31 18:56:38.879022
5493,103335,4,103335,113,10696,113,12,1,12,Relationship with Co-Workers,3,10696,109,2021-08-31 18:00:02,2021-08-31 18:56:38.879022
5494,103336,4,103336,49,10696,49,13,1,13,General Satisfaction,3,10696,109,2021-08-31 18:00:02,2021-08-31 18:56:38.879022
5495,103337,5,103337,53,10696,53,14,1,14,Relationship with Supervisor,3,10696,109,2021-08-31 18:00:02,2021-08-31 18:56:38.879022
5496,103338,3,103338,51,10696,51,15,1,15,Company Administration,3,10696,109,2021-08-31 18:00:02,2021-08-31 18:56:38.879022
5497,103339,5,103339,36,10696,36,26,1,26,Direct Questions,3,10696,109,2021-08-31 18:00:02,2021-08-31 18:56:38.879022
5498,103364,5,103364,38,10701,38,11,1,11,Compensation and Benefits,3,10701,115,2021-08-31 18:00:03,2021-08-31 18:05:09.314126
5499,103365,4,103365,111,10701,111,12,1,12,Relationship with Co-Workers,3,10701,115,2021-08-31 18:00:03,2021-08-31 18:05:09.314126
5500,103366,6,103366,45,10701,45,13,1,13,General Satisfaction,3,10701,115,2021-08-31 18:00:03,2021-08-31 18:05:09.314126
5501,103367,6,103367,120,10701,120,14,1,14,Relationship with Supervisor,3,10701,115,2021-08-31 18:00:03,2021-08-31 18:05:09.314126
5502,103368,5,103368,115,10701,115,15,1,15,Company Administration,3,10701,115,2021-08-31 18:00:03,2021-08-31 18:05:09.314126
5503,103369,6,103369,35,10701,35,26,1,26,Direct Questions,3,10701,115,2021-08-31 18:00:03,2021-08-31 18:05:09.314126
5504,103382,5,103382,38,10704,38,11,1,11,Compensation and Benefits,3,10704,118,2021-08-31 18:00:04,2021-08-31 19:07:28.088515
5505,103383,3,103383,43,10704,43,12,1,12,Relationship with Co-Workers,3,10704,118,2021-08-31 18:00:04,2021-08-31 19:07:28.088515
5506,103384,3,103384,118,10704,118,13,1,13,General Satisfaction,3,10704,118,2021-08-31 18:00:04,2021-08-31 19:07:28.088515
5507,103385,2,103385,53,10704,53,14,1,14,Relationship with Supervisor,3,10704,118,2021-08-31 18:00:04,2021-08-31 19:07:28.088515
5508,103386,4,103386,116,10704,116,15,1,15,Company Administration,3,10704,118,2021-08-31 18:00:04,2021-08-31 19:07:28.088515
5509,103387,6,103387,35,10704,35,26,1,26,Direct Questions,3,10704,118,2021-08-31 18:00:04,2021-08-31 19:07:28.088515
5510,103464,4,103464,38,10719,38,11,1,11,Compensation and Benefits,3,10719,113,2021-09-02 18:00:02,2021-09-02 18:36:43.560871
5511,103465,3,103465,43,10719,43,12,1,12,Relationship with Co-Workers,3,10719,113,2021-09-02 18:00:02,2021-09-02 18:36:43.560871
5512,103466,4,103466,45,10719,45,13,1,13,General Satisfaction,3,10719,113,2021-09-02 18:00:02,2021-09-02 18:36:43.560871
5513,103467,2,103467,54,10719,54,14,1,14,Relationship with Supervisor,3,10719,113,2021-09-02 18:00:02,2021-09-02 18:36:43.560871
5514,103468,4,103468,58,10719,58,15,1,15,Company Administration,3,10719,113,2021-09-02 18:00:02,2021-09-02 18:36:43.560871
5515,103469,4,103469,36,10719,36,26,1,26,Direct Questions,3,10719,113,2021-09-02 18:00:02,2021-09-02 18:36:43.560871
5516,103494,4,103494,38,10724,38,11,1,11,Compensation and Benefits,3,10724,118,2021-09-02 18:00:05,2021-09-02 18:13:53.884241
5517,103495,4,103495,111,10724,111,12,1,12,Relationship with Co-Workers,3,10724,118,2021-09-02 18:00:05,2021-09-02 18:13:53.884241
5518,103496,4,103496,48,10724,48,13,1,13,General Satisfaction,3,10724,118,2021-09-02 18:00:05,2021-09-02 18:13:53.884241
5519,103497,4,103497,123,10724,123,14,1,14,Relationship with Supervisor,3,10724,118,2021-09-02 18:00:05,2021-09-02 18:13:53.884241
5520,103498,4,103498,116,10724,116,15,1,15,Company Administration,3,10724,118,2021-09-02 18:00:05,2021-09-02 18:13:53.884241
5521,103499,6,103499,36,10724,36,26,1,26,Direct Questions,3,10724,118,2021-09-02 18:00:05,2021-09-02 18:13:53.884241
5522,103506,2,103506,38,10726,38,11,1,11,Compensation and Benefits,3,10726,107,2021-09-07 18:00:02,2021-09-07 19:23:40.901644
5523,103507,4,103507,111,10726,111,12,1,12,Relationship with Co-Workers,3,10726,107,2021-09-07 18:00:02,2021-09-07 19:23:40.901644
5524,103508,4,103508,48,10726,48,13,1,13,General Satisfaction,3,10726,107,2021-09-07 18:00:02,2021-09-07 19:23:40.901644
5525,103509,6,103509,123,10726,123,14,1,14,Relationship with Supervisor,3,10726,107,2021-09-07 18:00:02,2021-09-07 19:23:40.901644
5526,103510,3,103510,52,10726,52,15,1,15,Company Administration,3,10726,107,2021-09-07 18:00:02,2021-09-07 19:23:40.901644
5527,103511,6,103511,36,10726,36,26,1,26,Direct Questions,3,10726,107,2021-09-07 18:00:02,2021-09-07 19:23:40.901644
5528,103512,4,103512,38,10727,38,11,1,11,Compensation and Benefits,3,10727,108,2021-09-07 18:00:02,2021-09-07 18:00:43.559125
5529,103513,3,103513,40,10727,40,12,1,12,Relationship with Co-Workers,3,10727,108,2021-09-07 18:00:02,2021-09-07 18:00:43.559125
5530,103514,4,103514,117,10727,117,13,1,13,General Satisfaction,3,10727,108,2021-09-07 18:00:02,2021-09-07 18:00:43.559125
5531,103515,4,103515,121,10727,121,14,1,14,Relationship with Supervisor,3,10727,108,2021-09-07 18:00:02,2021-09-07 18:00:43.559125
5532,103516,4,103516,57,10727,57,15,1,15,Company Administration,3,10727,108,2021-09-07 18:00:02,2021-09-07 18:00:43.559125
5533,103517,6,103517,34,10727,34,26,1,26,Direct Questions,3,10727,108,2021-09-07 18:00:02,2021-09-07 18:00:43.559125
5534,103518,3,103518,38,10728,38,11,1,11,Compensation and Benefits,3,10728,109,2021-09-07 18:00:02,2021-09-07 18:37:15.598954
5535,103519,4,103519,111,10728,111,12,1,12,Relationship with Co-Workers,3,10728,109,2021-09-07 18:00:02,2021-09-07 18:37:15.598954
5536,103520,4,103520,118,10728,118,13,1,13,General Satisfaction,3,10728,109,2021-09-07 18:00:02,2021-09-07 18:37:15.598954
5537,103521,4,103521,122,10728,122,14,1,14,Relationship with Supervisor,3,10728,109,2021-09-07 18:00:02,2021-09-07 18:37:15.598954
5538,103522,4,103522,52,10728,52,15,1,15,Company Administration,3,10728,109,2021-09-07 18:00:02,2021-09-07 18:37:15.598954
5539,103523,5,103523,36,10728,36,26,1,26,Direct Questions,3,10728,109,2021-09-07 18:00:02,2021-09-07 18:37:15.598954
5540,103524,2,103524,38,10729,38,11,1,11,Compensation and Benefits,3,10729,110,2021-09-07 18:00:02,2021-09-07 18:31:49.153309
5541,103525,1,103525,41,10729,41,12,1,12,Relationship with Co-Workers,3,10729,110,2021-09-07 18:00:02,2021-09-07 18:31:49.153309
5542,103526,5,103526,48,10729,48,13,1,13,General Satisfaction,3,10729,110,2021-09-07 18:00:02,2021-09-07 18:31:49.153309
5543,103527,6,103527,54,10729,54,14,1,14,Relationship with Supervisor,3,10729,110,2021-09-07 18:00:02,2021-09-07 18:31:49.153309
5544,103528,6,103528,55,10729,55,15,1,15,Company Administration,3,10729,110,2021-09-07 18:00:02,2021-09-07 18:31:49.153309
5545,103529,1,103529,34,10729,34,26,1,26,Direct Questions,3,10729,110,2021-09-07 18:00:02,2021-09-07 18:31:49.153309
5546,103530,3,103530,38,10730,38,11,1,11,Compensation and Benefits,3,10730,111,2021-09-07 18:00:03,2021-09-07 18:33:37.439466
5547,103531,4,103531,43,10730,43,12,1,12,Relationship with Co-Workers,3,10730,111,2021-09-07 18:00:03,2021-09-07 18:33:37.439466
5548,103532,5,103532,46,10730,46,13,1,13,General Satisfaction,3,10730,111,2021-09-07 18:00:03,2021-09-07 18:33:37.439466
5549,103533,4,103533,54,10730,54,14,1,14,Relationship with Supervisor,3,10730,111,2021-09-07 18:00:03,2021-09-07 18:33:37.439466
5550,103534,4,103534,114,10730,114,15,1,15,Company Administration,3,10730,111,2021-09-07 18:00:03,2021-09-07 18:33:37.439466
5551,103535,5,103535,34,10730,34,26,1,26,Direct Questions,3,10730,111,2021-09-07 18:00:03,2021-09-07 18:33:37.439466
5552,103548,5,103548,38,10733,38,11,1,11,Compensation and Benefits,3,10733,115,2021-09-07 18:00:03,2021-09-07 18:04:37.753281
5553,103549,5,103549,41,10733,41,12,1,12,Relationship with Co-Workers,3,10733,115,2021-09-07 18:00:03,2021-09-07 18:04:37.753281
5554,103550,6,103550,45,10733,45,13,1,13,General Satisfaction,3,10733,115,2021-09-07 18:00:03,2021-09-07 18:04:37.753281
5555,103551,4,103551,121,10733,121,14,1,14,Relationship with Supervisor,3,10733,115,2021-09-07 18:00:03,2021-09-07 18:04:37.753281
5556,103552,6,103552,114,10733,114,15,1,15,Company Administration,3,10733,115,2021-09-07 18:00:03,2021-09-07 18:04:37.753281
5557,103553,6,103553,35,10733,35,26,1,26,Direct Questions,3,10733,115,2021-09-07 18:00:03,2021-09-07 18:04:37.753281
5558,103566,4,103566,38,10736,38,11,1,11,Compensation and Benefits,3,10736,118,2021-09-07 18:00:04,2021-09-07 18:35:00.577960
5559,103567,5,103567,40,10736,40,12,1,12,Relationship with Co-Workers,3,10736,118,2021-09-07 18:00:04,2021-09-07 18:35:00.577960
5560,103568,4,103568,49,10736,49,13,1,13,General Satisfaction,3,10736,118,2021-09-07 18:00:04,2021-09-07 18:35:00.577960
5561,103569,2,103569,50,10736,50,14,1,14,Relationship with Supervisor,3,10736,118,2021-09-07 18:00:04,2021-09-07 18:35:00.577960
5562,103570,3,103570,57,10736,57,15,1,15,Company Administration,3,10736,118,2021-09-07 18:00:04,2021-09-07 18:35:00.577960
5563,103571,6,103571,35,10736,35,26,1,26,Direct Questions,3,10736,118,2021-09-07 18:00:04,2021-09-07 18:35:00.577960
5564,103618,2,103618,38,10746,38,11,1,11,Compensation and Benefits,3,10746,107,2021-09-09 18:00:01,2021-09-09 18:49:06.827016
5565,103619,4,103619,43,10746,43,12,1,12,Relationship with Co-Workers,3,10746,107,2021-09-09 18:00:01,2021-09-09 18:49:06.827016
5566,103620,4,103620,46,10746,46,13,1,13,General Satisfaction,3,10746,107,2021-09-09 18:00:01,2021-09-09 18:49:06.827016
5567,103621,6,103621,123,10746,123,14,1,14,Relationship with Supervisor,3,10746,107,2021-09-09 18:00:01,2021-09-09 18:49:06.827016
5568,103622,6,103622,51,10746,51,15,1,15,Company Administration,3,10746,107,2021-09-09 18:00:01,2021-09-09 18:49:06.827016
5569,103623,6,103623,36,10746,36,26,1,26,Direct Questions,3,10746,107,2021-09-09 18:00:01,2021-09-09 18:49:06.827016
5570,103630,3,103630,38,10748,38,11,1,11,Compensation and Benefits,3,10748,109,2021-09-09 18:00:02,2021-09-09 18:30:40.690177
5571,103631,3,103631,113,10748,113,12,1,12,Relationship with Co-Workers,3,10748,109,2021-09-09 18:00:02,2021-09-09 18:30:40.690177
5572,103632,4,103632,47,10748,47,13,1,13,General Satisfaction,3,10748,109,2021-09-09 18:00:02,2021-09-09 18:30:40.690177
5573,103633,2,103633,53,10748,53,14,1,14,Relationship with Supervisor,3,10748,109,2021-09-09 18:00:02,2021-09-09 18:30:40.690177
5574,103634,2,103634,55,10748,55,15,1,15,Company Administration,3,10748,109,2021-09-09 18:00:02,2021-09-09 18:30:40.690177
5575,103635,5,103635,36,10748,36,26,1,26,Direct Questions,3,10748,109,2021-09-09 18:00:02,2021-09-09 18:30:40.690177
5576,103654,4,103654,38,10752,38,11,1,11,Compensation and Benefits,3,10752,114,2021-09-09 18:00:03,2021-09-09 18:34:03.902992
5577,103655,4,103655,42,10752,42,12,1,12,Relationship with Co-Workers,3,10752,114,2021-09-09 18:00:03,2021-09-09 18:34:03.902992
5578,103656,4,103656,49,10752,49,13,1,13,General Satisfaction,3,10752,114,2021-09-09 18:00:03,2021-09-09 18:34:03.902992
5579,103657,4,103657,120,10752,120,14,1,14,Relationship with Supervisor,3,10752,114,2021-09-09 18:00:03,2021-09-09 18:34:03.902992
5580,103658,4,103658,114,10752,114,15,1,15,Company Administration,3,10752,114,2021-09-09 18:00:03,2021-09-09 18:34:03.902992
5581,103659,4,103659,36,10752,36,26,1,26,Direct Questions,3,10752,114,2021-09-09 18:00:03,2021-09-09 18:34:03.902992
5582,103666,1,103666,38,10754,38,11,1,11,Compensation and Benefits,3,10754,116,2021-09-09 18:00:03,2021-09-09 18:42:20.840847
5583,103667,2,103667,111,10754,111,12,1,12,Relationship with Co-Workers,3,10754,116,2021-09-09 18:00:03,2021-09-09 18:42:20.840847
5584,103668,4,103668,48,10754,48,13,1,13,General Satisfaction,3,10754,116,2021-09-09 18:00:03,2021-09-09 18:42:20.840847
5585,103669,1,103669,53,10754,53,14,1,14,Relationship with Supervisor,3,10754,116,2021-09-09 18:00:03,2021-09-09 18:42:20.840847
5586,103670,1,103670,114,10754,114,15,1,15,Company Administration,3,10754,116,2021-09-09 18:00:03,2021-09-09 18:42:20.840847
5587,103671,3,103671,35,10754,35,26,1,26,Direct Questions,3,10754,116,2021-09-09 18:00:03,2021-09-09 18:42:20.840847
5588,103684,6,103684,38,10757,38,11,1,11,Compensation and Benefits,3,10757,156,2021-09-09 18:00:04,2021-09-09 20:43:44.826022
5589,103685,6,103685,113,10757,113,12,1,12,Relationship with Co-Workers,3,10757,156,2021-09-09 18:00:04,2021-09-09 20:43:44.826022
5590,103686,6,103686,45,10757,45,13,1,13,General Satisfaction,3,10757,156,2021-09-09 18:00:04,2021-09-09 20:43:44.826022
5591,103687,6,103687,120,10757,120,14,1,14,Relationship with Supervisor,3,10757,156,2021-09-09 18:00:04,2021-09-09 20:43:44.826022
5592,103688,5,103688,57,10757,57,15,1,15,Company Administration,3,10757,156,2021-09-09 18:00:04,2021-09-09 20:43:44.826022
5593,103689,6,103689,35,10757,35,26,1,26,Direct Questions,3,10757,156,2021-09-09 18:00:04,2021-09-09 20:43:44.826022
5594,103690,3,103690,38,10758,38,11,1,11,Compensation and Benefits,3,10758,107,2021-09-14 18:00:01,2021-09-14 19:49:27.331000
5595,103691,4,103691,40,10758,40,12,1,12,Relationship with Co-Workers,3,10758,107,2021-09-14 18:00:01,2021-09-14 19:49:27.331000
5596,103692,5,103692,45,10758,45,13,1,13,General Satisfaction,3,10758,107,2021-09-14 18:00:01,2021-09-14 19:49:27.331000
5597,103693,3,103693,50,10758,50,14,1,14,Relationship with Supervisor,3,10758,107,2021-09-14 18:00:01,2021-09-14 19:49:27.331000
5598,103694,6,103694,58,10758,58,15,1,15,Company Administration,3,10758,107,2021-09-14 18:00:01,2021-09-14 19:49:27.331000
5599,103695,4,103695,34,10758,34,26,1,26,Direct Questions,3,10758,107,2021-09-14 18:00:01,2021-09-14 19:49:27.331000
5600,103714,4,103714,38,10762,38,11,1,11,Compensation and Benefits,3,10762,111,2021-09-14 18:00:02,2021-09-14 21:09:21.194939
5601,103715,4,103715,113,10762,113,12,1,12,Relationship with Co-Workers,3,10762,111,2021-09-14 18:00:02,2021-09-14 21:09:21.194939
5602,103716,2,103716,119,10762,119,13,1,13,General Satisfaction,3,10762,111,2021-09-14 18:00:02,2021-09-14 21:09:21.194939
5603,103717,4,103717,54,10762,54,14,1,14,Relationship with Supervisor,3,10762,111,2021-09-14 18:00:02,2021-09-14 21:09:21.194939
5604,103718,4,103718,55,10762,55,15,1,15,Company Administration,3,10762,111,2021-09-14 18:00:02,2021-09-14 21:09:21.194939
5605,103719,4,103719,36,10762,36,26,1,26,Direct Questions,3,10762,111,2021-09-14 18:00:02,2021-09-14 21:09:21.194939
5606,103720,4,103720,38,10763,38,11,1,11,Compensation and Benefits,3,10763,113,2021-09-14 18:00:02,2021-09-14 18:45:09.693680
5607,103721,3,103721,42,10763,42,12,1,12,Relationship with Co-Workers,3,10763,113,2021-09-14 18:00:02,2021-09-14 18:45:09.693680
5608,103722,4,103722,45,10763,45,13,1,13,General Satisfaction,3,10763,113,2021-09-14 18:00:02,2021-09-14 18:45:09.693680
5609,103723,2,103723,121,10763,121,14,1,14,Relationship with Supervisor,3,10763,113,2021-09-14 18:00:02,2021-09-14 18:45:09.693680
5610,103724,4,103724,57,10763,57,15,1,15,Company Administration,3,10763,113,2021-09-14 18:00:02,2021-09-14 18:45:09.693680
5611,103725,5,103725,34,10763,34,26,1,26,Direct Questions,3,10763,113,2021-09-14 18:00:02,2021-09-14 18:45:09.693680
5612,103838,4,103838,38,10784,38,11,1,11,Compensation and Benefits,3,10784,114,2021-09-16 18:00:02,2021-09-16 18:41:22.821933
5613,103839,4,103839,43,10784,43,12,1,12,Relationship with Co-Workers,3,10784,114,2021-09-16 18:00:02,2021-09-16 18:41:22.821933
5614,103840,4,103840,46,10784,46,13,1,13,General Satisfaction,3,10784,114,2021-09-16 18:00:02,2021-09-16 18:41:22.821933
5615,103841,4,103841,50,10784,50,14,1,14,Relationship with Supervisor,3,10784,114,2021-09-16 18:00:02,2021-09-16 18:41:22.821933
5616,103842,4,103842,55,10784,55,15,1,15,Company Administration,3,10784,114,2021-09-16 18:00:02,2021-09-16 18:41:22.821933
5617,103843,4,103843,36,10784,36,26,1,26,Direct Questions,3,10784,114,2021-09-16 18:00:02,2021-09-16 18:41:22.821933
5618,103862,4,103862,38,10788,38,11,1,11,Compensation and Benefits,3,10788,118,2021-09-16 18:00:03,2021-09-16 18:44:42.432332
5619,103863,3,103863,39,10788,39,12,1,12,Relationship with Co-Workers,3,10788,118,2021-09-16 18:00:03,2021-09-16 18:44:42.432332
5620,103864,4,103864,118,10788,118,13,1,13,General Satisfaction,3,10788,118,2021-09-16 18:00:03,2021-09-16 18:44:42.432332
5621,103865,5,103865,122,10788,122,14,1,14,Relationship with Supervisor,3,10788,118,2021-09-16 18:00:03,2021-09-16 18:44:42.432332
5622,103866,4,103866,57,10788,57,15,1,15,Company Administration,3,10788,118,2021-09-16 18:00:03,2021-09-16 18:44:42.432332
5623,103867,6,103867,35,10788,35,26,1,26,Direct Questions,3,10788,118,2021-09-16 18:00:03,2021-09-16 18:44:42.432332
5624,103898,5,103898,38,10794,38,11,1,11,Compensation and Benefits,3,10794,111,2021-09-21 18:00:02,2021-09-21 20:29:42.106737
5625,103899,4,103899,113,10794,113,12,1,12,Relationship with Co-Workers,3,10794,111,2021-09-21 18:00:02,2021-09-21 20:29:42.106737
5626,103900,4,103900,47,10794,47,13,1,13,General Satisfaction,3,10794,111,2021-09-21 18:00:02,2021-09-21 20:29:42.106737
5627,103901,4,103901,120,10794,120,14,1,14,Relationship with Supervisor,3,10794,111,2021-09-21 18:00:02,2021-09-21 20:29:42.106737
5628,103902,3,103902,116,10794,116,15,1,15,Company Administration,3,10794,111,2021-09-21 18:00:02,2021-09-21 20:29:42.106737
5629,103903,5,103903,35,10794,35,26,1,26,Direct Questions,3,10794,111,2021-09-21 18:00:02,2021-09-21 20:29:42.106737
5630,103910,4,103910,38,10796,38,11,1,11,Compensation and Benefits,3,10796,114,2021-09-21 18:00:02,2021-09-21 18:34:01.020101
5631,103911,4,103911,111,10796,111,12,1,12,Relationship with Co-Workers,3,10796,114,2021-09-21 18:00:02,2021-09-21 18:34:01.020101
5632,103912,4,103912,49,10796,49,13,1,13,General Satisfaction,3,10796,114,2021-09-21 18:00:02,2021-09-21 18:34:01.020101
5633,103913,4,103913,121,10796,121,14,1,14,Relationship with Supervisor,3,10796,114,2021-09-21 18:00:02,2021-09-21 18:34:01.020101
5634,103914,4,103914,44,10796,44,15,1,15,Company Administration,3,10796,114,2021-09-21 18:00:02,2021-09-21 18:34:01.020101
5635,103915,4,103915,34,10796,34,26,1,26,Direct Questions,3,10796,114,2021-09-21 18:00:02,2021-09-21 18:34:01.020101
5636,103986,2,103986,38,10810,38,11,1,11,Compensation and Benefits,3,10810,107,2021-09-23 18:00:01,2021-09-23 23:43:56.442001
5637,103987,4,103987,40,10810,40,12,1,12,Relationship with Co-Workers,3,10810,107,2021-09-23 18:00:01,2021-09-23 23:43:56.442001
5638,103988,4,103988,45,10810,45,13,1,13,General Satisfaction,3,10810,107,2021-09-23 18:00:01,2021-09-23 23:43:56.442001
5639,103989,4,103989,122,10810,122,14,1,14,Relationship with Supervisor,3,10810,107,2021-09-23 18:00:01,2021-09-23 23:43:56.442001
5640,103990,4,103990,44,10810,44,15,1,15,Company Administration,3,10810,107,2021-09-23 18:00:01,2021-09-23 23:43:56.442001
5641,103991,1,103991,35,10810,35,26,1,26,Direct Questions,3,10810,107,2021-09-23 18:00:01,2021-09-23 23:43:56.442001
5642,104058,3,104058,38,10822,38,11,1,11,Compensation and Benefits,3,10822,107,2021-09-28 18:00:01,2021-09-29 04:50:03.726263
5643,104059,3,104059,43,10822,43,12,1,12,Relationship with Co-Workers,3,10822,107,2021-09-28 18:00:01,2021-09-29 04:50:03.726263
5644,104060,5,104060,118,10822,118,13,1,13,General Satisfaction,3,10822,107,2021-09-28 18:00:01,2021-09-29 04:50:03.726263
5645,104061,4,104061,122,10822,122,14,1,14,Relationship with Supervisor,3,10822,107,2021-09-28 18:00:01,2021-09-29 04:50:03.726263
5646,104062,6,104062,58,10822,58,15,1,15,Company Administration,3,10822,107,2021-09-28 18:00:01,2021-09-29 04:50:03.726263
5647,104063,3,104063,34,10822,34,26,1,26,Direct Questions,3,10822,107,2021-09-28 18:00:01,2021-09-29 04:50:03.726263
5648,104070,2,104070,38,10824,38,11,1,11,Compensation and Benefits,3,10824,109,2021-09-28 18:00:02,2021-09-28 18:35:15.426210
5649,104071,4,104071,40,10824,40,12,1,12,Relationship with Co-Workers,3,10824,109,2021-09-28 18:00:02,2021-09-28 18:35:15.426210
5650,104072,5,104072,47,10824,47,13,1,13,General Satisfaction,3,10824,109,2021-09-28 18:00:02,2021-09-28 18:35:15.426210
5651,104073,4,104073,121,10824,121,14,1,14,Relationship with Supervisor,3,10824,109,2021-09-28 18:00:02,2021-09-28 18:35:15.426210
5652,104074,5,104074,55,10824,55,15,1,15,Company Administration,3,10824,109,2021-09-28 18:00:02,2021-09-28 18:35:15.426210
5653,104075,5,104075,35,10824,35,26,1,26,Direct Questions,3,10824,109,2021-09-28 18:00:02,2021-09-28 18:35:15.426210
5654,104076,3,104076,38,10825,38,11,1,11,Compensation and Benefits,3,10825,110,2021-09-28 18:00:02,2021-09-28 19:35:06.129677
5655,104077,1,104077,42,10825,42,12,1,12,Relationship with Co-Workers,3,10825,110,2021-09-28 18:00:02,2021-09-28 19:35:06.129677
5656,104078,4,104078,46,10825,46,13,1,13,General Satisfaction,3,10825,110,2021-09-28 18:00:02,2021-09-28 19:35:06.129677
5657,104079,6,104079,120,10825,120,14,1,14,Relationship with Supervisor,3,10825,110,2021-09-28 18:00:02,2021-09-28 19:35:06.129677
5658,104080,6,104080,52,10825,52,15,1,15,Company Administration,3,10825,110,2021-09-28 18:00:02,2021-09-28 19:35:06.129677
5659,104081,1,104081,35,10825,35,26,1,26,Direct Questions,3,10825,110,2021-09-28 18:00:02,2021-09-28 19:35:06.129677
5660,104094,3,104094,38,10828,38,11,1,11,Compensation and Benefits,3,10828,114,2021-09-28 18:00:03,2021-09-28 18:35:40.856762
5661,104095,4,104095,113,10828,113,12,1,12,Relationship with Co-Workers,3,10828,114,2021-09-28 18:00:03,2021-09-28 18:35:40.856762
5662,104096,4,104096,117,10828,117,13,1,13,General Satisfaction,3,10828,114,2021-09-28 18:00:03,2021-09-28 18:35:40.856762
5663,104097,4,104097,120,10828,120,14,1,14,Relationship with Supervisor,3,10828,114,2021-09-28 18:00:03,2021-09-28 18:35:40.856762
5664,104098,3,104098,56,10828,56,15,1,15,Company Administration,3,10828,114,2021-09-28 18:00:03,2021-09-28 18:35:40.856762
5665,104099,4,104099,35,10828,35,26,1,26,Direct Questions,3,10828,114,2021-09-28 18:00:03,2021-09-28 18:35:40.856762
5666,104212,4,104212,38,10849,38,11,1,11,Compensation and Benefits,3,10849,111,2021-09-30 18:00:02,2021-09-30 18:01:46.372666
5667,104213,4,104213,112,10849,112,12,1,12,Relationship with Co-Workers,3,10849,111,2021-09-30 18:00:02,2021-09-30 18:01:46.372666
5668,104214,5,104214,47,10849,47,13,1,13,General Satisfaction,3,10849,111,2021-09-30 18:00:02,2021-09-30 18:01:46.372666
5669,104215,5,104215,120,10849,120,14,1,14,Relationship with Supervisor,3,10849,111,2021-09-30 18:00:02,2021-09-30 18:01:46.372666
5670,104216,4,104216,114,10849,114,15,1,15,Company Administration,3,10849,111,2021-09-30 18:00:02,2021-09-30 18:01:46.372666
5671,104217,5,104217,36,10849,36,26,1,26,Direct Questions,3,10849,111,2021-09-30 18:00:02,2021-09-30 18:01:46.372666
5672,104236,1,104236,38,10853,38,11,1,11,Compensation and Benefits,3,10853,116,2021-09-30 18:00:03,2021-09-30 18:35:48.171953
5673,104237,3,104237,40,10853,40,12,1,12,Relationship with Co-Workers,3,10853,116,2021-09-30 18:00:03,2021-09-30 18:35:48.171953
5674,104238,3,104238,118,10853,118,13,1,13,General Satisfaction,3,10853,116,2021-09-30 18:00:03,2021-09-30 18:35:48.171953
5675,104239,2,104239,121,10853,121,14,1,14,Relationship with Supervisor,3,10853,116,2021-09-30 18:00:03,2021-09-30 18:35:48.171953
5676,104240,1,104240,115,10853,115,15,1,15,Company Administration,3,10853,116,2021-09-30 18:00:03,2021-09-30 18:35:48.171953
5677,104241,6,104241,35,10853,35,26,1,26,Direct Questions,3,10853,116,2021-09-30 18:00:03,2021-09-30 18:35:48.171953
5678,104254,6,104254,38,10856,38,11,1,11,Compensation and Benefits,3,10856,156,2021-09-30 18:00:04,2021-09-30 20:59:58.208648
5679,104255,6,104255,42,10856,42,12,1,12,Relationship with Co-Workers,3,10856,156,2021-09-30 18:00:04,2021-09-30 20:59:58.208648
5680,104256,6,104256,117,10856,117,13,1,13,General Satisfaction,3,10856,156,2021-09-30 18:00:04,2021-09-30 20:59:58.208648
5681,104257,6,104257,121,10856,121,14,1,14,Relationship with Supervisor,3,10856,156,2021-09-30 18:00:04,2021-09-30 20:59:58.208648
5682,104258,6,104258,57,10856,57,15,1,15,Company Administration,3,10856,156,2021-09-30 18:00:04,2021-09-30 20:59:58.208648
5683,104259,6,104259,35,10856,35,26,1,26,Direct Questions,3,10856,156,2021-09-30 18:00:04,2021-09-30 20:59:58.208648
5684,104266,6,104266,38,10858,38,11,1,11,Compensation and Benefits,3,10858,158,2021-09-30 18:00:04,2021-09-30 18:32:21.335315
5685,104267,6,104267,41,10858,41,12,1,12,Relationship with Co-Workers,3,10858,158,2021-09-30 18:00:04,2021-09-30 18:32:21.335315
5686,104268,6,104268,46,10858,46,13,1,13,General Satisfaction,3,10858,158,2021-09-30 18:00:04,2021-09-30 18:32:21.335315
5687,104269,6,104269,123,10858,123,14,1,14,Relationship with Supervisor,3,10858,158,2021-09-30 18:00:04,2021-09-30 18:32:21.335315
5688,104270,6,104270,114,10858,114,15,1,15,Company Administration,3,10858,158,2021-09-30 18:00:04,2021-09-30 18:32:21.335315
5689,104271,6,104271,36,10858,36,26,1,26,Direct Questions,3,10858,158,2021-09-30 18:00:04,2021-09-30 18:32:21.335315
5690,104314,4,104314,38,10866,38,11,1,11,Compensation and Benefits,3,10866,113,2021-10-05 18:00:03,2021-10-05 18:35:26.689924
5691,104315,2,104315,41,10866,41,12,1,12,Relationship with Co-Workers,3,10866,113,2021-10-05 18:00:03,2021-10-05 18:35:26.689924
5692,104316,3,104316,47,10866,47,13,1,13,General Satisfaction,3,10866,113,2021-10-05 18:00:03,2021-10-05 18:35:26.689924
5693,104317,1,104317,53,10866,53,14,1,14,Relationship with Supervisor,3,10866,113,2021-10-05 18:00:03,2021-10-05 18:35:26.689924
5694,104318,3,104318,52,10866,52,15,1,15,Company Administration,3,10866,113,2021-10-05 18:00:03,2021-10-05 18:35:26.689924
5695,104319,4,104319,35,10866,35,26,1,26,Direct Questions,3,10866,113,2021-10-05 18:00:03,2021-10-05 18:35:26.689924
5696,104332,2,104332,38,10869,38,11,1,11,Compensation and Benefits,3,10869,116,2021-10-05 18:00:04,2021-10-05 18:33:50.397149
5697,104333,4,104333,40,10869,40,12,1,12,Relationship with Co-Workers,3,10869,116,2021-10-05 18:00:04,2021-10-05 18:33:50.397149
5698,104334,4,104334,118,10869,118,13,1,13,General Satisfaction,3,10869,116,2021-10-05 18:00:04,2021-10-05 18:33:50.397149
5699,104335,2,104335,50,10869,50,14,1,14,Relationship with Supervisor,3,10869,116,2021-10-05 18:00:04,2021-10-05 18:33:50.397149
5700,104336,3,104336,114,10869,114,15,1,15,Company Administration,3,10869,116,2021-10-05 18:00:04,2021-10-05 18:33:50.397149
5701,104337,3,104337,36,10869,36,26,1,26,Direct Questions,3,10869,116,2021-10-05 18:00:04,2021-10-05 18:33:50.397149
5702,104368,5,104368,38,10875,38,11,1,11,Compensation and Benefits,3,10875,159,2021-10-05 18:00:05,2021-10-05 18:36:19.065361
5703,104369,5,104369,113,10875,113,12,1,12,Relationship with Co-Workers,3,10875,159,2021-10-05 18:00:05,2021-10-05 18:36:19.065361
5704,104370,5,104370,47,10875,47,13,1,13,General Satisfaction,3,10875,159,2021-10-05 18:00:05,2021-10-05 18:36:19.065361
5705,104371,6,104371,53,10875,53,14,1,14,Relationship with Supervisor,3,10875,159,2021-10-05 18:00:05,2021-10-05 18:36:19.065361
5706,104372,6,104372,55,10875,55,15,1,15,Company Administration,3,10875,159,2021-10-05 18:00:05,2021-10-05 18:36:19.065361
5707,104373,6,104373,36,10875,36,26,1,26,Direct Questions,3,10875,159,2021-10-05 18:00:05,2021-10-05 18:36:19.065361
5708,104438,5,104438,38,10888,38,11,1,11,Compensation and Benefits,3,10888,110,2021-10-07 18:00:02,2021-10-07 18:01:10.881423
5709,104439,5,104439,111,10888,111,12,1,12,Relationship with Co-Workers,3,10888,110,2021-10-07 18:00:02,2021-10-07 18:01:10.881423
5710,104440,6,104440,119,10888,119,13,1,13,General Satisfaction,3,10888,110,2021-10-07 18:00:02,2021-10-07 18:01:10.881423
5711,104441,6,104441,120,10888,120,14,1,14,Relationship with Supervisor,3,10888,110,2021-10-07 18:00:02,2021-10-07 18:01:10.881423
5712,104442,5,104442,115,10888,115,15,1,15,Company Administration,3,10888,110,2021-10-07 18:00:02,2021-10-07 18:01:10.881423
5713,104443,2,104443,36,10888,36,26,1,26,Direct Questions,3,10888,110,2021-10-07 18:00:02,2021-10-07 18:01:10.881423
5714,104444,4,104444,38,10889,38,11,1,11,Compensation and Benefits,3,10889,111,2021-10-07 18:00:02,2021-10-07 18:34:09.124045
5715,104445,4,104445,111,10889,111,12,1,12,Relationship with Co-Workers,3,10889,111,2021-10-07 18:00:02,2021-10-07 18:34:09.124045
5716,104446,5,104446,46,10889,46,13,1,13,General Satisfaction,3,10889,111,2021-10-07 18:00:02,2021-10-07 18:34:09.124045
5717,104447,4,104447,121,10889,121,14,1,14,Relationship with Supervisor,3,10889,111,2021-10-07 18:00:02,2021-10-07 18:34:09.124045
5718,104448,4,104448,114,10889,114,15,1,15,Company Administration,3,10889,111,2021-10-07 18:00:02,2021-10-07 18:34:09.124045
5719,104449,5,104449,34,10889,34,26,1,26,Direct Questions,3,10889,111,2021-10-07 18:00:02,2021-10-07 18:34:09.124045
5720,104456,3,104456,38,10891,38,11,1,11,Compensation and Benefits,3,10891,114,2021-10-07 18:00:03,2021-10-07 18:34:45.155023
5721,104457,4,104457,40,10891,40,12,1,12,Relationship with Co-Workers,3,10891,114,2021-10-07 18:00:03,2021-10-07 18:34:45.155023
5722,104458,4,104458,117,10891,117,13,1,13,General Satisfaction,3,10891,114,2021-10-07 18:00:03,2021-10-07 18:34:45.155023
5723,104459,4,104459,121,10891,121,14,1,14,Relationship with Supervisor,3,10891,114,2021-10-07 18:00:03,2021-10-07 18:34:45.155023
5724,104460,4,104460,44,10891,44,15,1,15,Company Administration,3,10891,114,2021-10-07 18:00:03,2021-10-07 18:34:45.155023
5725,104461,4,104461,34,10891,34,26,1,26,Direct Questions,3,10891,114,2021-10-07 18:00:03,2021-10-07 18:34:45.155023
5726,104468,2,104468,38,10893,38,11,1,11,Compensation and Benefits,3,10893,116,2021-10-07 18:00:04,2021-10-07 18:38:42.738265
5727,104469,4,104469,39,10893,39,12,1,12,Relationship with Co-Workers,3,10893,116,2021-10-07 18:00:04,2021-10-07 18:38:42.738265
5728,104470,1,104470,46,10893,46,13,1,13,General Satisfaction,3,10893,116,2021-10-07 18:00:04,2021-10-07 18:38:42.738265
5729,104471,4,104471,123,10893,123,14,1,14,Relationship with Supervisor,3,10893,116,2021-10-07 18:00:04,2021-10-07 18:38:42.738265
5730,104472,2,104472,57,10893,57,15,1,15,Company Administration,3,10893,116,2021-10-07 18:00:04,2021-10-07 18:38:42.738265
5731,104473,3,104473,36,10893,36,26,1,26,Direct Questions,3,10893,116,2021-10-07 18:00:04,2021-10-07 18:38:42.738265
5732,104498,6,104498,38,10898,38,11,1,11,Compensation and Benefits,3,10898,158,2021-10-07 18:00:05,2021-10-07 18:31:51.829817
5733,104499,6,104499,112,10898,112,12,1,12,Relationship with Co-Workers,3,10898,158,2021-10-07 18:00:05,2021-10-07 18:31:51.829817
5734,104500,6,104500,46,10898,46,13,1,13,General Satisfaction,3,10898,158,2021-10-07 18:00:05,2021-10-07 18:31:51.829817
5735,104501,6,104501,50,10898,50,14,1,14,Relationship with Supervisor,3,10898,158,2021-10-07 18:00:05,2021-10-07 18:31:51.829817
5736,104502,6,104502,55,10898,55,15,1,15,Company Administration,3,10898,158,2021-10-07 18:00:05,2021-10-07 18:31:51.829817
5737,104503,6,104503,35,10898,35,26,1,26,Direct Questions,3,10898,158,2021-10-07 18:00:05,2021-10-07 18:31:51.829817
5738,102546,1,102546,109,10544,109,11,1,11,Compensation and Benefits,3,10544,109,2021-08-10 18:00:02,2021-08-10 19:05:17.029257
5739,102547,5,102547,113,10544,113,12,1,12,Relationship with Co-Workers,3,10544,109,2021-08-10 18:00:02,2021-08-10 19:05:17.029257
5740,102548,2,102548,119,10544,119,13,1,13,General Satisfaction,3,10544,109,2021-08-10 18:00:02,2021-08-10 19:05:17.029257
5741,102549,4,102549,120,10544,120,14,1,14,Relationship with Supervisor,3,10544,109,2021-08-10 18:00:02,2021-08-10 19:05:17.029257
5742,102550,5,102550,57,10544,57,15,1,15,Company Administration,3,10544,109,2021-08-10 18:00:02,2021-08-10 19:05:17.029257
5743,102551,6,102551,34,10544,34,26,1,26,Direct Questions,3,10544,109,2021-08-10 18:00:02,2021-08-10 19:05:17.029257
5744,102552,1,102552,109,10545,109,11,1,11,Compensation and Benefits,3,10545,110,2021-08-10 18:00:02,2021-08-10 18:35:51.692087
5745,102553,5,102553,39,10545,39,12,1,12,Relationship with Co-Workers,3,10545,110,2021-08-10 18:00:02,2021-08-10 18:35:51.692087
5746,102554,4,102554,47,10545,47,13,1,13,General Satisfaction,3,10545,110,2021-08-10 18:00:02,2021-08-10 18:35:51.692087
5747,102555,6,102555,122,10545,122,14,1,14,Relationship with Supervisor,3,10545,110,2021-08-10 18:00:02,2021-08-10 18:35:51.692087
5748,102556,5,102556,115,10545,115,15,1,15,Company Administration,3,10545,110,2021-08-10 18:00:02,2021-08-10 18:35:51.692087
5749,102557,2,102557,34,10545,34,26,1,26,Direct Questions,3,10545,110,2021-08-10 18:00:02,2021-08-10 18:35:51.692087
5750,102558,4,102558,109,10546,109,11,1,11,Compensation and Benefits,3,10546,111,2021-08-10 18:00:02,2021-08-10 18:33:36.375084
5751,102559,4,102559,112,10546,112,12,1,12,Relationship with Co-Workers,3,10546,111,2021-08-10 18:00:02,2021-08-10 18:33:36.375084
5752,102560,5,102560,48,10546,48,13,1,13,General Satisfaction,3,10546,111,2021-08-10 18:00:02,2021-08-10 18:33:36.375084
5753,102561,4,102561,54,10546,54,14,1,14,Relationship with Supervisor,3,10546,111,2021-08-10 18:00:02,2021-08-10 18:33:36.375084
5754,102562,4,102562,115,10546,115,15,1,15,Company Administration,3,10546,111,2021-08-10 18:00:02,2021-08-10 18:33:36.375084
5755,102563,6,102563,36,10546,36,26,1,26,Direct Questions,3,10546,111,2021-08-10 18:00:02,2021-08-10 18:33:36.375084
5756,102758,4,102758,109,10589,109,11,1,11,Compensation and Benefits,3,10589,108,2021-08-12 18:00:01,2021-08-12 18:01:31.327194
5757,102759,3,102759,42,10589,42,12,1,12,Relationship with Co-Workers,3,10589,108,2021-08-12 18:00:01,2021-08-12 18:01:31.327194
5758,102760,4,102760,47,10589,47,13,1,13,General Satisfaction,3,10589,108,2021-08-12 18:00:01,2021-08-12 18:01:31.327194
5759,102761,4,102761,53,10589,53,14,1,14,Relationship with Supervisor,3,10589,108,2021-08-12 18:00:01,2021-08-12 18:01:31.327194
5760,102762,4,102762,56,10589,56,15,1,15,Company Administration,3,10589,108,2021-08-12 18:00:01,2021-08-12 18:01:31.327194
5761,102763,5,102763,34,10589,34,26,1,26,Direct Questions,3,10589,108,2021-08-12 18:00:01,2021-08-12 18:01:31.327194
5762,102776,4,102776,109,10592,109,11,1,11,Compensation and Benefits,3,10592,111,2021-08-12 18:00:02,2021-08-12 18:39:14.969809
5763,102777,3,102777,41,10592,41,12,1,12,Relationship with Co-Workers,3,10592,111,2021-08-12 18:00:02,2021-08-12 18:39:14.969809
5764,102778,4,102778,49,10592,49,13,1,13,General Satisfaction,3,10592,111,2021-08-12 18:00:02,2021-08-12 18:39:14.969809
5765,102779,5,102779,50,10592,50,14,1,14,Relationship with Supervisor,3,10592,111,2021-08-12 18:00:02,2021-08-12 18:39:14.969809
5766,102780,4,102780,51,10592,51,15,1,15,Company Administration,3,10592,111,2021-08-12 18:00:02,2021-08-12 18:39:14.969809
5767,102781,5,102781,34,10592,34,26,1,26,Direct Questions,3,10592,111,2021-08-12 18:00:02,2021-08-12 18:39:14.969809
5768,102812,4,102812,109,10598,109,11,1,11,Compensation and Benefits,3,10598,118,2021-08-12 18:00:03,2021-08-12 18:01:05.090546
5769,102813,4,102813,40,10598,40,12,1,12,Relationship with Co-Workers,3,10598,118,2021-08-12 18:00:03,2021-08-12 18:01:05.090546
5770,102814,4,102814,117,10598,117,13,1,13,General Satisfaction,3,10598,118,2021-08-12 18:00:03,2021-08-12 18:01:05.090546
5771,102815,3,102815,50,10598,50,14,1,14,Relationship with Supervisor,3,10598,118,2021-08-12 18:00:03,2021-08-12 18:01:05.090546
5772,102816,4,102816,58,10598,58,15,1,15,Company Administration,3,10598,118,2021-08-12 18:00:03,2021-08-12 18:01:05.090546
5773,102817,5,102817,34,10598,34,26,1,26,Direct Questions,3,10598,118,2021-08-12 18:00:03,2021-08-12 18:01:05.090546
5774,102830,4,102830,109,10601,109,11,1,11,Compensation and Benefits,3,10601,107,2021-08-17 18:00:01,2021-08-17 18:07:18.830269
5775,102831,4,102831,40,10601,40,12,1,12,Relationship with Co-Workers,3,10601,107,2021-08-17 18:00:01,2021-08-17 18:07:18.830269
5776,102832,5,102832,47,10601,47,13,1,13,General Satisfaction,3,10601,107,2021-08-17 18:00:01,2021-08-17 18:07:18.830269
5777,102833,6,102833,54,10601,54,14,1,14,Relationship with Supervisor,3,10601,107,2021-08-17 18:00:01,2021-08-17 18:07:18.830269
5778,102834,5,102834,56,10601,56,15,1,15,Company Administration,3,10601,107,2021-08-17 18:00:01,2021-08-17 18:07:18.830269
5779,102835,1,102835,35,10601,35,26,1,26,Direct Questions,3,10601,107,2021-08-17 18:00:01,2021-08-17 18:07:18.830269
5780,102842,1,102842,109,10603,109,11,1,11,Compensation and Benefits,3,10603,109,2021-08-17 18:00:02,2021-08-17 18:33:39.555365
5781,102843,6,102843,112,10603,112,12,1,12,Relationship with Co-Workers,3,10603,109,2021-08-17 18:00:02,2021-08-17 18:33:39.555365
5782,102844,3,102844,48,10603,48,13,1,13,General Satisfaction,3,10603,109,2021-08-17 18:00:02,2021-08-17 18:33:39.555365
5783,102845,1,102845,123,10603,123,14,1,14,Relationship with Supervisor,3,10603,109,2021-08-17 18:00:02,2021-08-17 18:33:39.555365
5784,102846,6,102846,114,10603,114,15,1,15,Company Administration,3,10603,109,2021-08-17 18:00:02,2021-08-17 18:33:39.555365
5785,102847,6,102847,36,10603,36,26,1,26,Direct Questions,3,10603,109,2021-08-17 18:00:02,2021-08-17 18:33:39.555365
5786,102884,5,102884,109,10610,109,11,1,11,Compensation and Benefits,3,10610,117,2021-08-17 18:00:03,2021-08-17 18:23:33.887132
5787,102885,4,102885,112,10610,112,12,1,12,Relationship with Co-Workers,3,10610,117,2021-08-17 18:00:03,2021-08-17 18:23:33.887132
5788,102886,4,102886,49,10610,49,13,1,13,General Satisfaction,3,10610,117,2021-08-17 18:00:03,2021-08-17 18:23:33.887132
5789,102887,4,102887,50,10610,50,14,1,14,Relationship with Supervisor,3,10610,117,2021-08-17 18:00:03,2021-08-17 18:23:33.887132
5790,102888,4,102888,114,10610,114,15,1,15,Company Administration,3,10610,117,2021-08-17 18:00:03,2021-08-17 18:23:33.887132
5791,102889,5,102889,34,10610,34,26,1,26,Direct Questions,3,10610,117,2021-08-17 18:00:03,2021-08-17 18:23:33.887132
5792,103054,4,103054,109,10648,109,11,1,11,Compensation and Benefits,3,10648,108,2021-08-19 18:00:01,2021-08-19 18:32:52.880854
5793,103055,3,103055,40,10648,40,12,1,12,Relationship with Co-Workers,3,10648,108,2021-08-19 18:00:01,2021-08-19 18:32:52.880854
5794,103056,4,103056,47,10648,47,13,1,13,General Satisfaction,3,10648,108,2021-08-19 18:00:01,2021-08-19 18:32:52.880854
5795,103057,4,103057,50,10648,50,14,1,14,Relationship with Supervisor,3,10648,108,2021-08-19 18:00:01,2021-08-19 18:32:52.880854
5796,103058,5,103058,52,10648,52,15,1,15,Company Administration,3,10648,108,2021-08-19 18:00:01,2021-08-19 18:32:52.880854
5797,103059,6,103059,36,10648,36,26,1,26,Direct Questions,3,10648,108,2021-08-19 18:00:01,2021-08-19 18:32:52.880854
5798,103060,2,103060,109,10649,109,11,1,11,Compensation and Benefits,3,10649,109,2021-08-19 18:00:02,2021-08-19 18:32:11.238060
5799,103061,5,103061,43,10649,43,12,1,12,Relationship with Co-Workers,3,10649,109,2021-08-19 18:00:02,2021-08-19 18:32:11.238060
5800,103062,4,103062,118,10649,118,13,1,13,General Satisfaction,3,10649,109,2021-08-19 18:00:02,2021-08-19 18:32:11.238060
5801,103063,6,103063,122,10649,122,14,1,14,Relationship with Supervisor,3,10649,109,2021-08-19 18:00:02,2021-08-19 18:32:11.238060
5802,103064,4,103064,116,10649,116,15,1,15,Company Administration,3,10649,109,2021-08-19 18:00:02,2021-08-19 18:32:11.238060
5803,103065,6,103065,36,10649,36,26,1,26,Direct Questions,3,10649,109,2021-08-19 18:00:02,2021-08-19 18:32:11.238060
5804,103102,5,103102,109,10656,109,11,1,11,Compensation and Benefits,3,10656,117,2021-08-19 18:00:03,2021-08-20 01:27:06.059493
5805,103103,4,103103,111,10656,111,12,1,12,Relationship with Co-Workers,3,10656,117,2021-08-19 18:00:03,2021-08-20 01:27:06.059493
5806,103104,4,103104,48,10656,48,13,1,13,General Satisfaction,3,10656,117,2021-08-19 18:00:03,2021-08-20 01:27:06.059493
5807,103105,5,103105,123,10656,123,14,1,14,Relationship with Supervisor,3,10656,117,2021-08-19 18:00:03,2021-08-20 01:27:06.059493
5808,103106,4,103106,52,10656,52,15,1,15,Company Administration,3,10656,117,2021-08-19 18:00:03,2021-08-20 01:27:06.059493
5809,103107,5,103107,36,10656,36,26,1,26,Direct Questions,3,10656,117,2021-08-19 18:00:03,2021-08-20 01:27:06.059493
5810,103108,4,103108,109,10657,109,11,1,11,Compensation and Benefits,3,10657,118,2021-08-19 18:00:03,2021-08-19 18:42:44.812271
5811,103109,3,103109,39,10657,39,12,1,12,Relationship with Co-Workers,3,10657,118,2021-08-19 18:00:03,2021-08-19 18:42:44.812271
5812,103110,4,103110,47,10657,47,13,1,13,General Satisfaction,3,10657,118,2021-08-19 18:00:03,2021-08-19 18:42:44.812271
5813,103111,3,103111,53,10657,53,14,1,14,Relationship with Supervisor,3,10657,118,2021-08-19 18:00:03,2021-08-19 18:42:44.812271
5814,103112,5,103112,115,10657,115,15,1,15,Company Administration,3,10657,118,2021-08-19 18:00:03,2021-08-19 18:42:44.812271
5815,103113,6,103113,35,10657,35,26,1,26,Direct Questions,3,10657,118,2021-08-19 18:00:03,2021-08-19 18:42:44.812271
5816,103132,4,103132,109,10661,109,11,1,11,Compensation and Benefits,3,10661,108,2021-08-24 18:00:01,2021-08-24 18:06:35.703089
5817,103133,4,103133,113,10661,113,12,1,12,Relationship with Co-Workers,3,10661,108,2021-08-24 18:00:01,2021-08-24 18:06:35.703089
5818,103134,4,103134,45,10661,45,13,1,13,General Satisfaction,3,10661,108,2021-08-24 18:00:01,2021-08-24 18:06:35.703089
5819,103135,5,103135,123,10661,123,14,1,14,Relationship with Supervisor,3,10661,108,2021-08-24 18:00:01,2021-08-24 18:06:35.703089
5820,103136,5,103136,114,10661,114,15,1,15,Company Administration,3,10661,108,2021-08-24 18:00:01,2021-08-24 18:06:35.703089
5821,103137,6,103137,36,10661,36,26,1,26,Direct Questions,3,10661,108,2021-08-24 18:00:01,2021-08-24 18:06:35.703089
5822,103150,4,103150,109,10664,109,11,1,11,Compensation and Benefits,3,10664,111,2021-08-24 18:00:02,2021-08-24 18:41:42.277823
5823,103151,4,103151,41,10664,41,12,1,12,Relationship with Co-Workers,3,10664,111,2021-08-24 18:00:02,2021-08-24 18:41:42.277823
5824,103152,4,103152,49,10664,49,13,1,13,General Satisfaction,3,10664,111,2021-08-24 18:00:02,2021-08-24 18:41:42.277823
5825,103153,4,103153,122,10664,122,14,1,14,Relationship with Supervisor,3,10664,111,2021-08-24 18:00:02,2021-08-24 18:41:42.277823
5826,103154,3,103154,116,10664,116,15,1,15,Company Administration,3,10664,111,2021-08-24 18:00:02,2021-08-24 18:41:42.277823
5827,103155,5,103155,34,10664,34,26,1,26,Direct Questions,3,10664,111,2021-08-24 18:00:02,2021-08-24 18:41:42.277823
5828,103168,4,103168,109,10667,109,11,1,11,Compensation and Benefits,3,10667,115,2021-08-24 18:00:03,2021-08-24 18:02:39.548837
5829,103169,5,103169,40,10667,40,12,1,12,Relationship with Co-Workers,3,10667,115,2021-08-24 18:00:03,2021-08-24 18:02:39.548837
5830,103170,5,103170,117,10667,117,13,1,13,General Satisfaction,3,10667,115,2021-08-24 18:00:03,2021-08-24 18:02:39.548837
5831,103171,3,103171,121,10667,121,14,1,14,Relationship with Supervisor,3,10667,115,2021-08-24 18:00:03,2021-08-24 18:02:39.548837
5832,103172,5,103172,58,10667,58,15,1,15,Company Administration,3,10667,115,2021-08-24 18:00:03,2021-08-24 18:02:39.548837
5833,103173,5,103173,36,10667,36,26,1,26,Direct Questions,3,10667,115,2021-08-24 18:00:03,2021-08-24 18:02:39.548837
5834,103174,3,103174,109,10668,109,11,1,11,Compensation and Benefits,3,10668,116,2021-08-24 18:00:03,2021-08-24 18:41:18.919206
5835,103175,4,103175,113,10668,113,12,1,12,Relationship with Co-Workers,3,10668,116,2021-08-24 18:00:03,2021-08-24 18:41:18.919206
5836,103176,3,103176,45,10668,45,13,1,13,General Satisfaction,3,10668,116,2021-08-24 18:00:03,2021-08-24 18:41:18.919206
5837,103177,2,103177,54,10668,54,14,1,14,Relationship with Supervisor,3,10668,116,2021-08-24 18:00:03,2021-08-24 18:41:18.919206
5838,103178,2,103178,56,10668,56,15,1,15,Company Administration,3,10668,116,2021-08-24 18:00:03,2021-08-24 18:41:18.919206
5839,103179,5,103179,36,10668,36,26,1,26,Direct Questions,3,10668,116,2021-08-24 18:00:03,2021-08-24 18:41:18.919206
5840,103180,5,103180,109,10669,109,11,1,11,Compensation and Benefits,3,10669,117,2021-08-24 18:00:03,2021-08-24 22:54:07.826484
5841,103181,4,103181,111,10669,111,12,1,12,Relationship with Co-Workers,3,10669,117,2021-08-24 18:00:03,2021-08-24 22:54:07.826484
5842,103182,5,103182,117,10669,117,13,1,13,General Satisfaction,3,10669,117,2021-08-24 18:00:03,2021-08-24 22:54:07.826484
5843,103183,4,103183,50,10669,50,14,1,14,Relationship with Supervisor,3,10669,117,2021-08-24 18:00:03,2021-08-24 22:54:07.826484
5844,103184,5,103184,55,10669,55,15,1,15,Company Administration,3,10669,117,2021-08-24 18:00:03,2021-08-24 22:54:07.826484
5845,103185,5,103185,36,10669,36,26,1,26,Direct Questions,3,10669,117,2021-08-24 18:00:03,2021-08-24 22:54:07.826484
5846,103274,5,103274,109,10686,109,11,1,11,Compensation and Benefits,3,10686,113,2021-08-26 18:00:03,2021-08-26 19:14:45.062772
5847,103275,4,103275,112,10686,112,12,1,12,Relationship with Co-Workers,3,10686,113,2021-08-26 18:00:03,2021-08-26 19:14:45.062772
5848,103276,3,103276,117,10686,117,13,1,13,General Satisfaction,3,10686,113,2021-08-26 18:00:03,2021-08-26 19:14:45.062772
5849,103277,2,103277,121,10686,121,14,1,14,Relationship with Supervisor,3,10686,113,2021-08-26 18:00:03,2021-08-26 19:14:45.062772
5850,103278,3,103278,52,10686,52,15,1,15,Company Administration,3,10686,113,2021-08-26 18:00:03,2021-08-26 19:14:45.062772
5851,103279,5,103279,36,10686,36,26,1,26,Direct Questions,3,10686,113,2021-08-26 18:00:03,2021-08-26 19:14:45.062772
5852,103286,4,103286,109,10688,109,11,1,11,Compensation and Benefits,3,10688,115,2021-08-26 18:00:03,2021-08-26 18:05:04.942256
5853,103287,4,103287,111,10688,111,12,1,12,Relationship with Co-Workers,3,10688,115,2021-08-26 18:00:03,2021-08-26 18:05:04.942256
5854,103288,4,103288,48,10688,48,13,1,13,General Satisfaction,3,10688,115,2021-08-26 18:00:03,2021-08-26 18:05:04.942256
5855,103289,4,103289,53,10688,53,14,1,14,Relationship with Supervisor,3,10688,115,2021-08-26 18:00:03,2021-08-26 18:05:04.942256
5856,103290,6,103290,114,10688,114,15,1,15,Company Administration,3,10688,115,2021-08-26 18:00:03,2021-08-26 18:05:04.942256
5857,103291,4,103291,34,10688,34,26,1,26,Direct Questions,3,10688,115,2021-08-26 18:00:03,2021-08-26 18:05:04.942256
5858,103298,5,103298,109,10690,109,11,1,11,Compensation and Benefits,3,10690,117,2021-08-26 18:00:03,2021-08-26 18:01:02.485896
5859,103299,4,103299,41,10690,41,12,1,12,Relationship with Co-Workers,3,10690,117,2021-08-26 18:00:03,2021-08-26 18:01:02.485896
5860,103300,5,103300,45,10690,45,13,1,13,General Satisfaction,3,10690,117,2021-08-26 18:00:03,2021-08-26 18:01:02.485896
5861,103301,5,103301,120,10690,120,14,1,14,Relationship with Supervisor,3,10690,117,2021-08-26 18:00:03,2021-08-26 18:01:02.485896
5862,103302,4,103302,44,10690,44,15,1,15,Company Administration,3,10690,117,2021-08-26 18:00:03,2021-08-26 18:01:02.485896
5863,103303,1,103303,35,10690,35,26,1,26,Direct Questions,3,10690,117,2021-08-26 18:00:03,2021-08-26 18:01:02.485896
5864,103322,2,103322,109,10694,109,11,1,11,Compensation and Benefits,3,10694,107,2021-08-31 18:00:01,2021-08-31 18:54:52.538048
5865,103323,5,103323,111,10694,111,12,1,12,Relationship with Co-Workers,3,10694,107,2021-08-31 18:00:01,2021-08-31 18:54:52.538048
5866,103324,2,103324,46,10694,46,13,1,13,General Satisfaction,3,10694,107,2021-08-31 18:00:01,2021-08-31 18:54:52.538048
5867,103325,5,103325,54,10694,54,14,1,14,Relationship with Supervisor,3,10694,107,2021-08-31 18:00:01,2021-08-31 18:54:52.538048
5868,103326,5,103326,51,10694,51,15,1,15,Company Administration,3,10694,107,2021-08-31 18:00:01,2021-08-31 18:54:52.538048
5869,103327,6,103327,36,10694,36,26,1,26,Direct Questions,3,10694,107,2021-08-31 18:00:01,2021-08-31 18:54:52.538048
5870,103340,3,103340,109,10697,109,11,1,11,Compensation and Benefits,3,10697,110,2021-08-31 18:00:02,2021-08-31 18:32:41.457598
5871,103341,5,103341,39,10697,39,12,1,12,Relationship with Co-Workers,3,10697,110,2021-08-31 18:00:02,2021-08-31 18:32:41.457598
5872,103342,5,103342,119,10697,119,13,1,13,General Satisfaction,3,10697,110,2021-08-31 18:00:02,2021-08-31 18:32:41.457598
5873,103343,6,103343,54,10697,54,14,1,14,Relationship with Supervisor,3,10697,110,2021-08-31 18:00:02,2021-08-31 18:32:41.457598
5874,103344,6,103344,57,10697,57,15,1,15,Company Administration,3,10697,110,2021-08-31 18:00:02,2021-08-31 18:32:41.457598
5875,103345,2,103345,34,10697,34,26,1,26,Direct Questions,3,10697,110,2021-08-31 18:00:02,2021-08-31 18:32:41.457598
5876,103352,4,103352,109,10699,109,11,1,11,Compensation and Benefits,3,10699,113,2021-08-31 18:00:03,2021-08-31 19:10:44.420624
5877,103353,5,103353,40,10699,40,12,1,12,Relationship with Co-Workers,3,10699,113,2021-08-31 18:00:03,2021-08-31 19:10:44.420624
5878,103354,3,103354,46,10699,46,13,1,13,General Satisfaction,3,10699,113,2021-08-31 18:00:03,2021-08-31 19:10:44.420624
5879,103355,1,103355,53,10699,53,14,1,14,Relationship with Supervisor,3,10699,113,2021-08-31 18:00:03,2021-08-31 19:10:44.420624
5880,103356,2,103356,116,10699,116,15,1,15,Company Administration,3,10699,113,2021-08-31 18:00:03,2021-08-31 19:10:44.420624
5881,103357,4,103357,34,10699,34,26,1,26,Direct Questions,3,10699,113,2021-08-31 18:00:03,2021-08-31 19:10:44.420624
5882,103376,5,103376,109,10703,109,11,1,11,Compensation and Benefits,3,10703,117,2021-08-31 18:00:04,2021-08-31 19:04:09.281263
5883,103377,4,103377,113,10703,113,12,1,12,Relationship with Co-Workers,3,10703,117,2021-08-31 18:00:04,2021-08-31 19:04:09.281263
5884,103378,5,103378,49,10703,49,13,1,13,General Satisfaction,3,10703,117,2021-08-31 18:00:04,2021-08-31 19:04:09.281263
5885,103379,5,103379,122,10703,122,14,1,14,Relationship with Supervisor,3,10703,117,2021-08-31 18:00:04,2021-08-31 19:04:09.281263
5886,103380,4,103380,114,10703,114,15,1,15,Company Administration,3,10703,117,2021-08-31 18:00:04,2021-08-31 19:04:09.281263
5887,103381,1,103381,35,10703,35,26,1,26,Direct Questions,3,10703,117,2021-08-31 18:00:04,2021-08-31 19:04:09.281263
5888,103470,5,103470,109,10720,109,11,1,11,Compensation and Benefits,3,10720,114,2021-09-02 18:00:03,2021-09-02 21:13:02.709530
5889,103471,4,103471,39,10720,39,12,1,12,Relationship with Co-Workers,3,10720,114,2021-09-02 18:00:03,2021-09-02 21:13:02.709530
5890,103472,4,103472,48,10720,48,13,1,13,General Satisfaction,3,10720,114,2021-09-02 18:00:03,2021-09-02 21:13:02.709530
5891,103473,4,103473,120,10720,120,14,1,14,Relationship with Supervisor,3,10720,114,2021-09-02 18:00:03,2021-09-02 21:13:02.709530
5892,103474,5,103474,116,10720,116,15,1,15,Company Administration,3,10720,114,2021-09-02 18:00:03,2021-09-02 21:13:02.709530
5893,103475,4,103475,35,10720,35,26,1,26,Direct Questions,3,10720,114,2021-09-02 18:00:03,2021-09-02 21:13:02.709530
5894,103476,4,103476,109,10721,109,11,1,11,Compensation and Benefits,3,10721,115,2021-09-02 18:00:03,2021-09-02 18:03:47.965044
5895,103477,4,103477,112,10721,112,12,1,12,Relationship with Co-Workers,3,10721,115,2021-09-02 18:00:03,2021-09-02 18:03:47.965044
5896,103478,5,103478,47,10721,47,13,1,13,General Satisfaction,3,10721,115,2021-09-02 18:00:03,2021-09-02 18:03:47.965044
5897,103479,5,103479,120,10721,120,14,1,14,Relationship with Supervisor,3,10721,115,2021-09-02 18:00:03,2021-09-02 18:03:47.965044
5898,103480,5,103480,44,10721,44,15,1,15,Company Administration,3,10721,115,2021-09-02 18:00:03,2021-09-02 18:03:47.965044
5899,103481,5,103481,36,10721,36,26,1,26,Direct Questions,3,10721,115,2021-09-02 18:00:03,2021-09-02 18:03:47.965044
5900,103482,1,103482,109,10722,109,11,1,11,Compensation and Benefits,3,10722,116,2021-09-02 18:00:03,2021-09-02 18:42:42.725394
5901,103483,2,103483,40,10722,40,12,1,12,Relationship with Co-Workers,3,10722,116,2021-09-02 18:00:03,2021-09-02 18:42:42.725394
5902,103484,1,103484,46,10722,46,13,1,13,General Satisfaction,3,10722,116,2021-09-02 18:00:03,2021-09-02 18:42:42.725394
5903,103485,2,103485,120,10722,120,14,1,14,Relationship with Supervisor,3,10722,116,2021-09-02 18:00:03,2021-09-02 18:42:42.725394
5904,103486,1,103486,114,10722,114,15,1,15,Company Administration,3,10722,116,2021-09-02 18:00:03,2021-09-02 18:42:42.725394
5905,103487,1,103487,36,10722,36,26,1,26,Direct Questions,3,10722,116,2021-09-02 18:00:03,2021-09-02 18:42:42.725394
5906,103536,4,103536,109,10731,109,11,1,11,Compensation and Benefits,3,10731,113,2021-09-07 18:00:03,2021-09-07 18:39:42.057274
5907,103537,3,103537,42,10731,42,12,1,12,Relationship with Co-Workers,3,10731,113,2021-09-07 18:00:03,2021-09-07 18:39:42.057274
5908,103538,5,103538,48,10731,48,13,1,13,General Satisfaction,3,10731,113,2021-09-07 18:00:03,2021-09-07 18:39:42.057274
5909,103539,2,103539,50,10731,50,14,1,14,Relationship with Supervisor,3,10731,113,2021-09-07 18:00:03,2021-09-07 18:39:42.057274
5910,103540,5,103540,55,10731,55,15,1,15,Company Administration,3,10731,113,2021-09-07 18:00:03,2021-09-07 18:39:42.057274
5911,103541,5,103541,34,10731,34,26,1,26,Direct Questions,3,10731,113,2021-09-07 18:00:03,2021-09-07 18:39:42.057274
5912,103554,1,103554,109,10734,109,11,1,11,Compensation and Benefits,3,10734,116,2021-09-07 18:00:03,2021-09-07 18:34:39.156808
5913,103555,3,103555,111,10734,111,12,1,12,Relationship with Co-Workers,3,10734,116,2021-09-07 18:00:03,2021-09-07 18:34:39.156808
5914,103556,3,103556,45,10734,45,13,1,13,General Satisfaction,3,10734,116,2021-09-07 18:00:03,2021-09-07 18:34:39.156808
5915,103557,1,103557,123,10734,123,14,1,14,Relationship with Supervisor,3,10734,116,2021-09-07 18:00:03,2021-09-07 18:34:39.156808
5916,103558,1,103558,56,10734,56,15,1,15,Company Administration,3,10734,116,2021-09-07 18:00:03,2021-09-07 18:34:39.156808
5917,103559,4,103559,36,10734,36,26,1,26,Direct Questions,3,10734,116,2021-09-07 18:00:03,2021-09-07 18:34:39.156808
5918,103636,3,103636,109,10749,109,11,1,11,Compensation and Benefits,3,10749,110,2021-09-09 18:00:02,2021-09-09 18:42:04.050216
5919,103637,1,103637,41,10749,41,12,1,12,Relationship with Co-Workers,3,10749,110,2021-09-09 18:00:02,2021-09-09 18:42:04.050216
5920,103638,4,103638,46,10749,46,13,1,13,General Satisfaction,3,10749,110,2021-09-09 18:00:02,2021-09-09 18:42:04.050216
5921,103639,6,103639,54,10749,54,14,1,14,Relationship with Supervisor,3,10749,110,2021-09-09 18:00:02,2021-09-09 18:42:04.050216
5922,103640,6,103640,115,10749,115,15,1,15,Company Administration,3,10749,110,2021-09-09 18:00:02,2021-09-09 18:42:04.050216
5923,103641,1,103641,34,10749,34,26,1,26,Direct Questions,3,10749,110,2021-09-09 18:00:02,2021-09-09 18:42:04.050216
5924,103642,4,103642,109,10750,109,11,1,11,Compensation and Benefits,3,10750,111,2021-09-09 18:00:02,2021-09-09 18:05:32.745152
5925,103643,4,103643,39,10750,39,12,1,12,Relationship with Co-Workers,3,10750,111,2021-09-09 18:00:02,2021-09-09 18:05:32.745152
5926,103644,4,103644,118,10750,118,13,1,13,General Satisfaction,3,10750,111,2021-09-09 18:00:02,2021-09-09 18:05:32.745152
5927,103645,4,103645,122,10750,122,14,1,14,Relationship with Supervisor,3,10750,111,2021-09-09 18:00:02,2021-09-09 18:05:32.745152
5928,103646,3,103646,116,10750,116,15,1,15,Company Administration,3,10750,111,2021-09-09 18:00:02,2021-09-09 18:05:32.745152
5929,103647,4,103647,35,10750,35,26,1,26,Direct Questions,3,10750,111,2021-09-09 18:00:02,2021-09-09 18:05:32.745152
5930,103648,4,103648,109,10751,109,11,1,11,Compensation and Benefits,3,10751,113,2021-09-09 18:00:02,2021-09-09 19:01:55.794757
5931,103649,4,103649,111,10751,111,12,1,12,Relationship with Co-Workers,3,10751,113,2021-09-09 18:00:02,2021-09-09 19:01:55.794757
5932,103650,4,103650,119,10751,119,13,1,13,General Satisfaction,3,10751,113,2021-09-09 18:00:02,2021-09-09 19:01:55.794757
5933,103651,2,103651,53,10751,53,14,1,14,Relationship with Supervisor,3,10751,113,2021-09-09 18:00:02,2021-09-09 19:01:55.794757
5934,103652,4,103652,58,10751,58,15,1,15,Company Administration,3,10751,113,2021-09-09 18:00:02,2021-09-09 19:01:55.794757
5935,103653,5,103653,36,10751,36,26,1,26,Direct Questions,3,10751,113,2021-09-09 18:00:02,2021-09-09 19:01:55.794757
5936,103660,5,103660,109,10753,109,11,1,11,Compensation and Benefits,3,10753,115,2021-09-09 18:00:03,2021-09-09 18:00:48.141446
5937,103661,4,103661,112,10753,112,12,1,12,Relationship with Co-Workers,3,10753,115,2021-09-09 18:00:03,2021-09-09 18:00:48.141446
5938,103662,5,103662,49,10753,49,13,1,13,General Satisfaction,3,10753,115,2021-09-09 18:00:03,2021-09-09 18:00:48.141446
5939,103663,3,103663,50,10753,50,14,1,14,Relationship with Supervisor,3,10753,115,2021-09-09 18:00:03,2021-09-09 18:00:48.141446
5940,103664,5,103664,57,10753,57,15,1,15,Company Administration,3,10753,115,2021-09-09 18:00:03,2021-09-09 18:00:48.141446
5941,103665,5,103665,36,10753,36,26,1,26,Direct Questions,3,10753,115,2021-09-09 18:00:03,2021-09-09 18:00:48.141446
5942,103672,5,103672,109,10755,109,11,1,11,Compensation and Benefits,3,10755,117,2021-09-09 18:00:03,2021-09-09 18:46:32.990370
5943,103673,4,103673,113,10755,113,12,1,12,Relationship with Co-Workers,3,10755,117,2021-09-09 18:00:03,2021-09-09 18:46:32.990370
5944,103674,4,103674,46,10755,46,13,1,13,General Satisfaction,3,10755,117,2021-09-09 18:00:03,2021-09-09 18:46:32.990370
5945,103675,5,103675,122,10755,122,14,1,14,Relationship with Supervisor,3,10755,117,2021-09-09 18:00:03,2021-09-09 18:46:32.990370
5946,103676,4,103676,56,10755,56,15,1,15,Company Administration,3,10755,117,2021-09-09 18:00:03,2021-09-09 18:46:32.990370
5947,103677,5,103677,36,10755,36,26,1,26,Direct Questions,3,10755,117,2021-09-09 18:00:03,2021-09-09 18:46:32.990370
5948,103696,4,103696,109,10759,109,11,1,11,Compensation and Benefits,3,10759,108,2021-09-14 18:00:01,2021-09-14 18:41:30.705630
5949,103697,3,103697,40,10759,40,12,1,12,Relationship with Co-Workers,3,10759,108,2021-09-14 18:00:01,2021-09-14 18:41:30.705630
5950,103698,4,103698,46,10759,46,13,1,13,General Satisfaction,3,10759,108,2021-09-14 18:00:01,2021-09-14 18:41:30.705630
5951,103699,3,103699,50,10759,50,14,1,14,Relationship with Supervisor,3,10759,108,2021-09-14 18:00:01,2021-09-14 18:41:30.705630
5952,103700,4,103700,51,10759,51,15,1,15,Company Administration,3,10759,108,2021-09-14 18:00:01,2021-09-14 18:41:30.705630
5953,103701,6,103701,36,10759,36,26,1,26,Direct Questions,3,10759,108,2021-09-14 18:00:01,2021-09-14 18:41:30.705630
5954,103702,3,103702,109,10760,109,11,1,11,Compensation and Benefits,3,10760,109,2021-09-14 18:00:02,2021-09-14 18:02:18.607533
5955,103703,5,103703,42,10760,42,12,1,12,Relationship with Co-Workers,3,10760,109,2021-09-14 18:00:02,2021-09-14 18:02:18.607533
5956,103704,4,103704,48,10760,48,13,1,13,General Satisfaction,3,10760,109,2021-09-14 18:00:02,2021-09-14 18:02:18.607533
5957,103705,3,103705,120,10760,120,14,1,14,Relationship with Supervisor,3,10760,109,2021-09-14 18:00:02,2021-09-14 18:02:18.607533
5958,103706,5,103706,57,10760,57,15,1,15,Company Administration,3,10760,109,2021-09-14 18:00:02,2021-09-14 18:02:18.607533
5959,103707,5,103707,35,10760,35,26,1,26,Direct Questions,3,10760,109,2021-09-14 18:00:02,2021-09-14 18:02:18.607533
5960,103738,2,103738,109,10766,109,11,1,11,Compensation and Benefits,3,10766,116,2021-09-14 18:00:03,2021-09-14 18:45:01.760305
5961,103739,1,103739,42,10766,42,12,1,12,Relationship with Co-Workers,3,10766,116,2021-09-14 18:00:03,2021-09-14 18:45:01.760305
5962,103740,1,103740,46,10766,46,13,1,13,General Satisfaction,3,10766,116,2021-09-14 18:00:03,2021-09-14 18:45:01.760305
5963,103741,1,103741,120,10766,120,14,1,14,Relationship with Supervisor,3,10766,116,2021-09-14 18:00:03,2021-09-14 18:45:01.760305
5964,103742,3,103742,51,10766,51,15,1,15,Company Administration,3,10766,116,2021-09-14 18:00:03,2021-09-14 18:45:01.760305
5965,103743,3,103743,35,10766,35,26,1,26,Direct Questions,3,10766,116,2021-09-14 18:00:03,2021-09-14 18:45:01.760305
5966,103802,2,103802,109,10778,109,11,1,11,Compensation and Benefits,3,10778,107,2021-09-16 18:00:01,2021-09-16 18:43:11.974617
5967,103803,4,103803,43,10778,43,12,1,12,Relationship with Co-Workers,3,10778,107,2021-09-16 18:00:01,2021-09-16 18:43:11.974617
5968,103804,4,103804,47,10778,47,13,1,13,General Satisfaction,3,10778,107,2021-09-16 18:00:01,2021-09-16 18:43:11.974617
5969,103805,4,103805,53,10778,53,14,1,14,Relationship with Supervisor,3,10778,107,2021-09-16 18:00:01,2021-09-16 18:43:11.974617
5970,103806,5,103806,116,10778,116,15,1,15,Company Administration,3,10778,107,2021-09-16 18:00:01,2021-09-16 18:43:11.974617
5971,103807,6,103807,36,10778,36,26,1,26,Direct Questions,3,10778,107,2021-09-16 18:00:01,2021-09-16 18:43:11.974617
5972,103814,1,103814,109,10780,109,11,1,11,Compensation and Benefits,3,10780,109,2021-09-16 18:00:02,2021-09-16 18:02:45.093605
5973,103815,4,103815,111,10780,111,12,1,12,Relationship with Co-Workers,3,10780,109,2021-09-16 18:00:02,2021-09-16 18:02:45.093605
5974,103816,4,103816,45,10780,45,13,1,13,General Satisfaction,3,10780,109,2021-09-16 18:00:02,2021-09-16 18:02:45.093605
5975,103817,3,103817,123,10780,123,14,1,14,Relationship with Supervisor,3,10780,109,2021-09-16 18:00:02,2021-09-16 18:02:45.093605
5976,103818,4,103818,52,10780,52,15,1,15,Company Administration,3,10780,109,2021-09-16 18:00:02,2021-09-16 18:02:45.093605
5977,103819,5,103819,36,10780,36,26,1,26,Direct Questions,3,10780,109,2021-09-16 18:00:02,2021-09-16 18:02:45.093605
5978,103844,5,103844,109,10785,109,11,1,11,Compensation and Benefits,3,10785,115,2021-09-16 18:00:03,2021-09-16 18:07:46.975123
5979,103845,4,103845,113,10785,113,12,1,12,Relationship with Co-Workers,3,10785,115,2021-09-16 18:00:03,2021-09-16 18:07:46.975123
5980,103846,4,103846,119,10785,119,13,1,13,General Satisfaction,3,10785,115,2021-09-16 18:00:03,2021-09-16 18:07:46.975123
5981,103847,3,103847,121,10785,121,14,1,14,Relationship with Supervisor,3,10785,115,2021-09-16 18:00:03,2021-09-16 18:07:46.975123
5982,103848,5,103848,115,10785,115,15,1,15,Company Administration,3,10785,115,2021-09-16 18:00:03,2021-09-16 18:07:46.975123
5983,103849,5,103849,35,10785,35,26,1,26,Direct Questions,3,10785,115,2021-09-16 18:00:03,2021-09-16 18:07:46.975123
5984,103868,6,103868,109,10789,109,11,1,11,Compensation and Benefits,3,10789,156,2021-09-16 18:00:03,2021-09-16 20:54:56.918216
5985,103869,6,103869,43,10789,43,12,1,12,Relationship with Co-Workers,3,10789,156,2021-09-16 18:00:03,2021-09-16 20:54:56.918216
5986,103870,6,103870,119,10789,119,13,1,13,General Satisfaction,3,10789,156,2021-09-16 18:00:03,2021-09-16 20:54:56.918216
5987,103871,5,103871,121,10789,121,14,1,14,Relationship with Supervisor,3,10789,156,2021-09-16 18:00:03,2021-09-16 20:54:56.918216
5988,103872,6,103872,52,10789,52,15,1,15,Company Administration,3,10789,156,2021-09-16 18:00:03,2021-09-16 20:54:56.918216
5989,103873,6,103873,34,10789,34,26,1,26,Direct Questions,3,10789,156,2021-09-16 18:00:03,2021-09-16 20:54:56.918216
5990,103874,2,103874,109,10790,109,11,1,11,Compensation and Benefits,3,10790,107,2021-09-21 18:00:01,2021-09-21 19:28:30.500151
5991,103875,4,103875,40,10790,40,12,1,12,Relationship with Co-Workers,3,10790,107,2021-09-21 18:00:01,2021-09-21 19:28:30.500151
5992,103876,4,103876,47,10790,47,13,1,13,General Satisfaction,3,10790,107,2021-09-21 18:00:01,2021-09-21 19:28:30.500151
5993,103877,4,103877,122,10790,122,14,1,14,Relationship with Supervisor,3,10790,107,2021-09-21 18:00:01,2021-09-21 19:28:30.500151
5994,103878,4,103878,57,10790,57,15,1,15,Company Administration,3,10790,107,2021-09-21 18:00:01,2021-09-21 19:28:30.500151
5995,103879,1,103879,35,10790,35,26,1,26,Direct Questions,3,10790,107,2021-09-21 18:00:01,2021-09-21 19:28:30.500151
5996,103892,1,103892,109,10793,109,11,1,11,Compensation and Benefits,3,10793,110,2021-09-21 18:00:02,2021-09-21 19:04:22.269580
5997,103893,3,103893,40,10793,40,12,1,12,Relationship with Co-Workers,3,10793,110,2021-09-21 18:00:02,2021-09-21 19:04:22.269580
5998,103894,5,103894,48,10793,48,13,1,13,General Satisfaction,3,10793,110,2021-09-21 18:00:02,2021-09-21 19:04:22.269580
5999,103895,6,103895,121,10793,121,14,1,14,Relationship with Supervisor,3,10793,110,2021-09-21 18:00:02,2021-09-21 19:04:22.269580
6000,103896,6,103896,58,10793,58,15,1,15,Company Administration,3,10793,110,2021-09-21 18:00:02,2021-09-21 19:04:22.269580
6001,103897,1,103897,35,10793,35,26,1,26,Direct Questions,3,10793,110,2021-09-21 18:00:02,2021-09-21 19:04:22.269580
6002,103904,4,103904,109,10795,109,11,1,11,Compensation and Benefits,3,10795,113,2021-09-21 18:00:02,2021-09-21 18:33:06.366127
6003,103905,3,103905,41,10795,41,12,1,12,Relationship with Co-Workers,3,10795,113,2021-09-21 18:00:02,2021-09-21 18:33:06.366127
6004,103906,3,103906,49,10795,49,13,1,13,General Satisfaction,3,10795,113,2021-09-21 18:00:02,2021-09-21 18:33:06.366127
6005,103907,2,103907,54,10795,54,14,1,14,Relationship with Supervisor,3,10795,113,2021-09-21 18:00:02,2021-09-21 18:33:06.366127
6006,103908,4,103908,58,10795,58,15,1,15,Company Administration,3,10795,113,2021-09-21 18:00:02,2021-09-21 18:33:06.366127
6007,103909,5,103909,34,10795,34,26,1,26,Direct Questions,3,10795,113,2021-09-21 18:00:02,2021-09-21 18:33:06.366127
6008,103922,2,103922,109,10798,109,11,1,11,Compensation and Benefits,3,10798,116,2021-09-21 18:00:03,2021-09-21 18:32:52.354261
6009,103923,1,103923,43,10798,43,12,1,12,Relationship with Co-Workers,3,10798,116,2021-09-21 18:00:03,2021-09-21 18:32:52.354261
6010,103924,3,103924,119,10798,119,13,1,13,General Satisfaction,3,10798,116,2021-09-21 18:00:03,2021-09-21 18:32:52.354261
6011,103925,3,103925,122,10798,122,14,1,14,Relationship with Supervisor,3,10798,116,2021-09-21 18:00:03,2021-09-21 18:32:52.354261
6012,103926,3,103926,58,10798,58,15,1,15,Company Administration,3,10798,116,2021-09-21 18:00:03,2021-09-21 18:32:52.354261
6013,103927,3,103927,36,10798,36,26,1,26,Direct Questions,3,10798,116,2021-09-21 18:00:03,2021-09-21 18:32:52.354261
6014,104016,4,104016,109,10815,109,11,1,11,Compensation and Benefits,3,10815,113,2021-09-23 18:00:03,2021-09-23 18:38:13.036097
6015,104017,3,104017,43,10815,43,12,1,12,Relationship with Co-Workers,3,10815,113,2021-09-23 18:00:03,2021-09-23 18:38:13.036097
6016,104018,5,104018,48,10815,48,13,1,13,General Satisfaction,3,10815,113,2021-09-23 18:00:03,2021-09-23 18:38:13.036097
6017,104019,2,104019,53,10815,53,14,1,14,Relationship with Supervisor,3,10815,113,2021-09-23 18:00:03,2021-09-23 18:38:13.036097
6018,104020,4,104020,114,10815,114,15,1,15,Company Administration,3,10815,113,2021-09-23 18:00:03,2021-09-23 18:38:13.036097
6019,104021,6,104021,34,10815,34,26,1,26,Direct Questions,3,10815,113,2021-09-23 18:00:03,2021-09-23 18:38:13.036097
6020,104022,4,104022,109,10816,109,11,1,11,Compensation and Benefits,3,10816,114,2021-09-23 18:00:03,2021-09-23 18:36:30.587018
6021,104023,4,104023,111,10816,111,12,1,12,Relationship with Co-Workers,3,10816,114,2021-09-23 18:00:03,2021-09-23 18:36:30.587018
6022,104024,4,104024,45,10816,45,13,1,13,General Satisfaction,3,10816,114,2021-09-23 18:00:03,2021-09-23 18:36:30.587018
6023,104025,4,104025,122,10816,122,14,1,14,Relationship with Supervisor,3,10816,114,2021-09-23 18:00:03,2021-09-23 18:36:30.587018
6024,104026,4,104026,58,10816,58,15,1,15,Company Administration,3,10816,114,2021-09-23 18:00:03,2021-09-23 18:36:30.587018
6025,104027,4,104027,36,10816,36,26,1,26,Direct Questions,3,10816,114,2021-09-23 18:00:03,2021-09-23 18:36:30.587018
6026,104034,3,104034,109,10818,109,11,1,11,Compensation and Benefits,3,10818,116,2021-09-23 18:00:03,2021-09-23 18:00:48.668200
6027,104035,4,104035,112,10818,112,12,1,12,Relationship with Co-Workers,3,10818,116,2021-09-23 18:00:03,2021-09-23 18:00:48.668200
6028,104036,3,104036,45,10818,45,13,1,13,General Satisfaction,3,10818,116,2021-09-23 18:00:03,2021-09-23 18:00:48.668200
6029,104037,2,104037,123,10818,123,14,1,14,Relationship with Supervisor,3,10818,116,2021-09-23 18:00:03,2021-09-23 18:00:48.668200
6030,104038,1,104038,115,10818,115,15,1,15,Company Administration,3,10818,116,2021-09-23 18:00:03,2021-09-23 18:00:48.668200
6031,104039,4,104039,35,10818,35,26,1,26,Direct Questions,3,10818,116,2021-09-23 18:00:03,2021-09-23 18:00:48.668200
6032,104082,4,104082,109,10826,109,11,1,11,Compensation and Benefits,3,10826,111,2021-09-28 18:00:02,2021-09-29 00:30:13.242882
6033,104083,4,104083,42,10826,42,12,1,12,Relationship with Co-Workers,3,10826,111,2021-09-28 18:00:02,2021-09-29 00:30:13.242882
6034,104084,3,104084,117,10826,117,13,1,13,General Satisfaction,3,10826,111,2021-09-28 18:00:02,2021-09-29 00:30:13.242882
6035,104085,5,104085,53,10826,53,14,1,14,Relationship with Supervisor,3,10826,111,2021-09-28 18:00:02,2021-09-29 00:30:13.242882
6036,104086,4,104086,56,10826,56,15,1,15,Company Administration,3,10826,111,2021-09-28 18:00:02,2021-09-29 00:30:13.242882
6037,104087,5,104087,35,10826,35,26,1,26,Direct Questions,3,10826,111,2021-09-28 18:00:02,2021-09-29 00:30:13.242882
6038,104100,4,104100,109,10829,109,11,1,11,Compensation and Benefits,3,10829,115,2021-09-28 18:00:03,2021-09-28 18:21:53.196371
6039,104101,4,104101,112,10829,112,12,1,12,Relationship with Co-Workers,3,10829,115,2021-09-28 18:00:03,2021-09-28 18:21:53.196371
6040,104102,4,104102,45,10829,45,13,1,13,General Satisfaction,3,10829,115,2021-09-28 18:00:03,2021-09-28 18:21:53.196371
6041,104103,4,104103,54,10829,54,14,1,14,Relationship with Supervisor,3,10829,115,2021-09-28 18:00:03,2021-09-28 18:21:53.196371
6042,104104,4,104104,52,10829,52,15,1,15,Company Administration,3,10829,115,2021-09-28 18:00:03,2021-09-28 18:21:53.196371
6043,104105,5,104105,34,10829,34,26,1,26,Direct Questions,3,10829,115,2021-09-28 18:00:03,2021-09-28 18:21:53.196371
6044,104118,4,104118,109,10832,109,11,1,11,Compensation and Benefits,3,10832,118,2021-09-28 18:00:04,2021-09-28 18:35:23.696609
6045,104119,4,104119,41,10832,41,12,1,12,Relationship with Co-Workers,3,10832,118,2021-09-28 18:00:04,2021-09-28 18:35:23.696609
6046,104120,3,104120,117,10832,117,13,1,13,General Satisfaction,3,10832,118,2021-09-28 18:00:04,2021-09-28 18:35:23.696609
6047,104121,3,104121,120,10832,120,14,1,14,Relationship with Supervisor,3,10832,118,2021-09-28 18:00:04,2021-09-28 18:35:23.696609
6048,104122,3,104122,52,10832,52,15,1,15,Company Administration,3,10832,118,2021-09-28 18:00:04,2021-09-28 18:35:23.696609
6049,104123,6,104123,35,10832,35,26,1,26,Direct Questions,3,10832,118,2021-09-28 18:00:04,2021-09-28 18:35:23.696609
6050,104194,4,104194,109,10846,109,11,1,11,Compensation and Benefits,3,10846,108,2021-09-30 18:00:02,2021-09-30 18:01:53.792143
6051,104195,4,104195,112,10846,112,12,1,12,Relationship with Co-Workers,3,10846,108,2021-09-30 18:00:02,2021-09-30 18:01:53.792143
6052,104196,4,104196,46,10846,46,13,1,13,General Satisfaction,3,10846,108,2021-09-30 18:00:02,2021-09-30 18:01:53.792143
6053,104197,3,104197,50,10846,50,14,1,14,Relationship with Supervisor,3,10846,108,2021-09-30 18:00:02,2021-09-30 18:01:53.792143
6054,104198,4,104198,114,10846,114,15,1,15,Company Administration,3,10846,108,2021-09-30 18:00:02,2021-09-30 18:01:53.792143
6055,104199,6,104199,34,10846,34,26,1,26,Direct Questions,3,10846,108,2021-09-30 18:00:02,2021-09-30 18:01:53.792143
6056,104218,4,104218,109,10850,109,11,1,11,Compensation and Benefits,3,10850,113,2021-09-30 18:00:03,2021-09-30 18:44:45.353908
6057,104219,3,104219,40,10850,40,12,1,12,Relationship with Co-Workers,3,10850,113,2021-09-30 18:00:03,2021-09-30 18:44:45.353908
6058,104220,3,104220,117,10850,117,13,1,13,General Satisfaction,3,10850,113,2021-09-30 18:00:03,2021-09-30 18:44:45.353908
6059,104221,6,104221,123,10850,123,14,1,14,Relationship with Supervisor,3,10850,113,2021-09-30 18:00:03,2021-09-30 18:44:45.353908
6060,104222,5,104222,55,10850,55,15,1,15,Company Administration,3,10850,113,2021-09-30 18:00:03,2021-09-30 18:44:45.353908
6061,104223,4,104223,36,10850,36,26,1,26,Direct Questions,3,10850,113,2021-09-30 18:00:03,2021-09-30 18:44:45.353908
6062,104230,4,104230,109,10852,109,11,1,11,Compensation and Benefits,3,10852,115,2021-09-30 18:00:03,2021-09-30 18:11:43.649563
6063,104231,4,104231,111,10852,111,12,1,12,Relationship with Co-Workers,3,10852,115,2021-09-30 18:00:03,2021-09-30 18:11:43.649563
6064,104232,5,104232,47,10852,47,13,1,13,General Satisfaction,3,10852,115,2021-09-30 18:00:03,2021-09-30 18:11:43.649563
6065,104233,4,104233,53,10852,53,14,1,14,Relationship with Supervisor,3,10852,115,2021-09-30 18:00:03,2021-09-30 18:11:43.649563
6066,104234,5,104234,57,10852,57,15,1,15,Company Administration,3,10852,115,2021-09-30 18:00:03,2021-09-30 18:11:43.649563
6067,104235,5,104235,34,10852,34,26,1,26,Direct Questions,3,10852,115,2021-09-30 18:00:03,2021-09-30 18:11:43.649563
6068,104296,1,104296,109,10863,109,11,1,11,Compensation and Benefits,3,10863,109,2021-10-05 18:00:02,2021-10-05 18:43:35.805709
6069,104297,4,104297,111,10863,111,12,1,12,Relationship with Co-Workers,3,10863,109,2021-10-05 18:00:02,2021-10-05 18:43:35.805709
6070,104298,3,104298,45,10863,45,13,1,13,General Satisfaction,3,10863,109,2021-10-05 18:00:02,2021-10-05 18:43:35.805709
6071,104299,5,104299,53,10863,53,14,1,14,Relationship with Supervisor,3,10863,109,2021-10-05 18:00:02,2021-10-05 18:43:35.805709
6072,104300,6,104300,57,10863,57,15,1,15,Company Administration,3,10863,109,2021-10-05 18:00:02,2021-10-05 18:43:35.805709
6073,104301,6,104301,34,10863,34,26,1,26,Direct Questions,3,10863,109,2021-10-05 18:00:02,2021-10-05 18:43:35.805709
6074,104320,3,104320,109,10867,109,11,1,11,Compensation and Benefits,3,10867,114,2021-10-05 18:00:03,2021-10-05 18:38:48.397020
6075,104321,2,104321,39,10867,39,12,1,12,Relationship with Co-Workers,3,10867,114,2021-10-05 18:00:03,2021-10-05 18:38:48.397020
6076,104322,4,104322,118,10867,118,13,1,13,General Satisfaction,3,10867,114,2021-10-05 18:00:03,2021-10-05 18:38:48.397020
6077,104323,4,104323,54,10867,54,14,1,14,Relationship with Supervisor,3,10867,114,2021-10-05 18:00:03,2021-10-05 18:38:48.397020
6078,104324,2,104324,58,10867,58,15,1,15,Company Administration,3,10867,114,2021-10-05 18:00:03,2021-10-05 18:38:48.397020
6079,104325,4,104325,34,10867,34,26,1,26,Direct Questions,3,10867,114,2021-10-05 18:00:03,2021-10-05 18:38:48.397020
6080,104362,6,104362,109,10874,109,11,1,11,Compensation and Benefits,3,10874,158,2021-10-05 18:00:05,2021-10-05 18:40:21.897232
6081,104363,6,104363,113,10874,113,12,1,12,Relationship with Co-Workers,3,10874,158,2021-10-05 18:00:05,2021-10-05 18:40:21.897232
6082,104364,6,104364,48,10874,48,13,1,13,General Satisfaction,3,10874,158,2021-10-05 18:00:05,2021-10-05 18:40:21.897232
6083,104365,6,104365,123,10874,123,14,1,14,Relationship with Supervisor,3,10874,158,2021-10-05 18:00:05,2021-10-05 18:40:21.897232
6084,104366,6,104366,57,10874,57,15,1,15,Company Administration,3,10874,158,2021-10-05 18:00:05,2021-10-05 18:40:21.897232
6085,104367,6,104367,34,10874,34,26,1,26,Direct Questions,3,10874,158,2021-10-05 18:00:05,2021-10-05 18:40:21.897232
6086,104426,4,104426,109,10886,109,11,1,11,Compensation and Benefits,3,10886,108,2021-10-07 18:00:02,2021-10-07 18:46:23.320466
6087,104427,3,104427,42,10886,42,12,1,12,Relationship with Co-Workers,3,10886,108,2021-10-07 18:00:02,2021-10-07 18:46:23.320466
6088,104428,4,104428,118,10886,118,13,1,13,General Satisfaction,3,10886,108,2021-10-07 18:00:02,2021-10-07 18:46:23.320466
6089,104429,4,104429,53,10886,53,14,1,14,Relationship with Supervisor,3,10886,108,2021-10-07 18:00:02,2021-10-07 18:46:23.320466
6090,104430,4,104430,57,10886,57,15,1,15,Company Administration,3,10886,108,2021-10-07 18:00:02,2021-10-07 18:46:23.320466
6091,104431,6,104431,35,10886,35,26,1,26,Direct Questions,3,10886,108,2021-10-07 18:00:02,2021-10-07 18:46:23.320466
6092,104432,2,104432,109,10887,109,11,1,11,Compensation and Benefits,3,10887,109,2021-10-07 18:00:02,2021-10-07 18:37:08.826520
6093,104433,3,104433,111,10887,111,12,1,12,Relationship with Co-Workers,3,10887,109,2021-10-07 18:00:02,2021-10-07 18:37:08.826520
6094,104434,5,104434,49,10887,49,13,1,13,General Satisfaction,3,10887,109,2021-10-07 18:00:02,2021-10-07 18:37:08.826520
6095,104435,4,104435,50,10887,50,14,1,14,Relationship with Supervisor,3,10887,109,2021-10-07 18:00:02,2021-10-07 18:37:08.826520
6096,104436,4,104436,51,10887,51,15,1,15,Company Administration,3,10887,109,2021-10-07 18:00:02,2021-10-07 18:37:08.826520
6097,104437,6,104437,35,10887,35,26,1,26,Direct Questions,3,10887,109,2021-10-07 18:00:02,2021-10-07 18:37:08.826520
6098,102564,4,102564,110,10547,110,11,1,11,Compensation and Benefits,3,10547,113,2021-08-10 18:00:02,2021-08-10 23:26:24.441564
6099,102565,2,102565,112,10547,112,12,1,12,Relationship with Co-Workers,3,10547,113,2021-08-10 18:00:02,2021-08-10 23:26:24.441564
6100,102566,5,102566,48,10547,48,13,1,13,General Satisfaction,3,10547,113,2021-08-10 18:00:02,2021-08-10 23:26:24.441564
6101,102567,2,102567,54,10547,54,14,1,14,Relationship with Supervisor,3,10547,113,2021-08-10 18:00:02,2021-08-10 23:26:24.441564
6102,102568,3,102568,57,10547,57,15,1,15,Company Administration,3,10547,113,2021-08-10 18:00:02,2021-08-10 23:26:24.441564
6103,102569,5,102569,34,10547,34,26,1,26,Direct Questions,3,10547,113,2021-08-10 18:00:02,2021-08-10 23:26:24.441564
6104,102588,5,102588,110,10551,110,11,1,11,Compensation and Benefits,3,10551,117,2021-08-10 18:00:03,2021-08-10 18:01:17.968694
6105,102589,5,102589,113,10551,113,12,1,12,Relationship with Co-Workers,3,10551,117,2021-08-10 18:00:03,2021-08-10 18:01:17.968694
6106,102590,5,102590,45,10551,45,13,1,13,General Satisfaction,3,10551,117,2021-08-10 18:00:03,2021-08-10 18:01:17.968694
6107,102591,5,102591,53,10551,53,14,1,14,Relationship with Supervisor,3,10551,117,2021-08-10 18:00:03,2021-08-10 18:01:17.968694
6108,102592,5,102592,57,10551,57,15,1,15,Company Administration,3,10551,117,2021-08-10 18:00:03,2021-08-10 18:01:17.968694
6109,102593,6,102593,36,10551,36,26,1,26,Direct Questions,3,10551,117,2021-08-10 18:00:03,2021-08-10 18:01:17.968694
6110,102594,4,102594,110,10552,110,11,1,11,Compensation and Benefits,3,10552,118,2021-08-10 18:00:03,2021-08-10 19:12:06.030687
6111,102595,3,102595,41,10552,41,12,1,12,Relationship with Co-Workers,3,10552,118,2021-08-10 18:00:03,2021-08-10 19:12:06.030687
6112,102596,4,102596,117,10552,117,13,1,13,General Satisfaction,3,10552,118,2021-08-10 18:00:03,2021-08-10 19:12:06.030687
6113,102597,4,102597,54,10552,54,14,1,14,Relationship with Supervisor,3,10552,118,2021-08-10 18:00:03,2021-08-10 19:12:06.030687
6114,102598,4,102598,52,10552,52,15,1,15,Company Administration,3,10552,118,2021-08-10 18:00:03,2021-08-10 19:12:06.030687
6115,102599,6,102599,36,10552,36,26,1,26,Direct Questions,3,10552,118,2021-08-10 18:00:03,2021-08-10 19:12:06.030687
6116,102764,3,102764,110,10590,110,11,1,11,Compensation and Benefits,3,10590,109,2021-08-12 18:00:01,2021-08-13 12:21:41.517707
6117,102765,4,102765,41,10590,41,12,1,12,Relationship with Co-Workers,3,10590,109,2021-08-12 18:00:01,2021-08-13 12:21:41.517707
6118,102766,4,102766,118,10590,118,13,1,13,General Satisfaction,3,10590,109,2021-08-12 18:00:01,2021-08-13 12:21:41.517707
6119,102767,3,102767,123,10590,123,14,1,14,Relationship with Supervisor,3,10590,109,2021-08-12 18:00:01,2021-08-13 12:21:41.517707
6120,102768,5,102768,116,10590,116,15,1,15,Company Administration,3,10590,109,2021-08-12 18:00:01,2021-08-13 12:21:41.517707
6121,102769,6,102769,36,10590,36,26,1,26,Direct Questions,3,10590,109,2021-08-12 18:00:01,2021-08-13 12:21:41.517707
6122,102782,4,102782,110,10593,110,11,1,11,Compensation and Benefits,3,10593,113,2021-08-12 18:00:02,2021-08-12 18:03:01.520162
6123,102783,4,102783,111,10593,111,12,1,12,Relationship with Co-Workers,3,10593,113,2021-08-12 18:00:02,2021-08-12 18:03:01.520162
6124,102784,3,102784,47,10593,47,13,1,13,General Satisfaction,3,10593,113,2021-08-12 18:00:02,2021-08-12 18:03:01.520162
6125,102785,6,102785,123,10593,123,14,1,14,Relationship with Supervisor,3,10593,113,2021-08-12 18:00:02,2021-08-12 18:03:01.520162
6126,102786,5,102786,115,10593,115,15,1,15,Company Administration,3,10593,113,2021-08-12 18:00:02,2021-08-12 18:03:01.520162
6127,102787,5,102787,34,10593,34,26,1,26,Direct Questions,3,10593,113,2021-08-12 18:00:02,2021-08-12 18:03:01.520162
6128,102806,5,102806,110,10597,110,11,1,11,Compensation and Benefits,3,10597,117,2021-08-12 18:00:03,2021-08-12 19:32:40.879506
6129,102807,4,102807,112,10597,112,12,1,12,Relationship with Co-Workers,3,10597,117,2021-08-12 18:00:03,2021-08-12 19:32:40.879506
6130,102808,5,102808,46,10597,46,13,1,13,General Satisfaction,3,10597,117,2021-08-12 18:00:03,2021-08-12 19:32:40.879506
6131,102809,5,102809,122,10597,122,14,1,14,Relationship with Supervisor,3,10597,117,2021-08-12 18:00:03,2021-08-12 19:32:40.879506
6132,102810,5,102810,114,10597,114,15,1,15,Company Administration,3,10597,117,2021-08-12 18:00:03,2021-08-12 19:32:40.879506
6133,102811,5,102811,36,10597,36,26,1,26,Direct Questions,3,10597,117,2021-08-12 18:00:03,2021-08-12 19:32:40.879506
6134,102866,4,102866,110,10607,110,11,1,11,Compensation and Benefits,3,10607,114,2021-08-17 18:00:03,2021-08-17 20:39:47.478435
6135,102867,4,102867,39,10607,39,12,1,12,Relationship with Co-Workers,3,10607,114,2021-08-17 18:00:03,2021-08-17 20:39:47.478435
6136,102868,4,102868,119,10607,119,13,1,13,General Satisfaction,3,10607,114,2021-08-17 18:00:03,2021-08-17 20:39:47.478435
6137,102869,3,102869,53,10607,53,14,1,14,Relationship with Supervisor,3,10607,114,2021-08-17 18:00:03,2021-08-17 20:39:47.478435
6138,102870,3,102870,52,10607,52,15,1,15,Company Administration,3,10607,114,2021-08-17 18:00:03,2021-08-17 20:39:47.478435
6139,102871,5,102871,35,10607,35,26,1,26,Direct Questions,3,10607,114,2021-08-17 18:00:03,2021-08-17 20:39:47.478435
6140,102878,1,102878,110,10609,110,11,1,11,Compensation and Benefits,3,10609,116,2021-08-17 18:00:03,2021-08-17 18:11:23.740622
6141,102879,3,102879,41,10609,41,12,1,12,Relationship with Co-Workers,3,10609,116,2021-08-17 18:00:03,2021-08-17 18:11:23.740622
6142,102880,3,102880,49,10609,49,13,1,13,General Satisfaction,3,10609,116,2021-08-17 18:00:03,2021-08-17 18:11:23.740622
6143,102881,1,102881,53,10609,53,14,1,14,Relationship with Supervisor,3,10609,116,2021-08-17 18:00:03,2021-08-17 18:11:23.740622
6144,102882,1,102882,115,10609,115,15,1,15,Company Administration,3,10609,116,2021-08-17 18:00:03,2021-08-17 18:11:23.740622
6145,102883,5,102883,36,10609,36,26,1,26,Direct Questions,3,10609,116,2021-08-17 18:00:03,2021-08-17 18:11:23.740622
6146,103048,4,103048,110,10647,110,11,1,11,Compensation and Benefits,3,10647,107,2021-08-19 18:00:01,2021-08-19 18:49:03.908241
6147,103049,4,103049,41,10647,41,12,1,12,Relationship with Co-Workers,3,10647,107,2021-08-19 18:00:01,2021-08-19 18:49:03.908241
6148,103050,4,103050,118,10647,118,13,1,13,General Satisfaction,3,10647,107,2021-08-19 18:00:01,2021-08-19 18:49:03.908241
6149,103051,5,103051,50,10647,50,14,1,14,Relationship with Supervisor,3,10647,107,2021-08-19 18:00:01,2021-08-19 18:49:03.908241
6150,103052,4,103052,52,10647,52,15,1,15,Company Administration,3,10647,107,2021-08-19 18:00:01,2021-08-19 18:49:03.908241
6151,103053,6,103053,36,10647,36,26,1,26,Direct Questions,3,10647,107,2021-08-19 18:00:01,2021-08-19 18:49:03.908241
6152,103078,4,103078,110,10652,110,11,1,11,Compensation and Benefits,3,10652,113,2021-08-19 18:00:02,2021-08-19 19:21:50.199975
6153,103079,2,103079,41,10652,41,12,1,12,Relationship with Co-Workers,3,10652,113,2021-08-19 18:00:02,2021-08-19 19:21:50.199975
6154,103080,4,103080,118,10652,118,13,1,13,General Satisfaction,3,10652,113,2021-08-19 18:00:02,2021-08-19 19:21:50.199975
6155,103081,6,103081,123,10652,123,14,1,14,Relationship with Supervisor,3,10652,113,2021-08-19 18:00:02,2021-08-19 19:21:50.199975
6156,103082,3,103082,57,10652,57,15,1,15,Company Administration,3,10652,113,2021-08-19 18:00:02,2021-08-19 19:21:50.199975
6157,103083,5,103083,36,10652,36,26,1,26,Direct Questions,3,10652,113,2021-08-19 18:00:02,2021-08-19 19:21:50.199975
6158,103084,4,103084,110,10653,110,11,1,11,Compensation and Benefits,3,10653,114,2021-08-19 18:00:02,2021-08-19 20:43:38.483434
6159,103085,4,103085,113,10653,113,12,1,12,Relationship with Co-Workers,3,10653,114,2021-08-19 18:00:02,2021-08-19 20:43:38.483434
6160,103086,4,103086,47,10653,47,13,1,13,General Satisfaction,3,10653,114,2021-08-19 18:00:02,2021-08-19 20:43:38.483434
6161,103087,3,103087,53,10653,53,14,1,14,Relationship with Supervisor,3,10653,114,2021-08-19 18:00:02,2021-08-19 20:43:38.483434
6162,103088,4,103088,51,10653,51,15,1,15,Company Administration,3,10653,114,2021-08-19 18:00:02,2021-08-19 20:43:38.483434
6163,103089,5,103089,36,10653,36,26,1,26,Direct Questions,3,10653,114,2021-08-19 18:00:02,2021-08-19 20:43:38.483434
6164,103096,3,103096,110,10655,110,11,1,11,Compensation and Benefits,3,10655,116,2021-08-19 18:00:03,2021-08-19 18:53:24.761688
6165,103097,3,103097,41,10655,41,12,1,12,Relationship with Co-Workers,3,10655,116,2021-08-19 18:00:03,2021-08-19 18:53:24.761688
6166,103098,3,103098,45,10655,45,13,1,13,General Satisfaction,3,10655,116,2021-08-19 18:00:03,2021-08-19 18:53:24.761688
6167,103099,2,103099,120,10655,120,14,1,14,Relationship with Supervisor,3,10655,116,2021-08-19 18:00:03,2021-08-19 18:53:24.761688
6168,103100,2,103100,58,10655,58,15,1,15,Company Administration,3,10655,116,2021-08-19 18:00:03,2021-08-19 18:53:24.761688
6169,103101,5,103101,35,10655,35,26,1,26,Direct Questions,3,10655,116,2021-08-19 18:00:03,2021-08-19 18:53:24.761688
6170,103126,3,103126,110,10660,110,11,1,11,Compensation and Benefits,3,10660,107,2021-08-24 18:00:01,2021-08-24 18:42:38.502394
6171,103127,3,103127,40,10660,40,12,1,12,Relationship with Co-Workers,3,10660,107,2021-08-24 18:00:01,2021-08-24 18:42:38.502394
6172,103128,3,103128,46,10660,46,13,1,13,General Satisfaction,3,10660,107,2021-08-24 18:00:01,2021-08-24 18:42:38.502394
6173,103129,5,103129,54,10660,54,14,1,14,Relationship with Supervisor,3,10660,107,2021-08-24 18:00:01,2021-08-24 18:42:38.502394
6174,103130,6,103130,56,10660,56,15,1,15,Company Administration,3,10660,107,2021-08-24 18:00:01,2021-08-24 18:42:38.502394
6175,103131,1,103131,35,10660,35,26,1,26,Direct Questions,3,10660,107,2021-08-24 18:00:01,2021-08-24 18:42:38.502394
6176,103138,2,103138,110,10662,110,11,1,11,Compensation and Benefits,3,10662,109,2021-08-24 18:00:02,2021-08-24 18:05:38.780535
6177,103139,5,103139,113,10662,113,12,1,12,Relationship with Co-Workers,3,10662,109,2021-08-24 18:00:02,2021-08-24 18:05:38.780535
6178,103140,4,103140,45,10662,45,13,1,13,General Satisfaction,3,10662,109,2021-08-24 18:00:02,2021-08-24 18:05:38.780535
6179,103141,5,103141,120,10662,120,14,1,14,Relationship with Supervisor,3,10662,109,2021-08-24 18:00:02,2021-08-24 18:05:38.780535
6180,103142,4,103142,44,10662,44,15,1,15,Company Administration,3,10662,109,2021-08-24 18:00:02,2021-08-24 18:05:38.780535
6181,103143,5,103143,35,10662,35,26,1,26,Direct Questions,3,10662,109,2021-08-24 18:00:02,2021-08-24 18:05:38.780535
6182,103292,2,103292,110,10689,110,11,1,11,Compensation and Benefits,3,10689,116,2021-08-26 18:00:03,2021-08-26 18:48:55.171335
6183,103293,2,103293,43,10689,43,12,1,12,Relationship with Co-Workers,3,10689,116,2021-08-26 18:00:03,2021-08-26 18:48:55.171335
6184,103294,3,103294,49,10689,49,13,1,13,General Satisfaction,3,10689,116,2021-08-26 18:00:03,2021-08-26 18:48:55.171335
6185,103295,3,103295,54,10689,54,14,1,14,Relationship with Supervisor,3,10689,116,2021-08-26 18:00:03,2021-08-26 18:48:55.171335
6186,103296,1,103296,116,10689,116,15,1,15,Company Administration,3,10689,116,2021-08-26 18:00:03,2021-08-26 18:48:55.171335
6187,103297,4,103297,35,10689,35,26,1,26,Direct Questions,3,10689,116,2021-08-26 18:00:03,2021-08-26 18:48:55.171335
6188,103304,4,103304,110,10691,110,11,1,11,Compensation and Benefits,3,10691,118,2021-08-26 18:00:04,2021-08-26 18:42:51.330207
6189,103305,3,103305,43,10691,43,12,1,12,Relationship with Co-Workers,3,10691,118,2021-08-26 18:00:04,2021-08-26 18:42:51.330207
6190,103306,5,103306,46,10691,46,13,1,13,General Satisfaction,3,10691,118,2021-08-26 18:00:04,2021-08-26 18:42:51.330207
6191,103307,2,103307,120,10691,120,14,1,14,Relationship with Supervisor,3,10691,118,2021-08-26 18:00:04,2021-08-26 18:42:51.330207
6192,103308,4,103308,55,10691,55,15,1,15,Company Administration,3,10691,118,2021-08-26 18:00:04,2021-08-26 18:42:51.330207
6193,103309,6,103309,36,10691,36,26,1,26,Direct Questions,3,10691,118,2021-08-26 18:00:04,2021-08-26 18:42:51.330207
6194,103370,2,103370,110,10702,110,11,1,11,Compensation and Benefits,3,10702,116,2021-08-31 18:00:03,2021-08-31 18:43:01.632041
6195,103371,2,103371,40,10702,40,12,1,12,Relationship with Co-Workers,3,10702,116,2021-08-31 18:00:03,2021-08-31 18:43:01.632041
6196,103372,1,103372,117,10702,117,13,1,13,General Satisfaction,3,10702,116,2021-08-31 18:00:03,2021-08-31 18:43:01.632041
6197,103373,1,103373,50,10702,50,14,1,14,Relationship with Supervisor,3,10702,116,2021-08-31 18:00:03,2021-08-31 18:43:01.632041
6198,103374,1,103374,58,10702,58,15,1,15,Company Administration,3,10702,116,2021-08-31 18:00:03,2021-08-31 18:43:01.632041
6199,103375,1,103375,35,10702,35,26,1,26,Direct Questions,3,10702,116,2021-08-31 18:00:03,2021-08-31 18:43:01.632041
6200,103458,4,103458,110,10718,110,11,1,11,Compensation and Benefits,3,10718,111,2021-09-02 18:00:02,2021-09-02 18:33:22.679136
6201,103459,4,103459,40,10718,40,12,1,12,Relationship with Co-Workers,3,10718,111,2021-09-02 18:00:02,2021-09-02 18:33:22.679136
6202,103460,4,103460,118,10718,118,13,1,13,General Satisfaction,3,10718,111,2021-09-02 18:00:02,2021-09-02 18:33:22.679136
6203,103461,4,103461,122,10718,122,14,1,14,Relationship with Supervisor,3,10718,111,2021-09-02 18:00:02,2021-09-02 18:33:22.679136
6204,103462,4,103462,44,10718,44,15,1,15,Company Administration,3,10718,111,2021-09-02 18:00:02,2021-09-02 18:33:22.679136
6205,103463,5,103463,36,10718,36,26,1,26,Direct Questions,3,10718,111,2021-09-02 18:00:02,2021-09-02 18:33:22.679136
6206,103542,4,103542,110,10732,110,11,1,11,Compensation and Benefits,3,10732,114,2021-09-07 18:00:03,2021-09-07 18:34:16.777098
6207,103543,4,103543,111,10732,111,12,1,12,Relationship with Co-Workers,3,10732,114,2021-09-07 18:00:03,2021-09-07 18:34:16.777098
6208,103544,4,103544,45,10732,45,13,1,13,General Satisfaction,3,10732,114,2021-09-07 18:00:03,2021-09-07 18:34:16.777098
6209,103545,4,103545,50,10732,50,14,1,14,Relationship with Supervisor,3,10732,114,2021-09-07 18:00:03,2021-09-07 18:34:16.777098
6210,103546,4,103546,55,10732,55,15,1,15,Company Administration,3,10732,114,2021-09-07 18:00:03,2021-09-07 18:34:16.777098
6211,103547,5,103547,34,10732,34,26,1,26,Direct Questions,3,10732,114,2021-09-07 18:00:03,2021-09-07 18:34:16.777098
6212,103560,5,103560,110,10735,110,11,1,11,Compensation and Benefits,3,10735,117,2021-09-07 18:00:04,2021-09-07 18:41:30.682165
6213,103561,4,103561,40,10735,40,12,1,12,Relationship with Co-Workers,3,10735,117,2021-09-07 18:00:04,2021-09-07 18:41:30.682165
6214,103562,4,103562,46,10735,46,13,1,13,General Satisfaction,3,10735,117,2021-09-07 18:00:04,2021-09-07 18:41:30.682165
6215,103563,5,103563,53,10735,53,14,1,14,Relationship with Supervisor,3,10735,117,2021-09-07 18:00:04,2021-09-07 18:41:30.682165
6216,103564,5,103564,44,10735,44,15,1,15,Company Administration,3,10735,117,2021-09-07 18:00:04,2021-09-07 18:41:30.682165
6217,103565,1,103565,35,10735,35,26,1,26,Direct Questions,3,10735,117,2021-09-07 18:00:04,2021-09-07 18:41:30.682165
6218,103678,4,103678,110,10756,110,11,1,11,Compensation and Benefits,3,10756,118,2021-09-09 18:00:03,2021-09-09 18:42:00.167053
6219,103679,4,103679,112,10756,112,12,1,12,Relationship with Co-Workers,3,10756,118,2021-09-09 18:00:03,2021-09-09 18:42:00.167053
6220,103680,4,103680,118,10756,118,13,1,13,General Satisfaction,3,10756,118,2021-09-09 18:00:03,2021-09-09 18:42:00.167053
6221,103681,2,103681,120,10756,120,14,1,14,Relationship with Supervisor,3,10756,118,2021-09-09 18:00:03,2021-09-09 18:42:00.167053
6222,103682,5,103682,116,10756,116,15,1,15,Company Administration,3,10756,118,2021-09-09 18:00:03,2021-09-09 18:42:00.167053
6223,103683,6,103683,36,10756,36,26,1,26,Direct Questions,3,10756,118,2021-09-09 18:00:03,2021-09-09 18:42:00.167053
6224,103708,4,103708,110,10761,110,11,1,11,Compensation and Benefits,3,10761,110,2021-09-14 18:00:02,2021-09-14 18:01:44.177135
6225,103709,2,103709,41,10761,41,12,1,12,Relationship with Co-Workers,3,10761,110,2021-09-14 18:00:02,2021-09-14 18:01:44.177135
6226,103710,6,103710,49,10761,49,13,1,13,General Satisfaction,3,10761,110,2021-09-14 18:00:02,2021-09-14 18:01:44.177135
6227,103711,6,103711,50,10761,50,14,1,14,Relationship with Supervisor,3,10761,110,2021-09-14 18:00:02,2021-09-14 18:01:44.177135
6228,103712,5,103712,116,10761,116,15,1,15,Company Administration,3,10761,110,2021-09-14 18:00:02,2021-09-14 18:01:44.177135
6229,103713,1,103713,35,10761,35,26,1,26,Direct Questions,3,10761,110,2021-09-14 18:00:02,2021-09-14 18:01:44.177135
6230,103726,4,103726,110,10764,110,11,1,11,Compensation and Benefits,3,10764,114,2021-09-14 18:00:02,2021-09-14 18:32:31.120527
6231,103727,2,103727,111,10764,111,12,1,12,Relationship with Co-Workers,3,10764,114,2021-09-14 18:00:02,2021-09-14 18:32:31.120527
6232,103728,4,103728,117,10764,117,13,1,13,General Satisfaction,3,10764,114,2021-09-14 18:00:02,2021-09-14 18:32:31.120527
6233,103729,4,103729,121,10764,121,14,1,14,Relationship with Supervisor,3,10764,114,2021-09-14 18:00:02,2021-09-14 18:32:31.120527
6234,103730,4,103730,55,10764,55,15,1,15,Company Administration,3,10764,114,2021-09-14 18:00:02,2021-09-14 18:32:31.120527
6235,103731,4,103731,35,10764,35,26,1,26,Direct Questions,3,10764,114,2021-09-14 18:00:02,2021-09-14 18:32:31.120527
6236,103750,4,103750,110,10768,110,11,1,11,Compensation and Benefits,3,10768,118,2021-09-14 18:00:03,2021-09-14 18:43:15.964843
6237,103751,4,103751,43,10768,43,12,1,12,Relationship with Co-Workers,3,10768,118,2021-09-14 18:00:03,2021-09-14 18:43:15.964843
6238,103752,4,103752,117,10768,117,13,1,13,General Satisfaction,3,10768,118,2021-09-14 18:00:03,2021-09-14 18:43:15.964843
6239,103753,3,103753,54,10768,54,14,1,14,Relationship with Supervisor,3,10768,118,2021-09-14 18:00:03,2021-09-14 18:43:15.964843
6240,103754,4,103754,44,10768,44,15,1,15,Company Administration,3,10768,118,2021-09-14 18:00:03,2021-09-14 18:43:15.964843
6241,103755,6,103755,35,10768,35,26,1,26,Direct Questions,3,10768,118,2021-09-14 18:00:03,2021-09-14 18:43:15.964843
6242,103756,6,103756,110,10769,110,11,1,11,Compensation and Benefits,3,10769,156,2021-09-14 18:00:03,2021-09-14 21:38:51.383207
6243,103757,6,103757,43,10769,43,12,1,12,Relationship with Co-Workers,3,10769,156,2021-09-14 18:00:03,2021-09-14 21:38:51.383207
6244,103758,6,103758,45,10769,45,13,1,13,General Satisfaction,3,10769,156,2021-09-14 18:00:03,2021-09-14 21:38:51.383207
6245,103759,6,103759,123,10769,123,14,1,14,Relationship with Supervisor,3,10769,156,2021-09-14 18:00:03,2021-09-14 21:38:51.383207
6246,103760,6,103760,57,10769,57,15,1,15,Company Administration,3,10769,156,2021-09-14 18:00:03,2021-09-14 21:38:51.383207
6247,103761,6,103761,36,10769,36,26,1,26,Direct Questions,3,10769,156,2021-09-14 18:00:03,2021-09-14 21:38:51.383207
6248,103808,3,103808,110,10779,110,11,1,11,Compensation and Benefits,3,10779,108,2021-09-16 18:00:02,2021-09-16 18:01:17.696585
6249,103809,3,103809,112,10779,112,12,1,12,Relationship with Co-Workers,3,10779,108,2021-09-16 18:00:02,2021-09-16 18:01:17.696585
6250,103810,4,103810,46,10779,46,13,1,13,General Satisfaction,3,10779,108,2021-09-16 18:00:02,2021-09-16 18:01:17.696585
6251,103811,3,103811,50,10779,50,14,1,14,Relationship with Supervisor,3,10779,108,2021-09-16 18:00:02,2021-09-16 18:01:17.696585
6252,103812,4,103812,56,10779,56,15,1,15,Company Administration,3,10779,108,2021-09-16 18:00:02,2021-09-16 18:01:17.696585
6253,103813,5,103813,36,10779,36,26,1,26,Direct Questions,3,10779,108,2021-09-16 18:00:02,2021-09-16 18:01:17.696585
6254,103820,4,103820,110,10781,110,11,1,11,Compensation and Benefits,3,10781,110,2021-09-16 18:00:02,2021-09-16 18:30:32.996974
6255,103821,3,103821,41,10781,41,12,1,12,Relationship with Co-Workers,3,10781,110,2021-09-16 18:00:02,2021-09-16 18:30:32.996974
6256,103822,5,103822,119,10781,119,13,1,13,General Satisfaction,3,10781,110,2021-09-16 18:00:02,2021-09-16 18:30:32.996974
6257,103823,6,103823,54,10781,54,14,1,14,Relationship with Supervisor,3,10781,110,2021-09-16 18:00:02,2021-09-16 18:30:32.996974
6258,103824,4,103824,116,10781,116,15,1,15,Company Administration,3,10781,110,2021-09-16 18:00:02,2021-09-16 18:30:32.996974
6259,103825,1,103825,35,10781,35,26,1,26,Direct Questions,3,10781,110,2021-09-16 18:00:02,2021-09-16 18:30:32.996974
6260,103826,4,103826,110,10782,110,11,1,11,Compensation and Benefits,3,10782,111,2021-09-16 18:00:02,2021-09-16 19:09:52.504366
6261,103827,2,103827,40,10782,40,12,1,12,Relationship with Co-Workers,3,10782,111,2021-09-16 18:00:02,2021-09-16 19:09:52.504366
6262,103828,4,103828,47,10782,47,13,1,13,General Satisfaction,3,10782,111,2021-09-16 18:00:02,2021-09-16 19:09:52.504366
6263,103829,4,103829,122,10782,122,14,1,14,Relationship with Supervisor,3,10782,111,2021-09-16 18:00:02,2021-09-16 19:09:52.504366
6264,103830,4,103830,56,10782,56,15,1,15,Company Administration,3,10782,111,2021-09-16 18:00:02,2021-09-16 19:09:52.504366
6265,103831,4,103831,34,10782,34,26,1,26,Direct Questions,3,10782,111,2021-09-16 18:00:02,2021-09-16 19:09:52.504366
6266,103832,5,103832,110,10783,110,11,1,11,Compensation and Benefits,3,10783,113,2021-09-16 18:00:02,2021-09-16 18:37:39.999674
6267,103833,3,103833,40,10783,40,12,1,12,Relationship with Co-Workers,3,10783,113,2021-09-16 18:00:02,2021-09-16 18:37:39.999674
6268,103834,4,103834,118,10783,118,13,1,13,General Satisfaction,3,10783,113,2021-09-16 18:00:02,2021-09-16 18:37:39.999674
6269,103835,6,103835,123,10783,123,14,1,14,Relationship with Supervisor,3,10783,113,2021-09-16 18:00:02,2021-09-16 18:37:39.999674
6270,103836,3,103836,56,10783,56,15,1,15,Company Administration,3,10783,113,2021-09-16 18:00:02,2021-09-16 18:37:39.999674
6271,103837,4,103837,36,10783,36,26,1,26,Direct Questions,3,10783,113,2021-09-16 18:00:02,2021-09-16 18:37:39.999674
6272,103880,4,103880,110,10791,110,11,1,11,Compensation and Benefits,3,10791,108,2021-09-21 18:00:01,2021-09-21 18:00:54.004639
6273,103881,3,103881,41,10791,41,12,1,12,Relationship with Co-Workers,3,10791,108,2021-09-21 18:00:01,2021-09-21 18:00:54.004639
6274,103882,4,103882,45,10791,45,13,1,13,General Satisfaction,3,10791,108,2021-09-21 18:00:01,2021-09-21 18:00:54.004639
6275,103883,3,103883,50,10791,50,14,1,14,Relationship with Supervisor,3,10791,108,2021-09-21 18:00:01,2021-09-21 18:00:54.004639
6276,103884,4,103884,58,10791,58,15,1,15,Company Administration,3,10791,108,2021-09-21 18:00:01,2021-09-21 18:00:54.004639
6277,103885,6,103885,35,10791,35,26,1,26,Direct Questions,3,10791,108,2021-09-21 18:00:01,2021-09-21 18:00:54.004639
6278,103886,2,103886,110,10792,110,11,1,11,Compensation and Benefits,3,10792,109,2021-09-21 18:00:01,2021-09-21 18:31:00.302769
6279,103887,4,103887,39,10792,39,12,1,12,Relationship with Co-Workers,3,10792,109,2021-09-21 18:00:01,2021-09-21 18:31:00.302769
6280,103888,4,103888,117,10792,117,13,1,13,General Satisfaction,3,10792,109,2021-09-21 18:00:01,2021-09-21 18:31:00.302769
6281,103889,3,103889,54,10792,54,14,1,14,Relationship with Supervisor,3,10792,109,2021-09-21 18:00:01,2021-09-21 18:31:00.302769
6282,103890,3,103890,115,10792,115,15,1,15,Company Administration,3,10792,109,2021-09-21 18:00:01,2021-09-21 18:31:00.302769
6283,103891,6,103891,34,10792,34,26,1,26,Direct Questions,3,10792,109,2021-09-21 18:00:01,2021-09-21 18:31:00.302769
6284,103928,5,103928,110,10799,110,11,1,11,Compensation and Benefits,3,10799,117,2021-09-21 18:00:03,2021-09-21 18:30:13.429383
6285,103929,4,103929,112,10799,112,12,1,12,Relationship with Co-Workers,3,10799,117,2021-09-21 18:00:03,2021-09-21 18:30:13.429383
6286,103930,4,103930,49,10799,49,13,1,13,General Satisfaction,3,10799,117,2021-09-21 18:00:03,2021-09-21 18:30:13.429383
6287,103931,3,103931,121,10799,121,14,1,14,Relationship with Supervisor,3,10799,117,2021-09-21 18:00:03,2021-09-21 18:30:13.429383
6288,103932,4,103932,44,10799,44,15,1,15,Company Administration,3,10799,117,2021-09-21 18:00:03,2021-09-21 18:30:13.429383
6289,103933,5,103933,34,10799,34,26,1,26,Direct Questions,3,10799,117,2021-09-21 18:00:03,2021-09-21 18:30:13.429383
6290,103940,5,103940,110,10801,110,11,1,11,Compensation and Benefits,3,10801,156,2021-09-21 18:00:03,2021-09-22 03:59:15.977741
6291,103941,6,103941,39,10801,39,12,1,12,Relationship with Co-Workers,3,10801,156,2021-09-21 18:00:03,2021-09-22 03:59:15.977741
6292,103942,6,103942,47,10801,47,13,1,13,General Satisfaction,3,10801,156,2021-09-21 18:00:03,2021-09-22 03:59:15.977741
6293,103943,6,103943,120,10801,120,14,1,14,Relationship with Supervisor,3,10801,156,2021-09-21 18:00:03,2021-09-22 03:59:15.977741
6294,103944,6,103944,116,10801,116,15,1,15,Company Administration,3,10801,156,2021-09-21 18:00:03,2021-09-22 03:59:15.977741
6295,103945,6,103945,36,10801,36,26,1,26,Direct Questions,3,10801,156,2021-09-21 18:00:03,2021-09-22 03:59:15.977741
6296,103998,2,103998,110,10812,110,11,1,11,Compensation and Benefits,3,10812,109,2021-09-23 18:00:02,2021-09-23 18:10:43.521841
6297,103999,4,103999,40,10812,40,12,1,12,Relationship with Co-Workers,3,10812,109,2021-09-23 18:00:02,2021-09-23 18:10:43.521841
6298,104000,4,104000,45,10812,45,13,1,13,General Satisfaction,3,10812,109,2021-09-23 18:00:02,2021-09-23 18:10:43.521841
6299,104001,4,104001,54,10812,54,14,1,14,Relationship with Supervisor,3,10812,109,2021-09-23 18:00:02,2021-09-23 18:10:43.521841
6300,104002,6,104002,56,10812,56,15,1,15,Company Administration,3,10812,109,2021-09-23 18:00:02,2021-09-23 18:10:43.521841
6301,104003,6,104003,36,10812,36,26,1,26,Direct Questions,3,10812,109,2021-09-23 18:00:02,2021-09-23 18:10:43.521841
6302,104004,4,104004,110,10813,110,11,1,11,Compensation and Benefits,3,10813,110,2021-09-23 18:00:02,2021-09-23 21:47:41.226075
6303,104005,5,104005,39,10813,39,12,1,12,Relationship with Co-Workers,3,10813,110,2021-09-23 18:00:02,2021-09-23 21:47:41.226075
6304,104006,5,104006,47,10813,47,13,1,13,General Satisfaction,3,10813,110,2021-09-23 18:00:02,2021-09-23 21:47:41.226075
6305,104007,6,104007,122,10813,122,14,1,14,Relationship with Supervisor,3,10813,110,2021-09-23 18:00:02,2021-09-23 21:47:41.226075
6306,104008,6,104008,58,10813,58,15,1,15,Company Administration,3,10813,110,2021-09-23 18:00:02,2021-09-23 21:47:41.226075
6307,104009,6,104009,36,10813,36,26,1,26,Direct Questions,3,10813,110,2021-09-23 18:00:02,2021-09-23 21:47:41.226075
6308,104010,5,104010,110,10814,110,11,1,11,Compensation and Benefits,3,10814,111,2021-09-23 18:00:02,2021-09-23 18:56:06.197818
6309,104011,4,104011,42,10814,42,12,1,12,Relationship with Co-Workers,3,10814,111,2021-09-23 18:00:02,2021-09-23 18:56:06.197818
6310,104012,4,104012,117,10814,117,13,1,13,General Satisfaction,3,10814,111,2021-09-23 18:00:02,2021-09-23 18:56:06.197818
6311,104013,5,104013,54,10814,54,14,1,14,Relationship with Supervisor,3,10814,111,2021-09-23 18:00:02,2021-09-23 18:56:06.197818
6312,104014,4,104014,116,10814,116,15,1,15,Company Administration,3,10814,111,2021-09-23 18:00:02,2021-09-23 18:56:06.197818
6313,104015,4,104015,36,10814,36,26,1,26,Direct Questions,3,10814,111,2021-09-23 18:00:02,2021-09-23 18:56:06.197818
6314,104028,5,104028,110,10817,110,11,1,11,Compensation and Benefits,3,10817,115,2021-09-23 18:00:03,2021-09-23 18:11:02.432330
6315,104029,5,104029,41,10817,41,12,1,12,Relationship with Co-Workers,3,10817,115,2021-09-23 18:00:03,2021-09-23 18:11:02.432330
6316,104030,5,104030,45,10817,45,13,1,13,General Satisfaction,3,10817,115,2021-09-23 18:00:03,2021-09-23 18:11:02.432330
6317,104031,5,104031,53,10817,53,14,1,14,Relationship with Supervisor,3,10817,115,2021-09-23 18:00:03,2021-09-23 18:11:02.432330
6318,104032,5,104032,51,10817,51,15,1,15,Company Administration,3,10817,115,2021-09-23 18:00:03,2021-09-23 18:11:02.432330
6319,104033,5,104033,35,10817,35,26,1,26,Direct Questions,3,10817,115,2021-09-23 18:00:03,2021-09-23 18:11:02.432330
6320,104064,4,104064,110,10823,110,11,1,11,Compensation and Benefits,3,10823,108,2021-09-28 18:00:02,2021-09-28 18:01:55.823317
6321,104065,3,104065,40,10823,40,12,1,12,Relationship with Co-Workers,3,10823,108,2021-09-28 18:00:02,2021-09-28 18:01:55.823317
6322,104066,4,104066,45,10823,45,13,1,13,General Satisfaction,3,10823,108,2021-09-28 18:00:02,2021-09-28 18:01:55.823317
6323,104067,4,104067,122,10823,122,14,1,14,Relationship with Supervisor,3,10823,108,2021-09-28 18:00:02,2021-09-28 18:01:55.823317
6324,104068,4,104068,114,10823,114,15,1,15,Company Administration,3,10823,108,2021-09-28 18:00:02,2021-09-28 18:01:55.823317
6325,104069,6,104069,36,10823,36,26,1,26,Direct Questions,3,10823,108,2021-09-28 18:00:02,2021-09-28 18:01:55.823317
6326,104106,1,104106,110,10830,110,11,1,11,Compensation and Benefits,3,10830,116,2021-09-28 18:00:03,2021-09-28 20:35:16.284059
6327,104107,4,104107,39,10830,39,12,1,12,Relationship with Co-Workers,3,10830,116,2021-09-28 18:00:03,2021-09-28 20:35:16.284059
6328,104108,4,104108,119,10830,119,13,1,13,General Satisfaction,3,10830,116,2021-09-28 18:00:03,2021-09-28 20:35:16.284059
6329,104109,3,104109,120,10830,120,14,1,14,Relationship with Supervisor,3,10830,116,2021-09-28 18:00:03,2021-09-28 20:35:16.284059
6330,104110,4,104110,51,10830,51,15,1,15,Company Administration,3,10830,116,2021-09-28 18:00:03,2021-09-28 20:35:16.284059
6331,104111,4,104111,34,10830,34,26,1,26,Direct Questions,3,10830,116,2021-09-28 18:00:03,2021-09-28 20:35:16.284059
6332,104200,3,104200,110,10847,110,11,1,11,Compensation and Benefits,3,10847,109,2021-09-30 18:00:02,2021-09-30 18:11:23.672517
6333,104201,1,104201,42,10847,42,12,1,12,Relationship with Co-Workers,3,10847,109,2021-09-30 18:00:02,2021-09-30 18:11:23.672517
6334,104202,6,104202,46,10847,46,13,1,13,General Satisfaction,3,10847,109,2021-09-30 18:00:02,2021-09-30 18:11:23.672517
6335,104203,4,104203,120,10847,120,14,1,14,Relationship with Supervisor,3,10847,109,2021-09-30 18:00:02,2021-09-30 18:11:23.672517
6336,104204,4,104204,52,10847,52,15,1,15,Company Administration,3,10847,109,2021-09-30 18:00:02,2021-09-30 18:11:23.672517
6337,104205,6,104205,34,10847,34,26,1,26,Direct Questions,3,10847,109,2021-09-30 18:00:02,2021-09-30 18:11:23.672517
6338,104206,5,104206,110,10848,110,11,1,11,Compensation and Benefits,3,10848,110,2021-09-30 18:00:02,2021-09-30 18:50:12.327240
6339,104207,2,104207,43,10848,43,12,1,12,Relationship with Co-Workers,3,10848,110,2021-09-30 18:00:02,2021-09-30 18:50:12.327240
6340,104208,5,104208,45,10848,45,13,1,13,General Satisfaction,3,10848,110,2021-09-30 18:00:02,2021-09-30 18:50:12.327240
6341,104209,5,104209,50,10848,50,14,1,14,Relationship with Supervisor,3,10848,110,2021-09-30 18:00:02,2021-09-30 18:50:12.327240
6342,104210,4,104210,116,10848,116,15,1,15,Company Administration,3,10848,110,2021-09-30 18:00:02,2021-09-30 18:50:12.327240
6343,104211,1,104211,36,10848,36,26,1,26,Direct Questions,3,10848,110,2021-09-30 18:00:02,2021-09-30 18:50:12.327240
6344,104248,4,104248,110,10855,110,11,1,11,Compensation and Benefits,3,10855,118,2021-09-30 18:00:04,2021-09-30 19:17:05.925680
6345,104249,3,104249,42,10855,42,12,1,12,Relationship with Co-Workers,3,10855,118,2021-09-30 18:00:04,2021-09-30 19:17:05.925680
6346,104250,3,104250,49,10855,49,13,1,13,General Satisfaction,3,10855,118,2021-09-30 18:00:04,2021-09-30 19:17:05.925680
6347,104251,1,104251,121,10855,121,14,1,14,Relationship with Supervisor,3,10855,118,2021-09-30 18:00:04,2021-09-30 19:17:05.925680
6348,104252,4,104252,57,10855,57,15,1,15,Company Administration,3,10855,118,2021-09-30 18:00:04,2021-09-30 19:17:05.925680
6349,104253,6,104253,36,10855,36,26,1,26,Direct Questions,3,10855,118,2021-09-30 18:00:04,2021-09-30 19:17:05.925680
6350,104278,4,104278,110,10860,110,11,1,11,Compensation and Benefits,3,10860,160,2021-09-30 18:00:05,2021-10-01 11:40:51.494838
6351,104279,6,104279,39,10860,39,12,1,12,Relationship with Co-Workers,3,10860,160,2021-09-30 18:00:05,2021-10-01 11:40:51.494838
6352,104280,5,104280,117,10860,117,13,1,13,General Satisfaction,3,10860,160,2021-09-30 18:00:05,2021-10-01 11:40:51.494838
6353,104281,6,104281,53,10860,53,14,1,14,Relationship with Supervisor,3,10860,160,2021-09-30 18:00:05,2021-10-01 11:40:51.494838
6354,104282,6,104282,57,10860,57,15,1,15,Company Administration,3,10860,160,2021-09-30 18:00:05,2021-10-01 11:40:51.494838
6355,104283,5,104283,35,10860,35,26,1,26,Direct Questions,3,10860,160,2021-09-30 18:00:05,2021-10-01 11:40:51.494838
6356,104284,4,104284,110,10861,110,11,1,11,Compensation and Benefits,3,10861,107,2021-10-05 18:00:01,2021-10-05 18:47:08.557813
6357,104285,3,104285,39,10861,39,12,1,12,Relationship with Co-Workers,3,10861,107,2021-10-05 18:00:01,2021-10-05 18:47:08.557813
6358,104286,4,104286,117,10861,117,13,1,13,General Satisfaction,3,10861,107,2021-10-05 18:00:01,2021-10-05 18:47:08.557813
6359,104287,3,104287,53,10861,53,14,1,14,Relationship with Supervisor,3,10861,107,2021-10-05 18:00:01,2021-10-05 18:47:08.557813
6360,104288,5,104288,55,10861,55,15,1,15,Company Administration,3,10861,107,2021-10-05 18:00:01,2021-10-05 18:47:08.557813
6361,104289,1,104289,34,10861,34,26,1,26,Direct Questions,3,10861,107,2021-10-05 18:00:01,2021-10-05 18:47:08.557813
6362,104308,4,104308,110,10865,110,11,1,11,Compensation and Benefits,3,10865,111,2021-10-05 18:00:02,2021-10-05 18:36:57.701009
6363,104309,3,104309,40,10865,40,12,1,12,Relationship with Co-Workers,3,10865,111,2021-10-05 18:00:02,2021-10-05 18:36:57.701009
6364,104310,4,104310,49,10865,49,13,1,13,General Satisfaction,3,10865,111,2021-10-05 18:00:02,2021-10-05 18:36:57.701009
6365,104311,4,104311,53,10865,53,14,1,14,Relationship with Supervisor,3,10865,111,2021-10-05 18:00:02,2021-10-05 18:36:57.701009
6366,104312,4,104312,116,10865,116,15,1,15,Company Administration,3,10865,111,2021-10-05 18:00:02,2021-10-05 18:36:57.701009
6367,104313,5,104313,34,10865,34,26,1,26,Direct Questions,3,10865,111,2021-10-05 18:00:02,2021-10-05 18:36:57.701009
6368,104326,5,104326,110,10868,110,11,1,11,Compensation and Benefits,3,10868,115,2021-10-05 18:00:03,2021-10-05 18:43:06.229713
6369,104327,4,104327,112,10868,112,12,1,12,Relationship with Co-Workers,3,10868,115,2021-10-05 18:00:03,2021-10-05 18:43:06.229713
6370,104328,4,104328,119,10868,119,13,1,13,General Satisfaction,3,10868,115,2021-10-05 18:00:03,2021-10-05 18:43:06.229713
6371,104329,4,104329,120,10868,120,14,1,14,Relationship with Supervisor,3,10868,115,2021-10-05 18:00:03,2021-10-05 18:43:06.229713
6372,104330,5,104330,44,10868,44,15,1,15,Company Administration,3,10868,115,2021-10-05 18:00:03,2021-10-05 18:43:06.229713
6373,104331,5,104331,36,10868,36,26,1,26,Direct Questions,3,10868,115,2021-10-05 18:00:03,2021-10-05 18:43:06.229713
6374,104338,5,104338,110,10870,110,11,1,11,Compensation and Benefits,3,10870,117,2021-10-05 18:00:04,2021-10-05 19:02:45.853312
6375,104339,4,104339,112,10870,112,12,1,12,Relationship with Co-Workers,3,10870,117,2021-10-05 18:00:04,2021-10-05 19:02:45.853312
6376,104340,4,104340,47,10870,47,13,1,13,General Satisfaction,3,10870,117,2021-10-05 18:00:04,2021-10-05 19:02:45.853312
6377,104341,4,104341,54,10870,54,14,1,14,Relationship with Supervisor,3,10870,117,2021-10-05 18:00:04,2021-10-05 19:02:45.853312
6378,104342,4,104342,56,10870,56,15,1,15,Company Administration,3,10870,117,2021-10-05 18:00:04,2021-10-05 19:02:45.853312
6379,104343,1,104343,35,10870,35,26,1,26,Direct Questions,3,10870,117,2021-10-05 18:00:04,2021-10-05 19:02:45.853312
6380,104420,4,104420,110,10885,110,11,1,11,Compensation and Benefits,3,10885,107,2021-10-07 18:00:01,2021-10-07 18:48:59.023333
6381,104421,3,104421,41,10885,41,12,1,12,Relationship with Co-Workers,3,10885,107,2021-10-07 18:00:01,2021-10-07 18:48:59.023333
6382,104422,5,104422,117,10885,117,13,1,13,General Satisfaction,3,10885,107,2021-10-07 18:00:01,2021-10-07 18:48:59.023333
6383,104423,4,104423,122,10885,122,14,1,14,Relationship with Supervisor,3,10885,107,2021-10-07 18:00:01,2021-10-07 18:48:59.023333
6384,104424,6,104424,51,10885,51,15,1,15,Company Administration,3,10885,107,2021-10-07 18:00:01,2021-10-07 18:48:59.023333
6385,104425,6,104425,36,10885,36,26,1,26,Direct Questions,3,10885,107,2021-10-07 18:00:01,2021-10-07 18:48:59.023333
6386,104450,4,104450,110,10890,110,11,1,11,Compensation and Benefits,3,10890,113,2021-10-07 18:00:03,2021-10-08 05:55:22.938698
6387,104451,3,104451,43,10890,43,12,1,12,Relationship with Co-Workers,3,10890,113,2021-10-07 18:00:03,2021-10-08 05:55:22.938698
6388,104452,3,104452,47,10890,47,13,1,13,General Satisfaction,3,10890,113,2021-10-07 18:00:03,2021-10-08 05:55:22.938698
6389,104453,6,104453,123,10890,123,14,1,14,Relationship with Supervisor,3,10890,113,2021-10-07 18:00:03,2021-10-08 05:55:22.938698
6390,104454,4,104454,44,10890,44,15,1,15,Company Administration,3,10890,113,2021-10-07 18:00:03,2021-10-08 05:55:22.938698
6391,104455,4,104455,36,10890,36,26,1,26,Direct Questions,3,10890,113,2021-10-07 18:00:03,2021-10-08 05:55:22.938698
6392,104462,4,104462,110,10892,110,11,1,11,Compensation and Benefits,3,10892,115,2021-10-07 18:00:03,2021-10-07 18:07:08.163967
6393,104463,4,104463,111,10892,111,12,1,12,Relationship with Co-Workers,3,10892,115,2021-10-07 18:00:03,2021-10-07 18:07:08.163967
6394,104464,4,104464,45,10892,45,13,1,13,General Satisfaction,3,10892,115,2021-10-07 18:00:03,2021-10-07 18:07:08.163967
6395,104465,4,104465,120,10892,120,14,1,14,Relationship with Supervisor,3,10892,115,2021-10-07 18:00:03,2021-10-07 18:07:08.163967
6396,104466,4,104466,56,10892,56,15,1,15,Company Administration,3,10892,115,2021-10-07 18:00:03,2021-10-07 18:07:08.163967
6397,104467,5,104467,36,10892,36,26,1,26,Direct Questions,3,10892,115,2021-10-07 18:00:03,2021-10-07 18:07:08.163967
6398,104474,5,104474,110,10894,110,11,1,11,Compensation and Benefits,3,10894,117,2021-10-07 18:00:04,2021-10-08 01:02:15.772485
6399,104475,4,104475,111,10894,111,12,1,12,Relationship with Co-Workers,3,10894,117,2021-10-07 18:00:04,2021-10-08 01:02:15.772485
6400,104476,4,104476,48,10894,48,13,1,13,General Satisfaction,3,10894,117,2021-10-07 18:00:04,2021-10-08 01:02:15.772485
6401,104477,3,104477,121,10894,121,14,1,14,Relationship with Supervisor,3,10894,117,2021-10-07 18:00:04,2021-10-08 01:02:15.772485
6402,104478,4,104478,116,10894,116,15,1,15,Company Administration,3,10894,117,2021-10-07 18:00:04,2021-10-08 01:02:15.772485
6403,104479,1,104479,35,10894,35,26,1,26,Direct Questions,3,10894,117,2021-10-07 18:00:04,2021-10-08 01:02:15.772485
6404,104480,4,104480,110,10895,110,11,1,11,Compensation and Benefits,3,10895,118,2021-10-07 18:00:04,2021-10-07 18:35:23.008164
6405,104481,4,104481,112,10895,112,12,1,12,Relationship with Co-Workers,3,10895,118,2021-10-07 18:00:04,2021-10-07 18:35:23.008164
6406,104482,4,104482,48,10895,48,13,1,13,General Satisfaction,3,10895,118,2021-10-07 18:00:04,2021-10-07 18:35:23.008164
6407,104483,3,104483,120,10895,120,14,1,14,Relationship with Supervisor,3,10895,118,2021-10-07 18:00:04,2021-10-07 18:35:23.008164
6408,104484,4,104484,115,10895,115,15,1,15,Company Administration,3,10895,118,2021-10-07 18:00:04,2021-10-07 18:35:23.008164
6409,104485,6,104485,34,10895,34,26,1,26,Direct Questions,3,10895,118,2021-10-07 18:00:04,2021-10-07 18:35:23.008164
6410,104486,6,104486,110,10896,110,11,1,11,Compensation and Benefits,3,10896,156,2021-10-07 18:00:04,2021-10-07 20:38:57.084326
6411,104487,6,104487,41,10896,41,12,1,12,Relationship with Co-Workers,3,10896,156,2021-10-07 18:00:04,2021-10-07 20:38:57.084326
6412,104488,6,104488,117,10896,117,13,1,13,General Satisfaction,3,10896,156,2021-10-07 18:00:04,2021-10-07 20:38:57.084326
6413,104489,6,104489,53,10896,53,14,1,14,Relationship with Supervisor,3,10896,156,2021-10-07 18:00:04,2021-10-07 20:38:57.084326
6414,104490,5,104490,55,10896,55,15,1,15,Company Administration,3,10896,156,2021-10-07 18:00:04,2021-10-07 20:38:57.084326
6415,104491,6,104491,35,10896,35,26,1,26,Direct Questions,3,10896,156,2021-10-07 18:00:04,2021-10-07 20:38:57.084326
6416,104504,5,104504,110,10899,110,11,1,11,Compensation and Benefits,3,10899,159,2021-10-07 18:00:05,2021-10-07 18:36:59.741179
6417,104505,5,104505,40,10899,40,12,1,12,Relationship with Co-Workers,3,10899,159,2021-10-07 18:00:05,2021-10-07 18:36:59.741179
6418,104506,5,104506,49,10899,49,13,1,13,General Satisfaction,3,10899,159,2021-10-07 18:00:05,2021-10-07 18:36:59.741179
6419,104507,4,104507,120,10899,120,14,1,14,Relationship with Supervisor,3,10899,159,2021-10-07 18:00:05,2021-10-07 18:36:59.741179
6420,104508,4,104508,56,10899,56,15,1,15,Company Administration,3,10899,159,2021-10-07 18:00:05,2021-10-07 18:36:59.741179
6421,104509,4,104509,34,10899,34,26,1,26,Direct Questions,3,10899,159,2021-10-07 18:00:05,2021-10-07 18:36:59.741179
6422,4897,3,4897,43,1165,43,12,1,12,Relationship with Co-Workers,3,1165,111,2021-04-22 18:00:03,2021-04-22 18:36:21.702488
6423,4898,4,4898,45,1165,45,13,1,13,General Satisfaction,3,1165,111,2021-04-22 18:00:03,2021-04-22 18:36:21.702488
6424,4900,2,4900,58,1165,58,15,1,15,Company Administration,3,1165,111,2021-04-22 18:00:03,2021-04-22 18:36:21.702488
6425,4899,3,4899,52,1165,52,15,1,15,Company Administration,3,1165,111,2021-04-22 18:00:03,2021-04-22 18:36:21.702488
6426,4896,4,4896,36,1165,36,26,1,26,Direct Questions,3,1165,111,2021-04-22 18:00:03,2021-04-22 18:36:21.702488
6427,20017,2,20017,43,2003,43,12,1,12,Relationship with Co-Workers,3,2003,109,2021-04-27 18:00:03,2021-04-27 18:38:10.857140
6428,20018,5,20018,47,2003,47,13,1,13,General Satisfaction,3,2003,109,2021-04-27 18:00:03,2021-04-27 18:38:10.857140
6429,20019,5,20019,53,2003,53,14,1,14,Relationship with Supervisor,3,2003,109,2021-04-27 18:00:03,2021-04-27 18:38:10.857140
6430,20020,5,20020,57,2003,57,15,1,15,Company Administration,3,2003,109,2021-04-27 18:00:03,2021-04-27 18:38:10.857140
6431,20016,2,20016,34,2003,34,26,1,26,Direct Questions,3,2003,109,2021-04-27 18:00:03,2021-04-27 18:38:10.857140
6432,20042,2,20042,43,2008,43,12,1,12,Relationship with Co-Workers,3,2008,114,2021-04-27 18:00:04,2021-04-27 18:39:39.685905
6433,20043,5,20043,48,2008,48,13,1,13,General Satisfaction,3,2008,114,2021-04-27 18:00:04,2021-04-27 18:39:39.685905
6434,20045,3,20045,56,2008,56,15,1,15,Company Administration,3,2008,114,2021-04-27 18:00:04,2021-04-27 18:39:39.685905
6435,20044,4,20044,51,2008,51,15,1,15,Company Administration,3,2008,114,2021-04-27 18:00:04,2021-04-27 18:39:39.685905
6436,20041,4,20041,35,2008,35,26,1,26,Direct Questions,3,2008,114,2021-04-27 18:00:04,2021-04-27 18:39:39.685905
6437,20941,2,20941,43,2186,43,12,1,12,Relationship with Co-Workers,3,2186,110,2021-04-29 18:00:03,2021-04-29 18:11:14.811337
6438,20943,2,20943,53,2186,53,14,1,14,Relationship with Supervisor,3,2186,110,2021-04-29 18:00:03,2021-04-29 18:11:14.811337
6439,20944,5,20944,57,2186,57,15,1,15,Company Administration,3,2186,110,2021-04-29 18:00:03,2021-04-29 18:11:14.811337
6440,20942,3,20942,44,2186,44,15,1,15,Company Administration,3,2186,110,2021-04-29 18:00:03,2021-04-29 18:11:14.811337
6441,20940,5,20940,34,2186,34,26,1,26,Direct Questions,3,2186,110,2021-04-29 18:00:03,2021-04-29 18:11:14.811337
6442,20976,3,20976,43,2193,43,12,1,12,Relationship with Co-Workers,3,2193,117,2021-04-29 18:00:04,2021-04-29 18:08:26.705676
6443,20977,5,20977,45,2193,45,13,1,13,General Satisfaction,3,2193,117,2021-04-29 18:00:04,2021-04-29 18:08:26.705676
6444,20979,4,20979,56,2193,56,15,1,15,Company Administration,3,2193,117,2021-04-29 18:00:04,2021-04-29 18:08:26.705676
6445,20978,2,20978,52,2193,52,15,1,15,Company Administration,3,2193,117,2021-04-29 18:00:04,2021-04-29 18:08:26.705676
6446,20975,5,20975,36,2193,36,26,1,26,Direct Questions,3,2193,117,2021-04-29 18:00:04,2021-04-29 18:08:26.705676
6447,21011,5,21011,43,2200,43,12,1,12,Relationship with Co-Workers,3,2200,112,2021-05-04 18:00:04,2021-05-04 23:30:48.049688
6448,21012,3,21012,46,2200,46,13,1,13,General Satisfaction,3,2200,112,2021-05-04 18:00:04,2021-05-04 23:30:48.049688
6449,21013,4,21013,50,2200,50,14,1,14,Relationship with Supervisor,3,2200,112,2021-05-04 18:00:04,2021-05-04 23:30:48.049688
6450,21014,4,21014,58,2200,58,15,1,15,Company Administration,3,2200,112,2021-05-04 18:00:04,2021-05-04 23:30:48.049688
6451,21010,3,21010,34,2200,34,26,1,26,Direct Questions,3,2200,112,2021-05-04 18:00:04,2021-05-04 23:30:48.049688
6452,21026,3,21026,43,2203,43,12,1,12,Relationship with Co-Workers,3,2203,115,2021-05-04 18:00:05,2021-05-04 18:04:55.172248
6453,21027,4,21027,49,2203,49,13,1,13,General Satisfaction,3,2203,115,2021-05-04 18:00:05,2021-05-04 18:04:55.172248
6454,21028,5,21028,50,2203,50,14,1,14,Relationship with Supervisor,3,2203,115,2021-05-04 18:00:05,2021-05-04 18:04:55.172248
6455,21029,3,21029,56,2203,56,15,1,15,Company Administration,3,2203,115,2021-05-04 18:00:05,2021-05-04 18:04:55.172248
6456,21025,4,21025,34,2203,34,26,1,26,Direct Questions,3,2203,115,2021-05-04 18:00:05,2021-05-04 18:04:55.172248
6457,21935,4,21935,43,2383,43,12,1,12,Relationship with Co-Workers,3,2383,114,2021-05-06 18:00:04,2021-05-06 18:35:43.592406
6458,21936,2,21936,48,2383,48,13,1,13,General Satisfaction,3,2383,114,2021-05-06 18:00:04,2021-05-06 18:35:43.592406
6459,21938,2,21938,57,2383,57,15,1,15,Company Administration,3,2383,114,2021-05-06 18:00:04,2021-05-06 18:35:43.592406
6460,21937,2,21937,52,2383,52,15,1,15,Company Administration,3,2383,114,2021-05-06 18:00:04,2021-05-06 18:35:43.592406
6461,21934,3,21934,36,2383,36,26,1,26,Direct Questions,3,2383,114,2021-05-06 18:00:04,2021-05-06 18:35:43.592406
6462,22000,3,22000,43,2396,43,12,1,12,Relationship with Co-Workers,3,2396,115,2021-05-11 18:00:06,2021-05-11 18:06:26.523677
6463,22001,4,22001,49,2396,49,13,1,13,General Satisfaction,3,2396,115,2021-05-11 18:00:06,2021-05-11 18:06:26.523677
6464,22003,3,22003,55,2396,55,15,1,15,Company Administration,3,2396,115,2021-05-11 18:00:06,2021-05-11 18:06:26.523677
6465,22002,2,22002,52,2396,52,15,1,15,Company Administration,3,2396,115,2021-05-11 18:00:06,2021-05-11 18:06:26.523677
6466,21999,4,21999,34,2396,34,26,1,26,Direct Questions,3,2396,115,2021-05-11 18:00:06,2021-05-11 18:06:26.523677
6467,22184,3,22184,43,2431,43,12,1,12,Relationship with Co-Workers,3,2431,109,2021-05-18 18:00:03,2021-05-18 18:31:51.526599
6468,22185,4,22185,45,2431,45,13,1,13,General Satisfaction,3,2431,109,2021-05-18 18:00:03,2021-05-18 18:31:51.526599
6469,22186,3,22186,53,2431,53,14,1,14,Relationship with Supervisor,3,2431,109,2021-05-18 18:00:03,2021-05-18 18:31:51.526599
6470,22187,4,22187,58,2431,58,15,1,15,Company Administration,3,2431,109,2021-05-18 18:00:03,2021-05-18 18:31:51.526599
6471,22183,4,22183,36,2431,36,26,1,26,Direct Questions,3,2431,109,2021-05-18 18:00:03,2021-05-18 18:31:51.526599
6472,22333,3,22333,43,2459,43,12,1,12,Relationship with Co-Workers,3,2459,108,2021-05-20 18:00:02,2021-05-20 18:01:58.807313
6473,22334,5,22334,48,2459,48,13,1,13,General Satisfaction,3,2459,108,2021-05-20 18:00:02,2021-05-20 18:01:58.807313
6474,22336,4,22336,57,2459,57,15,1,15,Company Administration,3,2459,108,2021-05-20 18:00:02,2021-05-20 18:01:58.807313
6475,22335,4,22335,51,2459,51,15,1,15,Company Administration,3,2459,108,2021-05-20 18:00:02,2021-05-20 18:01:58.807313
6476,22332,4,22332,35,2459,35,26,1,26,Direct Questions,3,2459,108,2021-05-20 18:00:02,2021-05-20 18:01:58.807313
6477,22338,3,22338,43,2460,43,12,1,12,Relationship with Co-Workers,3,2460,109,2021-05-20 18:00:02,2021-05-20 18:43:53.803925
6478,22339,4,22339,48,2460,48,13,1,13,General Satisfaction,3,2460,109,2021-05-20 18:00:02,2021-05-20 18:43:53.803925
6479,22341,3,22341,58,2460,58,15,1,15,Company Administration,3,2460,109,2021-05-20 18:00:02,2021-05-20 18:43:53.803925
6480,22340,3,22340,51,2460,51,15,1,15,Company Administration,3,2460,109,2021-05-20 18:00:02,2021-05-20 18:43:53.803925
6481,22337,3,22337,34,2460,34,26,1,26,Direct Questions,3,2460,109,2021-05-20 18:00:02,2021-05-20 18:43:53.803925
6482,22378,3,22378,43,2468,43,12,1,12,Relationship with Co-Workers,3,2468,117,2021-05-20 18:00:03,2021-05-20 18:00:53.809679
6483,22379,5,22379,47,2468,47,13,1,13,General Satisfaction,3,2468,117,2021-05-20 18:00:03,2021-05-20 18:00:53.809679
6484,22380,5,22380,50,2468,50,14,1,14,Relationship with Supervisor,3,2468,117,2021-05-20 18:00:03,2021-05-20 18:00:53.809679
6485,22381,1,22381,55,2468,55,15,1,15,Company Administration,3,2468,117,2021-05-20 18:00:03,2021-05-20 18:00:53.809679
6486,22377,5,22377,36,2468,36,26,1,26,Direct Questions,3,2468,117,2021-05-20 18:00:03,2021-05-20 18:00:53.809679
6487,22428,3,22428,43,2478,43,12,1,12,Relationship with Co-Workers,3,2478,115,2021-05-25 18:00:03,2021-05-25 18:00:52.490923
6488,22429,4,22429,47,2478,47,13,1,13,General Satisfaction,3,2478,115,2021-05-25 18:00:03,2021-05-25 18:00:52.490923
6489,22430,4,22430,53,2478,53,14,1,14,Relationship with Supervisor,3,2478,115,2021-05-25 18:00:03,2021-05-25 18:00:52.490923
6490,22431,4,22431,57,2478,57,15,1,15,Company Administration,3,2478,115,2021-05-25 18:00:03,2021-05-25 18:00:52.490923
6491,22427,4,22427,36,2478,36,26,1,26,Direct Questions,3,2478,115,2021-05-25 18:00:03,2021-05-25 18:00:52.490923
6492,22592,2,22592,43,2509,43,12,1,12,Relationship with Co-Workers,3,2509,117,2021-05-27 18:00:04,2021-05-27 18:24:33.544350
6493,22593,4,22593,46,2509,46,13,1,13,General Satisfaction,3,2509,117,2021-05-27 18:00:04,2021-05-27 18:24:33.544350
6494,22594,5,22594,50,2509,50,14,1,14,Relationship with Supervisor,3,2509,117,2021-05-27 18:00:04,2021-05-27 18:24:33.544350
6495,22595,5,22595,58,2509,58,15,1,15,Company Administration,3,2509,117,2021-05-27 18:00:04,2021-05-27 18:24:33.544350
6496,22591,5,22591,36,2509,36,26,1,26,Direct Questions,3,2509,117,2021-05-27 18:00:04,2021-05-27 18:24:33.544350
6497,100055,2,100055,43,10011,43,12,1,12,Relationship with Co-Workers,3,10011,117,2021-06-01 18:00:03,2021-06-02 04:36:01.987428
6498,100056,4,100056,48,10011,48,13,1,13,General Satisfaction,3,10011,117,2021-06-01 18:00:03,2021-06-02 04:36:01.987428
6499,100058,5,100058,58,10011,58,15,1,15,Company Administration,3,10011,117,2021-06-01 18:00:03,2021-06-02 04:36:01.987428
6500,100057,5,100057,51,10011,51,15,1,15,Company Administration,3,10011,117,2021-06-01 18:00:03,2021-06-02 04:36:01.987428
6501,100054,5,100054,35,10011,35,26,1,26,Direct Questions,3,10011,117,2021-06-01 18:00:03,2021-06-02 04:36:01.987428
6502,100213,5,100213,43,10039,43,12,1,12,Relationship with Co-Workers,3,10039,109,2021-06-03 18:00:02,2021-06-03 18:37:07.380850
6503,100214,1,100214,46,10039,46,13,1,13,General Satisfaction,3,10039,109,2021-06-03 18:00:02,2021-06-03 18:37:07.380850
6504,100215,4,100215,54,10039,54,14,1,14,Relationship with Supervisor,3,10039,109,2021-06-03 18:00:02,2021-06-03 18:37:07.380850
6505,100216,2,100216,57,10039,57,15,1,15,Company Administration,3,10039,109,2021-06-03 18:00:02,2021-06-03 18:37:07.380850
6506,100212,4,100212,36,10039,36,26,1,26,Direct Questions,3,10039,109,2021-06-03 18:00:02,2021-06-03 18:37:07.380850
6507,100248,3,100248,43,10046,43,12,1,12,Relationship with Co-Workers,3,10046,116,2021-06-03 18:00:04,2021-06-03 18:00:53.534799
6508,100249,4,100249,45,10046,45,13,1,13,General Satisfaction,3,10046,116,2021-06-03 18:00:04,2021-06-03 18:00:53.534799
6509,100251,4,100251,57,10046,57,15,1,15,Company Administration,3,10046,116,2021-06-03 18:00:04,2021-06-03 18:00:53.534799
6510,100250,3,100250,52,10046,52,15,1,15,Company Administration,3,10046,116,2021-06-03 18:00:04,2021-06-03 18:00:53.534799
6511,100247,3,100247,35,10046,35,26,1,26,Direct Questions,3,10046,116,2021-06-03 18:00:04,2021-06-03 18:00:53.534799
6512,100645,3,100645,43,10133,43,12,1,12,Relationship with Co-Workers,3,10133,115,2021-06-10 18:00:03,2021-06-10 18:01:57.447405
6513,100646,4,100646,45,10133,45,13,1,13,General Satisfaction,3,10133,115,2021-06-10 18:00:03,2021-06-10 18:01:57.447405
6514,100648,3,100648,55,10133,55,15,1,15,Company Administration,3,10133,115,2021-06-10 18:00:03,2021-06-10 18:01:57.447405
6515,100647,4,100647,51,10133,51,15,1,15,Company Administration,3,10133,115,2021-06-10 18:00:03,2021-06-10 18:01:57.447405
6516,100644,4,100644,34,10133,34,26,1,26,Direct Questions,3,10133,115,2021-06-10 18:00:03,2021-06-10 18:01:57.447405
6517,100695,5,100695,43,10143,43,12,1,12,Relationship with Co-Workers,3,10143,113,2021-06-15 18:00:04,2021-06-15 19:35:45.769458
6518,100696,4,100696,45,10143,45,13,1,13,General Satisfaction,3,10143,113,2021-06-15 18:00:04,2021-06-15 19:35:45.769458
6519,100697,5,100697,54,10143,54,14,1,14,Relationship with Supervisor,3,10143,113,2021-06-15 18:00:04,2021-06-15 19:35:45.769458
6520,100698,6,100698,56,10143,56,15,1,15,Company Administration,3,10143,113,2021-06-15 18:00:04,2021-06-15 19:35:45.769458
6521,100694,4,100694,36,10143,36,26,1,26,Direct Questions,3,10143,113,2021-06-15 18:00:04,2021-06-15 19:35:45.769458
6522,100949,5,100949,43,10197,43,12,1,12,Relationship with Co-Workers,3,10197,113,2021-06-17 18:00:03,2021-06-17 19:44:52.353404
6523,100950,5,100950,46,10197,46,13,1,13,General Satisfaction,3,10197,113,2021-06-17 18:00:03,2021-06-17 19:44:52.353404
6524,100952,1,100952,57,10197,57,15,1,15,Company Administration,3,10197,113,2021-06-17 18:00:03,2021-06-17 19:44:52.353404
6525,100951,2,100951,51,10197,51,15,1,15,Company Administration,3,10197,113,2021-06-17 18:00:03,2021-06-17 19:44:52.353404
6526,100948,4,100948,34,10197,34,26,1,26,Direct Questions,3,10197,113,2021-06-17 18:00:03,2021-06-17 19:44:52.353404
6527,101029,2,101029,43,10213,43,12,1,12,Relationship with Co-Workers,3,10213,117,2021-06-22 18:00:05,2021-06-22 18:33:22.466113
6528,101030,5,101030,48,10213,48,13,1,13,General Satisfaction,3,10213,117,2021-06-22 18:00:05,2021-06-22 18:33:22.466113
6529,101031,5,101031,53,10213,53,14,1,14,Relationship with Supervisor,3,10213,117,2021-06-22 18:00:05,2021-06-22 18:33:22.466113
6530,101032,5,101032,58,10213,58,15,1,15,Company Administration,3,10213,117,2021-06-22 18:00:05,2021-06-22 18:33:22.466113
6531,101028,5,101028,34,10213,34,26,1,26,Direct Questions,3,10213,117,2021-06-22 18:00:05,2021-06-22 18:33:22.466113
6532,101572,2,101572,43,10328,43,12,1,12,Relationship with Co-Workers,3,10328,112,2021-07-01 18:00:03,2021-07-01 18:04:14.485616
6533,101573,1,101573,47,10328,47,13,1,13,General Satisfaction,3,10328,112,2021-07-01 18:00:03,2021-07-01 18:04:14.485616
6534,101574,6,101574,54,10328,54,14,1,14,Relationship with Supervisor,3,10328,112,2021-07-01 18:00:03,2021-07-01 18:04:14.485616
6535,101575,6,101575,55,10328,55,15,1,15,Company Administration,3,10328,112,2021-07-01 18:00:03,2021-07-01 18:04:14.485616
6536,101571,1,101571,35,10328,35,26,1,26,Direct Questions,3,10328,112,2021-07-01 18:00:03,2021-07-01 18:04:14.485616
6537,101657,2,101657,43,10345,43,12,1,12,Relationship with Co-Workers,3,10345,117,2021-07-06 18:00:04,2021-07-06 19:11:16.992538
6538,101658,5,101658,45,10345,45,13,1,13,General Satisfaction,3,10345,117,2021-07-06 18:00:04,2021-07-06 19:11:16.992538
6539,101660,2,101660,56,10345,56,15,1,15,Company Administration,3,10345,117,2021-07-06 18:00:04,2021-07-06 19:11:16.992538
6540,101659,5,101659,51,10345,51,15,1,15,Company Administration,3,10345,117,2021-07-06 18:00:04,2021-07-06 19:11:16.992538
6541,101656,5,101656,34,10345,34,26,1,26,Direct Questions,3,10345,117,2021-07-06 18:00:04,2021-07-06 19:11:16.992538
6542,101662,2,101662,43,10346,43,12,1,12,Relationship with Co-Workers,3,10346,118,2021-07-06 18:00:05,2021-07-07 09:39:02.830700
6543,101663,4,101663,49,10346,49,13,1,13,General Satisfaction,3,10346,118,2021-07-06 18:00:05,2021-07-07 09:39:02.830700
6544,101665,2,101665,55,10346,55,15,1,15,Company Administration,3,10346,118,2021-07-06 18:00:05,2021-07-07 09:39:02.830700
6545,101664,3,101664,52,10346,52,15,1,15,Company Administration,3,10346,118,2021-07-06 18:00:05,2021-07-07 09:39:02.830700
6546,101661,4,101661,35,10346,35,26,1,26,Direct Questions,3,10346,118,2021-07-06 18:00:05,2021-07-07 09:39:02.830700
6547,101871,4,101871,43,10391,43,12,1,12,Relationship with Co-Workers,3,10391,109,2021-07-08 18:00:02,2021-07-08 18:34:01.463040
6548,101872,4,101872,47,10391,47,13,1,13,General Satisfaction,3,10391,109,2021-07-08 18:00:02,2021-07-08 18:34:01.463040
6549,101873,4,101873,50,10391,50,14,1,14,Relationship with Supervisor,3,10391,109,2021-07-08 18:00:02,2021-07-08 18:34:01.463040
6550,101874,4,101874,55,10391,55,15,1,15,Company Administration,3,10391,109,2021-07-08 18:00:02,2021-07-08 18:34:01.463040
6551,101870,3,101870,34,10391,34,26,1,26,Direct Questions,3,10391,109,2021-07-08 18:00:02,2021-07-08 18:34:01.463040
6552,4012,4,4012,42,988,42,12,1,12,Relationship with Co-Workers,3,988,2,2021-04-20 15:08:57,2021-04-20 15:10:52.035523
6553,4013,4,4013,47,988,47,13,1,13,General Satisfaction,3,988,2,2021-04-20 15:08:57,2021-04-20 15:10:52.035523
6554,4014,4,4014,50,988,50,14,1,14,Relationship with Supervisor,3,988,2,2021-04-20 15:08:57,2021-04-20 15:10:52.035523
6555,4015,4,4015,58,988,58,15,1,15,Company Administration,3,988,2,2021-04-20 15:08:57,2021-04-20 15:10:52.035523
6556,4011,4,4011,34,988,34,26,1,26,Direct Questions,3,988,2,2021-04-20 15:08:57,2021-04-20 15:10:52.035523
6557,4907,6,4907,42,1167,42,12,1,12,Relationship with Co-Workers,3,1167,113,2021-04-22 18:00:03,2021-04-22 18:02:34.203671
6558,4908,5,4908,48,1167,48,13,1,13,General Satisfaction,3,1167,113,2021-04-22 18:00:03,2021-04-22 18:02:34.203671
6559,4909,4,4909,54,1167,54,14,1,14,Relationship with Supervisor,3,1167,113,2021-04-22 18:00:03,2021-04-22 18:02:34.203671
6560,4910,6,4910,56,1167,56,15,1,15,Company Administration,3,1167,113,2021-04-22 18:00:03,2021-04-22 18:02:34.203671
6561,4906,5,4906,36,1167,36,26,1,26,Direct Questions,3,1167,113,2021-04-22 18:00:03,2021-04-22 18:02:34.203671
6562,4932,4,4932,42,1172,42,12,1,12,Relationship with Co-Workers,3,1172,118,2021-04-22 18:00:04,2021-04-22 18:43:57.138758
6563,4934,5,4934,53,1172,53,14,1,14,Relationship with Supervisor,3,1172,118,2021-04-22 18:00:04,2021-04-22 18:43:57.138758
6564,4935,3,4935,56,1172,56,15,1,15,Company Administration,3,1172,118,2021-04-22 18:00:04,2021-04-22 18:43:57.138758
6565,4933,4,4933,44,1172,44,15,1,15,Company Administration,3,1172,118,2021-04-22 18:00:04,2021-04-22 18:43:57.138758
6566,4931,6,4931,34,1172,34,26,1,26,Direct Questions,3,1172,118,2021-04-22 18:00:04,2021-04-22 18:43:57.138758
6567,20971,3,20971,42,2192,42,12,1,12,Relationship with Co-Workers,3,2192,116,2021-04-29 18:00:04,2021-04-29 18:29:37.364522
6568,20972,5,20972,49,2192,49,13,1,13,General Satisfaction,3,2192,116,2021-04-29 18:00:04,2021-04-29 18:29:37.364522
6569,20973,3,20973,54,2192,54,14,1,14,Relationship with Supervisor,3,2192,116,2021-04-29 18:00:04,2021-04-29 18:29:37.364522
6570,20974,3,20974,57,2192,57,15,1,15,Company Administration,3,2192,116,2021-04-29 18:00:04,2021-04-29 18:29:37.364522
6571,20970,3,20970,34,2192,34,26,1,26,Direct Questions,3,2192,116,2021-04-29 18:00:04,2021-04-29 18:29:37.364522
6572,22005,2,22005,42,2397,42,12,1,12,Relationship with Co-Workers,3,2397,116,2021-05-11 18:00:06,2021-05-11 21:28:42.860511
6573,22006,4,22006,45,2397,45,13,1,13,General Satisfaction,3,2397,116,2021-05-11 18:00:06,2021-05-11 21:28:42.860511
6574,22008,3,22008,58,2397,58,15,1,15,Company Administration,3,2397,116,2021-05-11 18:00:06,2021-05-11 21:28:42.860511
6575,22007,4,22007,52,2397,52,15,1,15,Company Administration,3,2397,116,2021-05-11 18:00:06,2021-05-11 21:28:42.860511
6576,22004,3,22004,36,2397,36,26,1,26,Direct Questions,3,2397,116,2021-05-11 18:00:06,2021-05-11 21:28:42.860511
6577,22169,4,22169,42,2428,42,12,1,12,Relationship with Co-Workers,3,2428,118,2021-05-13 18:00:03,2021-05-13 18:15:08.669437
6578,22170,5,22170,47,2428,47,13,1,13,General Satisfaction,3,2428,118,2021-05-13 18:00:03,2021-05-13 18:15:08.669437
6579,22172,3,22172,57,2428,57,15,1,15,Company Administration,3,2428,118,2021-05-13 18:00:03,2021-05-13 18:15:08.669437
6580,22171,4,22171,51,2428,51,15,1,15,Company Administration,3,2428,118,2021-05-13 18:00:03,2021-05-13 18:15:08.669437
6581,22168,5,22168,36,2428,36,26,1,26,Direct Questions,3,2428,118,2021-05-13 18:00:03,2021-05-13 18:15:08.669437
6582,22174,3,22174,42,2429,42,12,1,12,Relationship with Co-Workers,3,2429,107,2021-05-18 18:00:02,2021-05-18 18:05:21.042136
6583,22175,4,22175,45,2429,45,13,1,13,General Satisfaction,3,2429,107,2021-05-18 18:00:02,2021-05-18 18:05:21.042136
6584,22177,4,22177,57,2429,57,15,1,15,Company Administration,3,2429,107,2021-05-18 18:00:02,2021-05-18 18:05:21.042136
6585,22176,3,22176,51,2429,51,15,1,15,Company Administration,3,2429,107,2021-05-18 18:00:02,2021-05-18 18:05:21.042136
6586,22173,4,22173,35,2429,35,26,1,26,Direct Questions,3,2429,107,2021-05-18 18:00:02,2021-05-18 18:05:21.042136
6587,22179,3,22179,42,2430,42,12,1,12,Relationship with Co-Workers,3,2430,108,2021-05-18 18:00:02,2021-05-18 18:00:58.166041
6588,22180,4,22180,46,2430,46,13,1,13,General Satisfaction,3,2430,108,2021-05-18 18:00:02,2021-05-18 18:00:58.166041
6589,22181,3,22181,54,2430,54,14,1,14,Relationship with Supervisor,3,2430,108,2021-05-18 18:00:02,2021-05-18 18:00:58.166041
6590,22182,4,22182,58,2430,58,15,1,15,Company Administration,3,2430,108,2021-05-18 18:00:02,2021-05-18 18:00:58.166041
6591,22178,4,22178,36,2430,36,26,1,26,Direct Questions,3,2430,108,2021-05-18 18:00:02,2021-05-18 18:00:58.166041
6592,22189,6,22189,42,2432,42,12,1,12,Relationship with Co-Workers,3,2432,110,2021-05-18 18:00:04,2021-05-18 18:32:06.653455
6593,22190,2,22190,45,2432,45,13,1,13,General Satisfaction,3,2432,110,2021-05-18 18:00:04,2021-05-18 18:32:06.653455
6594,22192,3,22192,58,2432,58,15,1,15,Company Administration,3,2432,110,2021-05-18 18:00:04,2021-05-18 18:32:06.653455
6595,22191,5,22191,52,2432,52,15,1,15,Company Administration,3,2432,110,2021-05-18 18:00:04,2021-05-18 18:32:06.653455
6596,22188,3,22188,34,2432,34,26,1,26,Direct Questions,3,2432,110,2021-05-18 18:00:04,2021-05-18 18:32:06.653455
6597,22214,3,22214,42,2437,42,12,1,12,Relationship with Co-Workers,3,2437,115,2021-05-18 18:00:05,2021-05-18 18:05:54.649006
6598,22215,4,22215,47,2437,47,13,1,13,General Satisfaction,3,2437,115,2021-05-18 18:00:05,2021-05-18 18:05:54.649006
6599,22216,4,22216,50,2437,50,14,1,14,Relationship with Supervisor,3,2437,115,2021-05-18 18:00:05,2021-05-18 18:05:54.649006
6600,22217,3,22217,55,2437,55,15,1,15,Company Administration,3,2437,115,2021-05-18 18:00:05,2021-05-18 18:05:54.649006
6601,22213,4,22213,34,2437,34,26,1,26,Direct Questions,3,2437,115,2021-05-18 18:00:05,2021-05-18 18:05:54.649006
6602,22224,3,22224,42,2439,42,12,1,12,Relationship with Co-Workers,3,2439,117,2021-05-18 18:00:05,2021-05-18 18:32:27.752780
6603,22225,5,22225,47,2439,47,13,1,13,General Satisfaction,3,2439,117,2021-05-18 18:00:05,2021-05-18 18:32:27.752780
6604,22226,5,22226,50,2439,50,14,1,14,Relationship with Supervisor,3,2439,117,2021-05-18 18:00:05,2021-05-18 18:32:27.752780
6605,22227,5,22227,58,2439,58,15,1,15,Company Administration,3,2439,117,2021-05-18 18:00:05,2021-05-18 18:32:27.752780
6606,22223,5,22223,34,2439,34,26,1,26,Direct Questions,3,2439,117,2021-05-18 18:00:05,2021-05-18 18:32:27.752780
6607,22358,1,22358,42,2464,42,12,1,12,Relationship with Co-Workers,3,2464,113,2021-05-20 18:00:03,2021-05-20 18:01:36.898402
6608,22359,4,22359,45,2464,45,13,1,13,General Satisfaction,3,2464,113,2021-05-20 18:00:03,2021-05-20 18:01:36.898402
6609,22360,4,22360,54,2464,54,14,1,14,Relationship with Supervisor,3,2464,113,2021-05-20 18:00:03,2021-05-20 18:01:36.898402
6610,22361,3,22361,58,2464,58,15,1,15,Company Administration,3,2464,113,2021-05-20 18:00:03,2021-05-20 18:01:36.898402
6611,22357,3,22357,35,2464,35,26,1,26,Direct Questions,3,2464,113,2021-05-20 18:00:03,2021-05-20 18:01:36.898402
6612,22363,4,22363,42,2465,42,12,1,12,Relationship with Co-Workers,3,2465,114,2021-05-20 18:00:03,2021-05-20 18:37:07.823248
6613,22364,3,22364,46,2465,46,13,1,13,General Satisfaction,3,2465,114,2021-05-20 18:00:03,2021-05-20 18:37:07.823248
6614,22365,4,22365,54,2465,54,14,1,14,Relationship with Supervisor,3,2465,114,2021-05-20 18:00:03,2021-05-20 18:37:07.823248
6615,22366,5,22366,56,2465,56,15,1,15,Company Administration,3,2465,114,2021-05-20 18:00:03,2021-05-20 18:37:07.823248
6616,22362,2,22362,35,2465,35,26,1,26,Direct Questions,3,2465,114,2021-05-20 18:00:03,2021-05-20 18:37:07.823248
6617,22403,6,22403,42,2473,42,12,1,12,Relationship with Co-Workers,3,2473,110,2021-05-25 18:00:02,2021-05-26 14:10:51.528304
6618,22404,5,22404,49,2473,49,13,1,13,General Satisfaction,3,2473,110,2021-05-25 18:00:02,2021-05-26 14:10:51.528304
6619,22406,4,22406,57,2473,57,15,1,15,Company Administration,3,2473,110,2021-05-25 18:00:02,2021-05-26 14:10:51.528304
6620,22405,1,22405,51,2473,51,15,1,15,Company Administration,3,2473,110,2021-05-25 18:00:02,2021-05-26 14:10:51.528304
6621,22402,3,22402,35,2473,35,26,1,26,Direct Questions,3,2473,110,2021-05-25 18:00:02,2021-05-26 14:10:51.528304
6622,22423,5,22423,42,2477,42,12,1,12,Relationship with Co-Workers,3,2477,114,2021-05-25 18:00:03,2021-05-25 18:33:52.221036
6623,22424,4,22424,45,2477,45,13,1,13,General Satisfaction,3,2477,114,2021-05-25 18:00:03,2021-05-25 18:33:52.221036
6624,22425,4,22425,50,2477,50,14,1,14,Relationship with Supervisor,3,2477,114,2021-05-25 18:00:03,2021-05-25 18:33:52.221036
6625,22426,5,22426,56,2477,56,15,1,15,Company Administration,3,2477,114,2021-05-25 18:00:03,2021-05-25 18:33:52.221036
6626,22422,4,22422,35,2477,35,26,1,26,Direct Questions,3,2477,114,2021-05-25 18:00:03,2021-05-25 18:33:52.221036
6627,22547,3,22547,42,2500,42,12,1,12,Relationship with Co-Workers,3,2500,108,2021-05-27 18:00:02,2021-05-27 18:25:10.775209
6628,22548,4,22548,46,2500,46,13,1,13,General Satisfaction,3,2500,108,2021-05-27 18:00:02,2021-05-27 18:25:10.775209
6629,22550,2,22550,55,2500,55,15,1,15,Company Administration,3,2500,108,2021-05-27 18:00:02,2021-05-27 18:25:10.775209
6630,22549,5,22549,51,2500,51,15,1,15,Company Administration,3,2500,108,2021-05-27 18:00:02,2021-05-27 18:25:10.775209
6631,22546,5,22546,36,2500,36,26,1,26,Direct Questions,3,2500,108,2021-05-27 18:00:02,2021-05-27 18:25:10.775209
6632,22552,5,22552,42,2501,42,12,1,12,Relationship with Co-Workers,3,2501,109,2021-05-27 18:00:02,2021-05-27 18:34:07.290380
6633,22553,4,22553,45,2501,45,13,1,13,General Satisfaction,3,2501,109,2021-05-27 18:00:02,2021-05-27 18:34:07.290380
6634,22554,3,22554,54,2501,54,14,1,14,Relationship with Supervisor,3,2501,109,2021-05-27 18:00:02,2021-05-27 18:34:07.290380
6635,22555,4,22555,55,2501,55,15,1,15,Company Administration,3,2501,109,2021-05-27 18:00:02,2021-05-27 18:34:07.290380
6636,22551,4,22551,36,2501,36,26,1,26,Direct Questions,3,2501,109,2021-05-27 18:00:02,2021-05-27 18:34:07.290380
6637,22562,5,22562,42,2503,42,12,1,12,Relationship with Co-Workers,3,2503,111,2021-05-27 18:00:03,2021-05-27 18:34:04.542176
6638,22563,4,22563,47,2503,47,13,1,13,General Satisfaction,3,2503,111,2021-05-27 18:00:03,2021-05-27 18:34:04.542176
6639,22564,6,22564,50,2503,50,14,1,14,Relationship with Supervisor,3,2503,111,2021-05-27 18:00:03,2021-05-27 18:34:04.542176
6640,22565,3,22565,58,2503,58,15,1,15,Company Administration,3,2503,111,2021-05-27 18:00:03,2021-05-27 18:34:04.542176
6641,22561,5,22561,34,2503,34,26,1,26,Direct Questions,3,2503,111,2021-05-27 18:00:03,2021-05-27 18:34:04.542176
6642,22587,3,22587,42,2508,42,12,1,12,Relationship with Co-Workers,3,2508,116,2021-05-27 18:00:03,2021-05-27 18:40:48.012858
6643,22588,4,22588,45,2508,45,13,1,13,General Satisfaction,3,2508,116,2021-05-27 18:00:03,2021-05-27 18:40:48.012858
6644,22589,4,22589,54,2508,54,14,1,14,Relationship with Supervisor,3,2508,116,2021-05-27 18:00:03,2021-05-27 18:40:48.012858
6645,22590,4,22590,55,2508,55,15,1,15,Company Administration,3,2508,116,2021-05-27 18:00:03,2021-05-27 18:40:48.012858
6646,22586,3,22586,34,2508,34,26,1,26,Direct Questions,3,2508,116,2021-05-27 18:00:03,2021-05-27 18:40:48.012858
6647,100005,4,100005,42,10001,42,12,1,12,Relationship with Co-Workers,3,10001,107,2021-06-01 18:00:01,2021-06-01 18:02:07.765212
6648,100006,3,100006,46,10001,46,13,1,13,General Satisfaction,3,10001,107,2021-06-01 18:00:01,2021-06-01 18:02:07.765212
6649,100007,1,100007,50,10001,50,14,1,14,Relationship with Supervisor,3,10001,107,2021-06-01 18:00:01,2021-06-01 18:02:07.765212
6650,100008,3,100008,57,10001,57,15,1,15,Company Administration,3,10001,107,2021-06-01 18:00:01,2021-06-01 18:02:07.765212
6651,100004,3,100004,35,10001,35,26,1,26,Direct Questions,3,10001,107,2021-06-01 18:00:01,2021-06-01 18:02:07.765212
6652,100610,4,100610,42,10126,42,12,1,12,Relationship with Co-Workers,3,10126,108,2021-06-10 18:00:02,2021-06-10 18:00:40.514784
6653,100612,4,100612,53,10126,53,14,1,14,Relationship with Supervisor,3,10126,108,2021-06-10 18:00:02,2021-06-10 18:00:40.514784
6654,100613,4,100613,58,10126,58,15,1,15,Company Administration,3,10126,108,2021-06-10 18:00:02,2021-06-10 18:00:40.514784
6655,100611,3,100611,44,10126,44,15,1,15,Company Administration,3,10126,108,2021-06-10 18:00:02,2021-06-10 18:00:40.514784
6656,100609,4,100609,36,10126,36,26,1,26,Direct Questions,3,10126,108,2021-06-10 18:00:02,2021-06-10 18:00:40.514784
6657,100660,3,100660,42,10136,42,12,1,12,Relationship with Co-Workers,3,10136,118,2021-06-10 18:00:04,2021-06-10 18:41:46.788443
6658,100661,4,100661,46,10136,46,13,1,13,General Satisfaction,3,10136,118,2021-06-10 18:00:04,2021-06-10 18:41:46.788443
6659,100662,2,100662,54,10136,54,14,1,14,Relationship with Supervisor,3,10136,118,2021-06-10 18:00:04,2021-06-10 18:41:46.788443
6660,100663,2,100663,55,10136,55,15,1,15,Company Administration,3,10136,118,2021-06-10 18:00:04,2021-06-10 18:41:46.788443
6661,100659,5,100659,36,10136,36,26,1,26,Direct Questions,3,10136,118,2021-06-10 18:00:04,2021-06-10 18:41:46.788443
6662,100924,4,100924,42,10192,42,12,1,12,Relationship with Co-Workers,3,10192,108,2021-06-17 18:00:02,2021-06-17 18:00:56.079514
6663,100927,3,100927,56,10192,56,15,1,15,Company Administration,3,10192,108,2021-06-17 18:00:02,2021-06-17 18:00:56.079514
6664,100925,3,100925,44,10192,44,15,1,15,Company Administration,3,10192,108,2021-06-17 18:00:02,2021-06-17 18:00:56.079514
6665,100926,4,100926,51,10192,51,15,1,15,Company Administration,3,10192,108,2021-06-17 18:00:02,2021-06-17 18:00:56.079514
6666,100923,4,100923,35,10192,35,26,1,26,Direct Questions,3,10192,108,2021-06-17 18:00:02,2021-06-17 18:00:56.079514
6667,100984,3,100984,42,10204,42,12,1,12,Relationship with Co-Workers,3,10204,108,2021-06-22 18:00:03,2021-06-22 18:02:11.804110
6668,100985,4,100985,49,10204,49,13,1,13,General Satisfaction,3,10204,108,2021-06-22 18:00:03,2021-06-22 18:02:11.804110
6669,100986,4,100986,50,10204,50,14,1,14,Relationship with Supervisor,3,10204,108,2021-06-22 18:00:03,2021-06-22 18:02:11.804110
6670,100987,4,100987,58,10204,58,15,1,15,Company Administration,3,10204,108,2021-06-22 18:00:03,2021-06-22 18:02:11.804110
6671,100983,4,100983,34,10204,34,26,1,26,Direct Questions,3,10204,108,2021-06-22 18:00:03,2021-06-22 18:02:11.804110
6672,101014,6,101014,42,10210,42,12,1,12,Relationship with Co-Workers,3,10210,114,2021-06-22 18:00:04,2021-06-22 18:33:07.423139
6673,101015,4,101015,49,10210,49,13,1,13,General Satisfaction,3,10210,114,2021-06-22 18:00:04,2021-06-22 18:33:07.423139
6674,101016,4,101016,53,10210,53,14,1,14,Relationship with Supervisor,3,10210,114,2021-06-22 18:00:04,2021-06-22 18:33:07.423139
6675,101017,2,101017,58,10210,58,15,1,15,Company Administration,3,10210,114,2021-06-22 18:00:04,2021-06-22 18:33:07.423139
6676,101013,4,101013,34,10210,34,26,1,26,Direct Questions,3,10210,114,2021-06-22 18:00:04,2021-06-22 18:33:07.423139
6677,101034,3,101034,42,10214,42,12,1,12,Relationship with Co-Workers,3,10214,118,2021-06-22 18:00:05,2021-06-22 18:48:39.537788
6678,101035,4,101035,45,10214,45,13,1,13,General Satisfaction,3,10214,118,2021-06-22 18:00:05,2021-06-22 18:48:39.537788
6679,101036,3,101036,54,10214,54,14,1,14,Relationship with Supervisor,3,10214,118,2021-06-22 18:00:05,2021-06-22 18:48:39.537788
6680,101037,3,101037,58,10214,58,15,1,15,Company Administration,3,10214,118,2021-06-22 18:00:05,2021-06-22 18:48:39.537788
6681,101033,4,101033,34,10214,34,26,1,26,Direct Questions,3,10214,118,2021-06-22 18:00:05,2021-06-22 18:48:39.537788
6682,101233,3,101233,42,10257,42,12,1,12,Relationship with Co-Workers,3,10257,107,2021-06-24 18:00:02,2021-06-24 18:17:29.515799
6683,101236,3,101236,56,10257,56,15,1,15,Company Administration,3,10257,107,2021-06-24 18:00:02,2021-06-24 18:17:29.515799
6684,101234,4,101234,44,10257,44,15,1,15,Company Administration,3,10257,107,2021-06-24 18:00:02,2021-06-24 18:17:29.515799
6685,101235,4,101235,52,10257,52,15,1,15,Company Administration,3,10257,107,2021-06-24 18:00:02,2021-06-24 18:17:29.515799
6686,101232,4,101232,36,10257,36,26,1,26,Direct Questions,3,10257,107,2021-06-24 18:00:02,2021-06-24 18:17:29.515799
6687,101253,5,101253,42,10261,42,12,1,12,Relationship with Co-Workers,3,10261,111,2021-06-24 18:00:03,2021-06-24 18:40:46.682351
6688,101254,6,101254,49,10261,49,13,1,13,General Satisfaction,3,10261,111,2021-06-24 18:00:03,2021-06-24 18:40:46.682351
6689,101256,5,101256,56,10261,56,15,1,15,Company Administration,3,10261,111,2021-06-24 18:00:03,2021-06-24 18:40:46.682351
6690,101255,4,101255,52,10261,52,15,1,15,Company Administration,3,10261,111,2021-06-24 18:00:03,2021-06-24 18:40:46.682351
6691,101252,4,101252,36,10261,36,26,1,26,Direct Questions,3,10261,111,2021-06-24 18:00:03,2021-06-24 18:40:46.682351
6692,101293,3,101293,42,10269,42,12,1,12,Relationship with Co-Workers,3,10269,107,2021-06-29 18:00:02,2021-06-29 20:59:53.958558
6693,101294,4,101294,49,10269,49,13,1,13,General Satisfaction,3,10269,107,2021-06-29 18:00:02,2021-06-29 20:59:53.958558
6694,101295,4,101295,54,10269,54,14,1,14,Relationship with Supervisor,3,10269,107,2021-06-29 18:00:02,2021-06-29 20:59:53.958558
6695,101296,3,101296,56,10269,56,15,1,15,Company Administration,3,10269,107,2021-06-29 18:00:02,2021-06-29 20:59:53.958558
6696,101292,4,101292,36,10269,36,26,1,26,Direct Questions,3,10269,107,2021-06-29 18:00:02,2021-06-29 20:59:53.958558
6697,101303,5,101303,42,10271,42,12,1,12,Relationship with Co-Workers,3,10271,109,2021-06-29 18:00:03,2021-06-29 18:34:30.414410
6698,101304,5,101304,49,10271,49,13,1,13,General Satisfaction,3,10271,109,2021-06-29 18:00:03,2021-06-29 18:34:30.414410
6699,101305,3,101305,53,10271,53,14,1,14,Relationship with Supervisor,3,10271,109,2021-06-29 18:00:03,2021-06-29 18:34:30.414410
6700,101306,3,101306,55,10271,55,15,1,15,Company Administration,3,10271,109,2021-06-29 18:00:03,2021-06-29 18:34:30.414410
6701,101302,3,101302,36,10271,36,26,1,26,Direct Questions,3,10271,109,2021-06-29 18:00:03,2021-06-29 18:34:30.414410
6702,101333,2,101333,42,10277,42,12,1,12,Relationship with Co-Workers,3,10277,115,2021-06-29 18:00:04,2021-06-29 18:03:47.004420
6703,101334,4,101334,46,10277,46,13,1,13,General Satisfaction,3,10277,115,2021-06-29 18:00:04,2021-06-29 18:03:47.004420
6704,101336,4,101336,58,10277,58,15,1,15,Company Administration,3,10277,115,2021-06-29 18:00:04,2021-06-29 18:03:47.004420
6705,101335,4,101335,51,10277,51,15,1,15,Company Administration,3,10277,115,2021-06-29 18:00:04,2021-06-29 18:03:47.004420
6706,101332,4,101332,35,10277,35,26,1,26,Direct Questions,3,10277,115,2021-06-29 18:00:04,2021-06-29 18:03:47.004420
6707,101343,3,101343,42,10279,42,12,1,12,Relationship with Co-Workers,3,10279,117,2021-06-29 18:00:04,2021-06-29 18:37:03.460265
6708,101344,4,101344,46,10279,46,13,1,13,General Satisfaction,3,10279,117,2021-06-29 18:00:04,2021-06-29 18:37:03.460265
6709,101345,5,101345,53,10279,53,14,1,14,Relationship with Supervisor,3,10279,117,2021-06-29 18:00:04,2021-06-29 18:37:03.460265
6710,101346,5,101346,57,10279,57,15,1,15,Company Administration,3,10279,117,2021-06-29 18:00:04,2021-06-29 18:37:03.460265
6711,101342,3,101342,35,10279,35,26,1,26,Direct Questions,3,10279,117,2021-06-29 18:00:04,2021-06-29 18:37:03.460265
6712,101617,3,101617,42,10337,42,12,1,12,Relationship with Co-Workers,3,10337,109,2021-07-06 18:00:03,2021-07-06 18:00:50.254656
6713,101618,3,101618,45,10337,45,13,1,13,General Satisfaction,3,10337,109,2021-07-06 18:00:03,2021-07-06 18:00:50.254656
6714,101619,3,101619,53,10337,53,14,1,14,Relationship with Supervisor,3,10337,109,2021-07-06 18:00:03,2021-07-06 18:00:50.254656
6715,101620,3,101620,55,10337,55,15,1,15,Company Administration,3,10337,109,2021-07-06 18:00:03,2021-07-06 18:00:50.254656
6716,101616,3,101616,36,10337,36,26,1,26,Direct Questions,3,10337,109,2021-07-06 18:00:03,2021-07-06 18:00:50.254656
6717,101622,6,101622,42,10338,42,12,1,12,Relationship with Co-Workers,3,10338,110,2021-07-06 18:00:03,2021-07-06 18:22:31.544393
6718,101623,5,101623,49,10338,49,13,1,13,General Satisfaction,3,10338,110,2021-07-06 18:00:03,2021-07-06 18:22:31.544393
6719,101624,2,101624,54,10338,54,14,1,14,Relationship with Supervisor,3,10338,110,2021-07-06 18:00:03,2021-07-06 18:22:31.544393
6720,101625,2,101625,56,10338,56,15,1,15,Company Administration,3,10338,110,2021-07-06 18:00:03,2021-07-06 18:22:31.544393
6721,101621,4,101621,36,10338,36,26,1,26,Direct Questions,3,10338,110,2021-07-06 18:00:03,2021-07-06 18:22:31.544393
6722,101637,6,101637,42,10341,42,12,1,12,Relationship with Co-Workers,3,10341,113,2021-07-06 18:00:03,2021-07-06 18:40:08.682743
6723,101638,1,101638,46,10341,46,13,1,13,General Satisfaction,3,10341,113,2021-07-06 18:00:03,2021-07-06 18:40:08.682743
6724,101639,5,101639,54,10341,54,14,1,14,Relationship with Supervisor,3,10341,113,2021-07-06 18:00:03,2021-07-06 18:40:08.682743
6725,101640,5,101640,55,10341,55,15,1,15,Company Administration,3,10341,113,2021-07-06 18:00:03,2021-07-06 18:40:08.682743
6726,101636,2,101636,36,10341,36,26,1,26,Direct Questions,3,10341,113,2021-07-06 18:00:03,2021-07-06 18:40:08.682743
6727,101642,2,101642,42,10342,42,12,1,12,Relationship with Co-Workers,3,10342,114,2021-07-06 18:00:04,2021-07-06 18:46:55.958780
6728,101643,2,101643,46,10342,46,13,1,13,General Satisfaction,3,10342,114,2021-07-06 18:00:04,2021-07-06 18:46:55.958780
6729,101645,3,101645,58,10342,58,15,1,15,Company Administration,3,10342,114,2021-07-06 18:00:04,2021-07-06 18:46:55.958780
6730,101644,3,101644,51,10342,51,15,1,15,Company Administration,3,10342,114,2021-07-06 18:00:04,2021-07-06 18:46:55.958780
6731,101641,3,101641,35,10342,35,26,1,26,Direct Questions,3,10342,114,2021-07-06 18:00:04,2021-07-06 18:46:55.958780
6732,101881,4,101881,42,10393,42,12,1,12,Relationship with Co-Workers,3,10393,111,2021-07-08 18:00:02,2021-07-08 18:34:42.834133
6733,101882,4,101882,45,10393,45,13,1,13,General Satisfaction,3,10393,111,2021-07-08 18:00:02,2021-07-08 18:34:42.834133
6734,101883,4,101883,54,10393,54,14,1,14,Relationship with Supervisor,3,10393,111,2021-07-08 18:00:02,2021-07-08 18:34:42.834133
6735,101884,4,101884,58,10393,58,15,1,15,Company Administration,3,10393,111,2021-07-08 18:00:02,2021-07-08 18:34:42.834133
6736,101880,4,101880,35,10393,35,26,1,26,Direct Questions,3,10393,111,2021-07-08 18:00:02,2021-07-08 18:34:42.834133
6737,4022,6,4022,41,990,41,12,1,12,Relationship with Co-Workers,3,990,107,2021-04-20 18:00:02,2021-04-20 18:01:19.418420
6738,4023,6,4023,47,990,47,13,1,13,General Satisfaction,3,990,107,2021-04-20 18:00:02,2021-04-20 18:01:19.418420
6739,4024,3,4024,53,990,53,14,1,14,Relationship with Supervisor,3,990,107,2021-04-20 18:00:02,2021-04-20 18:01:19.418420
6740,4025,4,4025,57,990,57,15,1,15,Company Administration,3,990,107,2021-04-20 18:00:02,2021-04-20 18:01:19.418420
6741,4021,4,4021,34,990,34,26,1,26,Direct Questions,3,990,107,2021-04-20 18:00:02,2021-04-20 18:01:19.418420
6742,4062,4,4062,41,998,41,12,1,12,Relationship with Co-Workers,3,998,115,2021-04-20 18:00:04,2021-04-20 18:01:35.361312
6743,4064,6,4064,50,998,50,14,1,14,Relationship with Supervisor,3,998,115,2021-04-20 18:00:04,2021-04-20 18:01:35.361312
6744,4065,5,4065,57,998,57,15,1,15,Company Administration,3,998,115,2021-04-20 18:00:04,2021-04-20 18:01:35.361312
6745,4063,3,4063,44,998,44,15,1,15,Company Administration,3,998,115,2021-04-20 18:00:04,2021-04-20 18:01:35.361312
6746,4061,4,4061,35,998,35,26,1,26,Direct Questions,3,998,115,2021-04-20 18:00:04,2021-04-20 18:01:35.361312
6747,4877,5,4877,41,1161,41,12,1,12,Relationship with Co-Workers,3,1161,107,2021-04-22 18:00:02,2021-04-22 18:40:47.117422
6748,4878,5,4878,45,1161,45,13,1,13,General Satisfaction,3,1161,107,2021-04-22 18:00:02,2021-04-22 18:40:47.117422
6749,4879,3,4879,53,1161,53,14,1,14,Relationship with Supervisor,3,1161,107,2021-04-22 18:00:02,2021-04-22 18:40:47.117422
6750,4880,3,4880,55,1161,55,15,1,15,Company Administration,3,1161,107,2021-04-22 18:00:02,2021-04-22 18:40:47.117422
6751,4876,5,4876,36,1161,36,26,1,26,Direct Questions,3,1161,107,2021-04-22 18:00:02,2021-04-22 18:40:47.117422
6752,4892,6,4892,41,1164,41,12,1,12,Relationship with Co-Workers,3,1164,110,2021-04-22 18:00:02,2021-04-22 18:16:52.052015
6753,4893,5,4893,48,1164,48,13,1,13,General Satisfaction,3,1164,110,2021-04-22 18:00:02,2021-04-22 18:16:52.052015
6754,4894,4,4894,54,1164,54,14,1,14,Relationship with Supervisor,3,1164,110,2021-04-22 18:00:02,2021-04-22 18:16:52.052015
6755,4895,2,4895,55,1164,55,15,1,15,Company Administration,3,1164,110,2021-04-22 18:00:02,2021-04-22 18:16:52.052015
6756,4891,5,4891,35,1164,35,26,1,26,Direct Questions,3,1164,110,2021-04-22 18:00:02,2021-04-22 18:16:52.052015
6757,20032,2,20032,41,2006,41,12,1,12,Relationship with Co-Workers,3,2006,112,2021-04-27 18:00:04,2021-04-27 18:35:05.795379
6758,20033,3,20033,46,2006,46,13,1,13,General Satisfaction,3,2006,112,2021-04-27 18:00:04,2021-04-27 18:35:05.795379
6759,20034,3,20034,54,2006,54,14,1,14,Relationship with Supervisor,3,2006,112,2021-04-27 18:00:04,2021-04-27 18:35:05.795379
6760,20035,5,20035,55,2006,55,15,1,15,Company Administration,3,2006,112,2021-04-27 18:00:04,2021-04-27 18:35:05.795379
6761,20031,4,20031,36,2006,36,26,1,26,Direct Questions,3,2006,112,2021-04-27 18:00:04,2021-04-27 18:35:05.795379
6762,20047,5,20047,41,2009,41,12,1,12,Relationship with Co-Workers,3,2009,115,2021-04-27 18:00:05,2021-04-27 18:03:36.700779
6763,20048,4,20048,48,2009,48,13,1,13,General Satisfaction,3,2009,115,2021-04-27 18:00:05,2021-04-27 18:03:36.700779
6764,20049,1,20049,54,2009,54,14,1,14,Relationship with Supervisor,3,2009,115,2021-04-27 18:00:05,2021-04-27 18:03:36.700779
6765,20050,4,20050,57,2009,57,15,1,15,Company Administration,3,2009,115,2021-04-27 18:00:05,2021-04-27 18:03:36.700779
6766,20046,4,20046,35,2009,35,26,1,26,Direct Questions,3,2009,115,2021-04-27 18:00:05,2021-04-27 18:03:36.700779
6767,20966,4,20966,41,2191,41,12,1,12,Relationship with Co-Workers,3,2191,115,2021-04-29 18:00:04,2021-04-29 18:01:06.370085
6768,20967,4,20967,46,2191,46,13,1,13,General Satisfaction,3,2191,115,2021-04-29 18:00:04,2021-04-29 18:01:06.370085
6769,20968,1,20968,54,2191,54,14,1,14,Relationship with Supervisor,3,2191,115,2021-04-29 18:00:04,2021-04-29 18:01:06.370085
6770,20969,4,20969,57,2191,57,15,1,15,Company Administration,3,2191,115,2021-04-29 18:00:04,2021-04-29 18:01:06.370085
6771,20965,4,20965,34,2191,34,26,1,26,Direct Questions,3,2191,115,2021-04-29 18:00:04,2021-04-29 18:01:06.370085
6772,20981,4,20981,41,2194,41,12,1,12,Relationship with Co-Workers,3,2194,118,2021-04-29 18:00:04,2021-04-29 18:44:51.425642
6773,20982,4,20982,47,2194,47,13,1,13,General Satisfaction,3,2194,118,2021-04-29 18:00:04,2021-04-29 18:44:51.425642
6774,20983,1,20983,54,2194,54,14,1,14,Relationship with Supervisor,3,2194,118,2021-04-29 18:00:04,2021-04-29 18:44:51.425642
6775,20984,3,20984,57,2194,57,15,1,15,Company Administration,3,2194,118,2021-04-29 18:00:04,2021-04-29 18:44:51.425642
6776,20980,5,20980,35,2194,35,26,1,26,Direct Questions,3,2194,118,2021-04-29 18:00:04,2021-04-29 18:44:51.425642
6777,21905,4,21905,41,2377,41,12,1,12,Relationship with Co-Workers,3,2377,108,2021-05-06 18:00:02,2021-05-06 18:00:56.356009
6778,21906,4,21906,48,2377,48,13,1,13,General Satisfaction,3,2377,108,2021-05-06 18:00:02,2021-05-06 18:00:56.356009
6779,21908,4,21908,55,2377,55,15,1,15,Company Administration,3,2377,108,2021-05-06 18:00:02,2021-05-06 18:00:56.356009
6780,21907,4,21907,52,2377,52,15,1,15,Company Administration,3,2377,108,2021-05-06 18:00:02,2021-05-06 18:00:56.356009
6781,21904,5,21904,35,2377,35,26,1,26,Direct Questions,3,2377,108,2021-05-06 18:00:02,2021-05-06 18:00:56.356009
6782,21955,4,21955,41,2387,41,12,1,12,Relationship with Co-Workers,3,2387,118,2021-05-06 18:00:05,2021-05-06 18:43:05.695885
6783,21957,2,21957,54,2387,54,14,1,14,Relationship with Supervisor,3,2387,118,2021-05-06 18:00:05,2021-05-06 18:43:05.695885
6784,21958,2,21958,56,2387,56,15,1,15,Company Administration,3,2387,118,2021-05-06 18:00:05,2021-05-06 18:43:05.695885
6785,21956,2,21956,44,2387,44,15,1,15,Company Administration,3,2387,118,2021-05-06 18:00:05,2021-05-06 18:43:05.695885
6786,21954,5,21954,36,2387,36,26,1,26,Direct Questions,3,2387,118,2021-05-06 18:00:05,2021-05-06 18:43:05.695885
6787,21975,5,21975,41,2391,41,12,1,12,Relationship with Co-Workers,3,2391,110,2021-05-11 18:00:05,2021-05-11 18:32:46.916151
6788,21976,5,21976,49,2391,49,13,1,13,General Satisfaction,3,2391,110,2021-05-11 18:00:05,2021-05-11 18:32:46.916151
6789,21978,2,21978,56,2391,56,15,1,15,Company Administration,3,2391,110,2021-05-11 18:00:05,2021-05-11 18:32:46.916151
6790,21977,1,21977,51,2391,51,15,1,15,Company Administration,3,2391,110,2021-05-11 18:00:05,2021-05-11 18:32:46.916151
6791,21974,4,21974,34,2391,34,26,1,26,Direct Questions,3,2391,110,2021-05-11 18:00:05,2021-05-11 18:32:46.916151
6792,21980,4,21980,41,2392,41,12,1,12,Relationship with Co-Workers,3,2392,111,2021-05-11 18:00:05,2021-05-11 18:35:03.028228
6793,21981,5,21981,47,2392,47,13,1,13,General Satisfaction,3,2392,111,2021-05-11 18:00:05,2021-05-11 18:35:03.028228
6794,21983,5,21983,55,2392,55,15,1,15,Company Administration,3,2392,111,2021-05-11 18:00:05,2021-05-11 18:35:03.028228
6795,21982,5,21982,52,2392,52,15,1,15,Company Administration,3,2392,111,2021-05-11 18:00:05,2021-05-11 18:35:03.028228
6796,21979,5,21979,35,2392,35,26,1,26,Direct Questions,3,2392,111,2021-05-11 18:00:05,2021-05-11 18:35:03.028228
6797,22010,5,22010,41,2398,41,12,1,12,Relationship with Co-Workers,3,2398,117,2021-05-11 18:00:06,2021-05-11 18:00:57.856195
6798,22011,5,22011,47,2398,47,13,1,13,General Satisfaction,3,2398,117,2021-05-11 18:00:06,2021-05-11 18:00:57.856195
6799,22012,5,22012,53,2398,53,14,1,14,Relationship with Supervisor,3,2398,117,2021-05-11 18:00:06,2021-05-11 18:00:57.856195
6800,22013,3,22013,56,2398,56,15,1,15,Company Administration,3,2398,117,2021-05-11 18:00:06,2021-05-11 18:00:57.856195
6801,22009,5,22009,35,2398,35,26,1,26,Direct Questions,3,2398,117,2021-05-11 18:00:06,2021-05-11 18:00:57.856195
6802,22204,2,22204,41,2435,41,12,1,12,Relationship with Co-Workers,3,2435,113,2021-05-18 18:00:04,2021-05-18 18:30:53.852632
6803,22205,3,22205,49,2435,49,13,1,13,General Satisfaction,3,2435,113,2021-05-18 18:00:04,2021-05-18 18:30:53.852632
6804,22206,2,22206,53,2435,53,14,1,14,Relationship with Supervisor,3,2435,113,2021-05-18 18:00:04,2021-05-18 18:30:53.852632
6805,22207,6,22207,56,2435,56,15,1,15,Company Administration,3,2435,113,2021-05-18 18:00:04,2021-05-18 18:30:53.852632
6806,22203,4,22203,34,2435,34,26,1,26,Direct Questions,3,2435,113,2021-05-18 18:00:04,2021-05-18 18:30:53.852632
6807,22328,4,22328,41,2458,41,12,1,12,Relationship with Co-Workers,3,2458,107,2021-05-20 18:00:01,2021-05-20 18:03:46.218254
6808,22329,5,22329,49,2458,49,13,1,13,General Satisfaction,3,2458,107,2021-05-20 18:00:01,2021-05-20 18:03:46.218254
6809,22331,4,22331,57,2458,57,15,1,15,Company Administration,3,2458,107,2021-05-20 18:00:01,2021-05-20 18:03:46.218254
6810,22330,4,22330,51,2458,51,15,1,15,Company Administration,3,2458,107,2021-05-20 18:00:01,2021-05-20 18:03:46.218254
6811,22327,4,22327,36,2458,36,26,1,26,Direct Questions,3,2458,107,2021-05-20 18:00:01,2021-05-20 18:03:46.218254
6812,22353,1,22353,41,2463,41,12,1,12,Relationship with Co-Workers,3,2463,112,2021-05-20 18:00:02,2021-05-20 20:29:43.056948
6813,22354,1,22354,45,2463,45,13,1,13,General Satisfaction,3,2463,112,2021-05-20 18:00:02,2021-05-20 20:29:43.056948
6814,22356,1,22356,58,2463,58,15,1,15,Company Administration,3,2463,112,2021-05-20 18:00:02,2021-05-20 20:29:43.056948
6815,22355,1,22355,51,2463,51,15,1,15,Company Administration,3,2463,112,2021-05-20 18:00:02,2021-05-20 20:29:43.056948
6816,22352,1,22352,36,2463,36,26,1,26,Direct Questions,3,2463,112,2021-05-20 18:00:02,2021-05-20 20:29:43.056948
6817,22413,1,22413,41,2475,41,12,1,12,Relationship with Co-Workers,3,2475,112,2021-05-25 18:00:02,2021-05-25 18:00:27.321439
6818,22414,1,22414,45,2475,45,13,1,13,General Satisfaction,3,2475,112,2021-05-25 18:00:02,2021-05-25 18:00:27.321439
6819,22416,1,22416,58,2475,58,15,1,15,Company Administration,3,2475,112,2021-05-25 18:00:02,2021-05-25 18:00:27.321439
6820,22415,1,22415,51,2475,51,15,1,15,Company Administration,3,2475,112,2021-05-25 18:00:02,2021-05-25 18:00:27.321439
6821,22412,1,22412,34,2475,34,26,1,26,Direct Questions,3,2475,112,2021-05-25 18:00:02,2021-05-25 18:00:27.321439
6822,22418,2,22418,41,2476,41,12,1,12,Relationship with Co-Workers,3,2476,113,2021-05-25 18:00:03,2021-05-25 18:36:46.327790
6823,22419,4,22419,47,2476,47,13,1,13,General Satisfaction,3,2476,113,2021-05-25 18:00:03,2021-05-25 18:36:46.327790
6824,22420,3,22420,50,2476,50,14,1,14,Relationship with Supervisor,3,2476,113,2021-05-25 18:00:03,2021-05-25 18:36:46.327790
6825,22421,4,22421,55,2476,55,15,1,15,Company Administration,3,2476,113,2021-05-25 18:00:03,2021-05-25 18:36:46.327790
6826,22417,4,22417,34,2476,34,26,1,26,Direct Questions,3,2476,113,2021-05-25 18:00:03,2021-05-25 18:36:46.327790
6827,22542,4,22542,41,2499,41,12,1,12,Relationship with Co-Workers,3,2499,107,2021-05-27 18:00:02,2021-05-27 18:29:39.958320
6828,22544,3,22544,54,2499,54,14,1,14,Relationship with Supervisor,3,2499,107,2021-05-27 18:00:02,2021-05-27 18:29:39.958320
6829,22545,4,22545,58,2499,58,15,1,15,Company Administration,3,2499,107,2021-05-27 18:00:02,2021-05-27 18:29:39.958320
6830,22543,4,22543,44,2499,44,15,1,15,Company Administration,3,2499,107,2021-05-27 18:00:02,2021-05-27 18:29:39.958320
6831,22541,4,22541,34,2499,34,26,1,26,Direct Questions,3,2499,107,2021-05-27 18:00:02,2021-05-27 18:29:39.958320
6832,100040,4,100040,41,10008,41,12,1,12,Relationship with Co-Workers,3,10008,114,2021-06-01 18:00:02,2021-06-01 19:47:35.458724
6833,100041,4,100041,45,10008,45,13,1,13,General Satisfaction,3,10008,114,2021-06-01 18:00:02,2021-06-01 19:47:35.458724
6834,100043,3,100043,57,10008,57,15,1,15,Company Administration,3,10008,114,2021-06-01 18:00:02,2021-06-01 19:47:35.458724
6835,100042,5,100042,51,10008,51,15,1,15,Company Administration,3,10008,114,2021-06-01 18:00:02,2021-06-01 19:47:35.458724
6836,100039,4,100039,34,10008,34,26,1,26,Direct Questions,3,10008,114,2021-06-01 18:00:02,2021-06-01 19:47:35.458724
6837,100394,4,100394,41,10080,41,12,1,12,Relationship with Co-Workers,3,10080,114,2021-06-08 18:00:03,2021-06-08 18:43:19.829334
6838,100396,6,100396,53,10080,53,14,1,14,Relationship with Supervisor,3,10080,114,2021-06-08 18:00:03,2021-06-08 18:43:19.829334
6839,100395,4,100395,44,10080,44,15,1,15,Company Administration,3,10080,114,2021-06-08 18:00:03,2021-06-08 18:43:19.829334
6840,100397,4,100397,55,10080,55,15,1,15,Company Administration,3,10080,114,2021-06-08 18:00:03,2021-06-08 18:43:19.829334
6841,100393,4,100393,34,10080,34,26,1,26,Direct Questions,3,10080,114,2021-06-08 18:00:03,2021-06-08 18:43:19.829334
6842,100404,4,100404,41,10082,41,12,1,12,Relationship with Co-Workers,3,10082,116,2021-06-08 18:00:03,2021-06-08 18:33:50.900850
6843,100405,4,100405,45,10082,45,13,1,13,General Satisfaction,3,10082,116,2021-06-08 18:00:03,2021-06-08 18:33:50.900850
6844,100407,3,100407,58,10082,58,15,1,15,Company Administration,3,10082,116,2021-06-08 18:00:03,2021-06-08 18:33:50.900850
6845,100406,3,100406,51,10082,51,15,1,15,Company Administration,3,10082,116,2021-06-08 18:00:03,2021-06-08 18:33:50.900850
6846,100403,3,100403,36,10082,36,26,1,26,Direct Questions,3,10082,116,2021-06-08 18:00:03,2021-06-08 18:33:50.900850
6847,100625,4,100625,41,10129,41,12,1,12,Relationship with Co-Workers,3,10129,111,2021-06-10 18:00:03,2021-06-10 18:35:30.954028
6848,100626,3,100626,46,10129,46,13,1,13,General Satisfaction,3,10129,111,2021-06-10 18:00:03,2021-06-10 18:35:30.954028
6849,100628,1,100628,57,10129,57,15,1,15,Company Administration,3,10129,111,2021-06-10 18:00:03,2021-06-10 18:35:30.954028
6850,100627,4,100627,52,10129,52,15,1,15,Company Administration,3,10129,111,2021-06-10 18:00:03,2021-06-10 18:35:30.954028
6851,100624,4,100624,36,10129,36,26,1,26,Direct Questions,3,10129,111,2021-06-10 18:00:03,2021-06-10 18:35:30.954028
6852,100650,4,100650,41,10134,41,12,1,12,Relationship with Co-Workers,3,10134,116,2021-06-10 18:00:04,2021-06-10 21:21:24.251964
6853,100651,4,100651,46,10134,46,13,1,13,General Satisfaction,3,10134,116,2021-06-10 18:00:04,2021-06-10 21:21:24.251964
6854,100653,4,100653,57,10134,57,15,1,15,Company Administration,3,10134,116,2021-06-10 18:00:04,2021-06-10 21:21:24.251964
6855,100652,4,100652,52,10134,52,15,1,15,Company Administration,3,10134,116,2021-06-10 18:00:04,2021-06-10 21:21:24.251964
6856,100649,3,100649,34,10134,34,26,1,26,Direct Questions,3,10134,116,2021-06-10 18:00:04,2021-06-10 21:21:24.251964
6857,100655,5,100655,41,10135,41,12,1,12,Relationship with Co-Workers,3,10135,117,2021-06-10 18:00:04,2021-06-10 18:01:14.555643
6858,100656,2,100656,44,10135,44,15,1,15,Company Administration,3,10135,117,2021-06-10 18:00:04,2021-06-10 18:01:14.555643
6859,100658,1,100658,55,10135,55,15,1,15,Company Administration,3,10135,117,2021-06-10 18:00:04,2021-06-10 18:01:14.555643
6860,100657,5,100657,51,10135,51,15,1,15,Company Administration,3,10135,117,2021-06-10 18:00:04,2021-06-10 18:01:14.555643
6861,100654,5,100654,34,10135,34,26,1,26,Direct Questions,3,10135,117,2021-06-10 18:00:04,2021-06-10 18:01:14.555643
6862,100979,4,100979,41,10203,41,12,1,12,Relationship with Co-Workers,3,10203,107,2021-06-22 18:00:02,2021-06-22 21:23:31.567340
6863,100982,3,100982,56,10203,56,15,1,15,Company Administration,3,10203,107,2021-06-22 18:00:02,2021-06-22 21:23:31.567340
6864,100980,4,100980,44,10203,44,15,1,15,Company Administration,3,10203,107,2021-06-22 18:00:02,2021-06-22 21:23:31.567340
6865,100981,4,100981,51,10203,51,15,1,15,Company Administration,3,10203,107,2021-06-22 18:00:02,2021-06-22 21:23:31.567340
6866,100978,4,100978,34,10203,34,26,1,26,Direct Questions,3,10203,107,2021-06-22 18:00:02,2021-06-22 21:23:31.567340
6867,101248,5,101248,41,10260,41,12,1,12,Relationship with Co-Workers,3,10260,110,2021-06-24 18:00:02,2021-06-24 18:18:20.016679
6868,101249,5,101249,49,10260,49,13,1,13,General Satisfaction,3,10260,110,2021-06-24 18:00:02,2021-06-24 18:18:20.016679
6869,101250,6,101250,50,10260,50,14,1,14,Relationship with Supervisor,3,10260,110,2021-06-24 18:00:02,2021-06-24 18:18:20.016679
6870,101251,6,101251,55,10260,55,15,1,15,Company Administration,3,10260,110,2021-06-24 18:00:02,2021-06-24 18:18:20.016679
6871,101247,4,101247,35,10260,35,26,1,26,Direct Questions,3,10260,110,2021-06-24 18:00:02,2021-06-24 18:18:20.016679
6872,101288,3,101288,41,10268,41,12,1,12,Relationship with Co-Workers,3,10268,118,2021-06-24 18:00:04,2021-06-24 18:47:17.564134
6873,101289,4,101289,49,10268,49,13,1,13,General Satisfaction,3,10268,118,2021-06-24 18:00:04,2021-06-24 18:47:17.564134
6874,101291,3,101291,58,10268,58,15,1,15,Company Administration,3,10268,118,2021-06-24 18:00:04,2021-06-24 18:47:17.564134
6875,101290,4,101290,51,10268,51,15,1,15,Company Administration,3,10268,118,2021-06-24 18:00:04,2021-06-24 18:47:17.564134
6876,101287,5,101287,34,10268,34,26,1,26,Direct Questions,3,10268,118,2021-06-24 18:00:04,2021-06-24 18:47:17.564134
6877,101298,4,101298,41,10270,41,12,1,12,Relationship with Co-Workers,3,10270,108,2021-06-29 18:00:03,2021-06-29 18:00:51.389242
6878,101299,4,101299,48,10270,48,13,1,13,General Satisfaction,3,10270,108,2021-06-29 18:00:03,2021-06-29 18:00:51.389242
6879,101300,4,101300,50,10270,50,14,1,14,Relationship with Supervisor,3,10270,108,2021-06-29 18:00:03,2021-06-29 18:00:51.389242
6880,101301,5,101301,55,10270,55,15,1,15,Company Administration,3,10270,108,2021-06-29 18:00:03,2021-06-29 18:00:51.389242
6881,101297,4,101297,36,10270,36,26,1,26,Direct Questions,3,10270,108,2021-06-29 18:00:03,2021-06-29 18:00:51.389242
6882,101323,4,101323,41,10275,41,12,1,12,Relationship with Co-Workers,3,10275,113,2021-06-29 18:00:04,2021-06-29 18:41:23.073421
6883,101324,3,101324,47,10275,47,13,1,13,General Satisfaction,3,10275,113,2021-06-29 18:00:04,2021-06-29 18:41:23.073421
6884,101326,5,101326,55,10275,55,15,1,15,Company Administration,3,10275,113,2021-06-29 18:00:04,2021-06-29 18:41:23.073421
6885,101325,5,101325,52,10275,52,15,1,15,Company Administration,3,10275,113,2021-06-29 18:00:04,2021-06-29 18:41:23.073421
6886,101322,1,101322,35,10275,35,26,1,26,Direct Questions,3,10275,113,2021-06-29 18:00:04,2021-06-29 18:41:23.073421
6887,101607,4,101607,41,10335,41,12,1,12,Relationship with Co-Workers,3,10335,107,2021-07-06 18:00:02,2021-07-07 16:53:25.306321
6888,101608,4,101608,49,10335,49,13,1,13,General Satisfaction,3,10335,107,2021-07-06 18:00:02,2021-07-07 16:53:25.306321
6889,101609,3,101609,50,10335,50,14,1,14,Relationship with Supervisor,3,10335,107,2021-07-06 18:00:02,2021-07-07 16:53:25.306321
6890,101610,3,101610,58,10335,58,15,1,15,Company Administration,3,10335,107,2021-07-06 18:00:02,2021-07-07 16:53:25.306321
6891,101606,4,101606,35,10335,35,26,1,26,Direct Questions,3,10335,107,2021-07-06 18:00:02,2021-07-07 16:53:25.306321
6892,101612,3,101612,41,10336,41,12,1,12,Relationship with Co-Workers,3,10336,108,2021-07-06 18:00:02,2021-07-06 18:22:05.985701
6893,101613,4,101613,49,10336,49,13,1,13,General Satisfaction,3,10336,108,2021-07-06 18:00:02,2021-07-06 18:22:05.985701
6894,101614,4,101614,50,10336,50,14,1,14,Relationship with Supervisor,3,10336,108,2021-07-06 18:00:02,2021-07-06 18:22:05.985701
6895,101615,3,101615,56,10336,56,15,1,15,Company Administration,3,10336,108,2021-07-06 18:00:02,2021-07-06 18:22:05.985701
6896,101611,4,101611,35,10336,35,26,1,26,Direct Questions,3,10336,108,2021-07-06 18:00:02,2021-07-06 18:22:05.985701
6897,101896,4,101896,41,10396,41,12,1,12,Relationship with Co-Workers,3,10396,114,2021-07-08 18:00:03,2021-07-08 18:34:55.996343
6898,101897,3,101897,47,10396,47,13,1,13,General Satisfaction,3,10396,114,2021-07-08 18:00:03,2021-07-08 18:34:55.996343
6899,101899,5,101899,58,10396,58,15,1,15,Company Administration,3,10396,114,2021-07-08 18:00:03,2021-07-08 18:34:55.996343
6900,101898,3,101898,51,10396,51,15,1,15,Company Administration,3,10396,114,2021-07-08 18:00:03,2021-07-08 18:34:55.996343
6901,101895,4,101895,36,10396,36,26,1,26,Direct Questions,3,10396,114,2021-07-08 18:00:03,2021-07-08 18:34:55.996343
6902,4032,4,4032,40,992,40,12,1,12,Relationship with Co-Workers,3,992,109,2021-04-20 18:00:03,2021-04-20 18:03:43.739540
6903,4033,5,4033,48,992,48,13,1,13,General Satisfaction,3,992,109,2021-04-20 18:00:03,2021-04-20 18:03:43.739540
6904,4034,4,4034,50,992,50,14,1,14,Relationship with Supervisor,3,992,109,2021-04-20 18:00:03,2021-04-20 18:03:43.739540
6905,4035,1,4035,56,992,56,15,1,15,Company Administration,3,992,109,2021-04-20 18:00:03,2021-04-20 18:03:43.739540
6906,4031,4,4031,35,992,35,26,1,26,Direct Questions,3,992,109,2021-04-20 18:00:03,2021-04-20 18:03:43.739540
6907,20022,5,20022,40,2004,40,12,1,12,Relationship with Co-Workers,3,2004,110,2021-04-27 18:00:03,2021-04-27 18:14:19.830999
6908,20025,5,20025,56,2004,56,15,1,15,Company Administration,3,2004,110,2021-04-27 18:00:03,2021-04-27 18:14:19.830999
6909,20023,5,20023,44,2004,44,15,1,15,Company Administration,3,2004,110,2021-04-27 18:00:03,2021-04-27 18:14:19.830999
6910,20024,2,20024,51,2004,51,15,1,15,Company Administration,3,2004,110,2021-04-27 18:00:03,2021-04-27 18:14:19.830999
6911,20021,5,20021,34,2004,34,26,1,26,Direct Questions,3,2004,110,2021-04-27 18:00:03,2021-04-27 18:14:19.830999
6912,20052,3,20052,40,2010,40,12,1,12,Relationship with Co-Workers,3,2010,116,2021-04-27 18:00:05,2021-04-27 18:35:23.861956
6913,20054,3,20054,50,2010,50,14,1,14,Relationship with Supervisor,3,2010,116,2021-04-27 18:00:05,2021-04-27 18:35:23.861956
6914,20055,4,20055,58,2010,58,15,1,15,Company Administration,3,2010,116,2021-04-27 18:00:05,2021-04-27 18:35:23.861956
6915,20053,3,20053,44,2010,44,15,1,15,Company Administration,3,2010,116,2021-04-27 18:00:05,2021-04-27 18:35:23.861956
6916,20051,2,20051,35,2010,35,26,1,26,Direct Questions,3,2010,116,2021-04-27 18:00:05,2021-04-27 18:35:23.861956
6917,20936,4,20936,40,2185,40,12,1,12,Relationship with Co-Workers,3,2185,109,2021-04-29 18:00:02,2021-04-29 18:30:53.832883
6918,20939,4,20939,58,2185,58,15,1,15,Company Administration,3,2185,109,2021-04-29 18:00:02,2021-04-29 18:30:53.832883
6919,20937,3,20937,44,2185,44,15,1,15,Company Administration,3,2185,109,2021-04-29 18:00:02,2021-04-29 18:30:53.832883
6920,20938,4,20938,51,2185,51,15,1,15,Company Administration,3,2185,109,2021-04-29 18:00:02,2021-04-29 18:30:53.832883
6921,20935,3,20935,34,2185,34,26,1,26,Direct Questions,3,2185,109,2021-04-29 18:00:02,2021-04-29 18:30:53.832883
6922,20996,2,20996,40,2197,40,12,1,12,Relationship with Co-Workers,3,2197,109,2021-05-04 18:00:03,2021-05-04 18:20:47.230887
6923,20997,6,20997,47,2197,47,13,1,13,General Satisfaction,3,2197,109,2021-05-04 18:00:03,2021-05-04 18:20:47.230887
6924,20998,1,20998,54,2197,54,14,1,14,Relationship with Supervisor,3,2197,109,2021-05-04 18:00:03,2021-05-04 18:20:47.230887
6925,20999,6,20999,57,2197,57,15,1,15,Company Administration,3,2197,109,2021-05-04 18:00:03,2021-05-04 18:20:47.230887
6926,20995,2,20995,36,2197,36,26,1,26,Direct Questions,3,2197,109,2021-05-04 18:00:03,2021-05-04 18:20:47.230887
6927,21915,5,21915,40,2379,40,12,1,12,Relationship with Co-Workers,3,2379,110,2021-05-06 18:00:02,2021-05-06 18:41:27.053047
6928,21916,4,21916,47,2379,47,13,1,13,General Satisfaction,3,2379,110,2021-05-06 18:00:02,2021-05-06 18:41:27.053047
6929,21917,3,21917,53,2379,53,14,1,14,Relationship with Supervisor,3,2379,110,2021-05-06 18:00:02,2021-05-06 18:41:27.053047
6930,21918,3,21918,57,2379,57,15,1,15,Company Administration,3,2379,110,2021-05-06 18:00:02,2021-05-06 18:41:27.053047
6931,21914,4,21914,34,2379,34,26,1,26,Direct Questions,3,2379,110,2021-05-06 18:00:02,2021-05-06 18:41:27.053047
6932,21945,4,21945,40,2385,40,12,1,12,Relationship with Co-Workers,3,2385,116,2021-05-06 18:00:04,2021-05-06 18:41:36.333553
6933,21946,4,21946,46,2385,46,13,1,13,General Satisfaction,3,2385,116,2021-05-06 18:00:04,2021-05-06 18:41:36.333553
6934,21948,4,21948,55,2385,55,15,1,15,Company Administration,3,2385,116,2021-05-06 18:00:04,2021-05-06 18:41:36.333553
6935,21947,4,21947,52,2385,52,15,1,15,Company Administration,3,2385,116,2021-05-06 18:00:04,2021-05-06 18:41:36.333553
6936,21944,3,21944,35,2385,35,26,1,26,Direct Questions,3,2385,116,2021-05-06 18:00:04,2021-05-06 18:41:36.333553
6937,21995,2,21995,40,2395,40,12,1,12,Relationship with Co-Workers,3,2395,114,2021-05-11 18:00:05,2021-05-11 18:46:33.312407
6938,21996,4,21996,49,2395,49,13,1,13,General Satisfaction,3,2395,114,2021-05-11 18:00:05,2021-05-11 18:46:33.312407
6939,21998,4,21998,58,2395,58,15,1,15,Company Administration,3,2395,114,2021-05-11 18:00:05,2021-05-11 18:46:33.312407
6940,21997,4,21997,52,2395,52,15,1,15,Company Administration,3,2395,114,2021-05-11 18:00:05,2021-05-11 18:46:33.312407
6941,21994,2,21994,34,2395,34,26,1,26,Direct Questions,3,2395,114,2021-05-11 18:00:05,2021-05-11 18:46:33.312407
6942,22154,4,22154,40,2425,40,12,1,12,Relationship with Co-Workers,3,2425,115,2021-05-13 18:00:03,2021-05-13 18:09:41.414048
6943,22155,4,22155,48,2425,48,13,1,13,General Satisfaction,3,2425,115,2021-05-13 18:00:03,2021-05-13 18:09:41.414048
6944,22157,2,22157,56,2425,56,15,1,15,Company Administration,3,2425,115,2021-05-13 18:00:03,2021-05-13 18:09:41.414048
6945,22156,4,22156,51,2425,51,15,1,15,Company Administration,3,2425,115,2021-05-13 18:00:03,2021-05-13 18:09:41.414048
6946,22153,4,22153,36,2425,36,26,1,26,Direct Questions,3,2425,115,2021-05-13 18:00:03,2021-05-13 18:09:41.414048
6947,22373,4,22373,40,2467,40,12,1,12,Relationship with Co-Workers,3,2467,116,2021-05-20 18:00:03,2021-05-20 20:35:14.633168
6948,22375,3,22375,53,2467,53,14,1,14,Relationship with Supervisor,3,2467,116,2021-05-20 18:00:03,2021-05-20 20:35:14.633168
6949,22376,4,22376,58,2467,58,15,1,15,Company Administration,3,2467,116,2021-05-20 18:00:03,2021-05-20 20:35:14.633168
6950,22374,3,22374,44,2467,44,15,1,15,Company Administration,3,2467,116,2021-05-20 18:00:03,2021-05-20 20:35:14.633168
6951,22372,3,22372,35,2467,35,26,1,26,Direct Questions,3,2467,116,2021-05-20 18:00:03,2021-05-20 20:35:14.633168
6952,22388,4,22388,40,2470,40,12,1,12,Relationship with Co-Workers,3,2470,107,2021-05-25 18:00:01,2021-05-25 18:41:53.237939
6953,22389,4,22389,47,2470,47,13,1,13,General Satisfaction,3,2470,107,2021-05-25 18:00:01,2021-05-25 18:41:53.237939
6954,22390,1,22390,53,2470,53,14,1,14,Relationship with Supervisor,3,2470,107,2021-05-25 18:00:01,2021-05-25 18:41:53.237939
6955,22391,4,22391,57,2470,57,15,1,15,Company Administration,3,2470,107,2021-05-25 18:00:01,2021-05-25 18:41:53.237939
6956,22387,4,22387,34,2470,34,26,1,26,Direct Questions,3,2470,107,2021-05-25 18:00:01,2021-05-25 18:41:53.237939
6957,22408,6,22408,40,2474,40,12,1,12,Relationship with Co-Workers,3,2474,111,2021-05-25 18:00:02,2021-05-25 18:34:30.526723
6958,22409,4,22409,47,2474,47,13,1,13,General Satisfaction,3,2474,111,2021-05-25 18:00:02,2021-05-25 18:34:30.526723
6959,22411,4,22411,55,2474,55,15,1,15,Company Administration,3,2474,111,2021-05-25 18:00:02,2021-05-25 18:34:30.526723
6960,22410,4,22410,51,2474,51,15,1,15,Company Administration,3,2474,111,2021-05-25 18:00:02,2021-05-25 18:34:30.526723
6961,22407,4,22407,36,2474,36,26,1,26,Direct Questions,3,2474,111,2021-05-25 18:00:02,2021-05-25 18:34:30.526723
6962,22582,4,22582,40,2507,40,12,1,12,Relationship with Co-Workers,3,2507,115,2021-05-27 18:00:03,2021-05-27 18:04:04.070926
6963,22583,4,22583,45,2507,45,13,1,13,General Satisfaction,3,2507,115,2021-05-27 18:00:03,2021-05-27 18:04:04.070926
6964,22584,4,22584,53,2507,53,14,1,14,Relationship with Supervisor,3,2507,115,2021-05-27 18:00:03,2021-05-27 18:04:04.070926
6965,22585,4,22585,57,2507,57,15,1,15,Company Administration,3,2507,115,2021-05-27 18:00:03,2021-05-27 18:04:04.070926
6966,22581,4,22581,35,2507,35,26,1,26,Direct Questions,3,2507,115,2021-05-27 18:00:03,2021-05-27 18:04:04.070926
6967,100010,4,100010,40,10002,40,12,1,12,Relationship with Co-Workers,3,10002,108,2021-06-01 18:00:01,2021-06-01 18:00:50.881452
6968,100011,4,100011,48,10002,48,13,1,13,General Satisfaction,3,10002,108,2021-06-01 18:00:01,2021-06-01 18:00:50.881452
6969,100012,5,100012,50,10002,50,14,1,14,Relationship with Supervisor,3,10002,108,2021-06-01 18:00:01,2021-06-01 18:00:50.881452
6970,100013,2,100013,55,10002,55,15,1,15,Company Administration,3,10002,108,2021-06-01 18:00:01,2021-06-01 18:00:50.881452
6971,100009,4,100009,34,10002,34,26,1,26,Direct Questions,3,10002,108,2021-06-01 18:00:01,2021-06-01 18:00:50.881452
6972,100020,1,100020,40,10004,40,12,1,12,Relationship with Co-Workers,3,10004,110,2021-06-01 18:00:02,2021-06-02 17:27:19.667040
6973,100021,1,100021,46,10004,46,13,1,13,General Satisfaction,3,10004,110,2021-06-01 18:00:02,2021-06-02 17:27:19.667040
6974,100023,1,100023,58,10004,58,15,1,15,Company Administration,3,10004,110,2021-06-01 18:00:02,2021-06-02 17:27:19.667040
6975,100022,6,100022,52,10004,52,15,1,15,Company Administration,3,10004,110,2021-06-01 18:00:02,2021-06-02 17:27:19.667040
6976,100019,1,100019,34,10004,34,26,1,26,Direct Questions,3,10004,110,2021-06-01 18:00:02,2021-06-02 17:27:19.667040
6977,100035,3,100035,40,10007,40,12,1,12,Relationship with Co-Workers,3,10007,113,2021-06-01 18:00:02,2021-06-01 18:33:11.997150
6978,100036,4,100036,48,10007,48,13,1,13,General Satisfaction,3,10007,113,2021-06-01 18:00:02,2021-06-01 18:33:11.997150
6979,100038,1,100038,57,10007,57,15,1,15,Company Administration,3,10007,113,2021-06-01 18:00:02,2021-06-01 18:33:11.997150
6980,100037,2,100037,51,10007,51,15,1,15,Company Administration,3,10007,113,2021-06-01 18:00:02,2021-06-01 18:33:11.997150
6981,100034,3,100034,35,10007,35,26,1,26,Direct Questions,3,10007,113,2021-06-01 18:00:02,2021-06-01 18:33:11.997150
6982,100364,4,100364,40,10074,40,12,1,12,Relationship with Co-Workers,3,10074,108,2021-06-08 18:00:02,2021-06-08 18:01:25.036761
6983,100365,4,100365,49,10074,49,13,1,13,General Satisfaction,3,10074,108,2021-06-08 18:00:02,2021-06-08 18:01:25.036761
6984,100367,2,100367,55,10074,55,15,1,15,Company Administration,3,10074,108,2021-06-08 18:00:02,2021-06-08 18:01:25.036761
6985,100366,2,100366,52,10074,52,15,1,15,Company Administration,3,10074,108,2021-06-08 18:00:02,2021-06-08 18:01:25.036761
6986,100363,4,100363,34,10074,34,26,1,26,Direct Questions,3,10074,108,2021-06-08 18:00:02,2021-06-08 18:01:25.036761
6987,100374,5,100374,40,10076,40,12,1,12,Relationship with Co-Workers,3,10076,110,2021-06-08 18:00:02,2021-06-08 18:19:16.443863
6988,100375,1,100375,46,10076,46,13,1,13,General Satisfaction,3,10076,110,2021-06-08 18:00:02,2021-06-08 18:19:16.443863
6989,100376,6,100376,50,10076,50,14,1,14,Relationship with Supervisor,3,10076,110,2021-06-08 18:00:02,2021-06-08 18:19:16.443863
6990,100377,6,100377,55,10076,55,15,1,15,Company Administration,3,10076,110,2021-06-08 18:00:02,2021-06-08 18:19:16.443863
6991,100373,1,100373,35,10076,35,26,1,26,Direct Questions,3,10076,110,2021-06-08 18:00:02,2021-06-08 18:19:16.443863
6992,100700,4,100700,40,10144,40,12,1,12,Relationship with Co-Workers,3,10144,114,2021-06-15 18:00:05,2021-06-15 18:36:59.163653
6993,100701,4,100701,45,10144,45,13,1,13,General Satisfaction,3,10144,114,2021-06-15 18:00:05,2021-06-15 18:36:59.163653
6994,100703,5,100703,56,10144,56,15,1,15,Company Administration,3,10144,114,2021-06-15 18:00:05,2021-06-15 18:36:59.163653
6995,100702,2,100702,52,10144,52,15,1,15,Company Administration,3,10144,114,2021-06-15 18:00:05,2021-06-15 18:36:59.163653
6996,100699,4,100699,35,10144,35,26,1,26,Direct Questions,3,10144,114,2021-06-15 18:00:05,2021-06-15 18:36:59.163653
6997,100705,4,100705,40,10145,40,12,1,12,Relationship with Co-Workers,3,10145,115,2021-06-15 18:00:05,2021-06-15 18:02:09.395485
6998,100707,4,100707,53,10145,53,14,1,14,Relationship with Supervisor,3,10145,115,2021-06-15 18:00:05,2021-06-15 18:02:09.395485
6999,100708,4,100708,57,10145,57,15,1,15,Company Administration,3,10145,115,2021-06-15 18:00:05,2021-06-15 18:02:09.395485
7000,100706,3,100706,44,10145,44,15,1,15,Company Administration,3,10145,115,2021-06-15 18:00:05,2021-06-15 18:02:09.395485
7001,100704,4,100704,35,10145,35,26,1,26,Direct Questions,3,10145,115,2021-06-15 18:00:05,2021-06-15 18:02:09.395485
7002,100934,5,100934,40,10194,40,12,1,12,Relationship with Co-Workers,3,10194,110,2021-06-17 18:00:02,2021-06-17 18:02:09.120094
7003,100935,3,100935,47,10194,47,13,1,13,General Satisfaction,3,10194,110,2021-06-17 18:00:02,2021-06-17 18:02:09.120094
7004,100936,5,100936,50,10194,50,14,1,14,Relationship with Supervisor,3,10194,110,2021-06-17 18:00:02,2021-06-17 18:02:09.120094
7005,100937,2,100937,57,10194,57,15,1,15,Company Administration,3,10194,110,2021-06-17 18:00:02,2021-06-17 18:02:09.120094
7006,100933,4,100933,34,10194,34,26,1,26,Direct Questions,3,10194,110,2021-06-17 18:00:02,2021-06-17 18:02:09.120094
7007,101318,1,101318,40,10274,40,12,1,12,Relationship with Co-Workers,3,10274,112,2021-06-29 18:00:03,2021-06-29 18:03:24.486629
7008,101319,2,101319,49,10274,49,13,1,13,General Satisfaction,3,10274,112,2021-06-29 18:00:03,2021-06-29 18:03:24.486629
7009,101320,6,101320,54,10274,54,14,1,14,Relationship with Supervisor,3,10274,112,2021-06-29 18:00:03,2021-06-29 18:03:24.486629
7010,101321,1,101321,57,10274,57,15,1,15,Company Administration,3,10274,112,2021-06-29 18:00:03,2021-06-29 18:03:24.486629
7011,101317,1,101317,34,10274,34,26,1,26,Direct Questions,3,10274,112,2021-06-29 18:00:03,2021-06-29 18:03:24.486629
7012,101582,3,101582,40,10330,40,12,1,12,Relationship with Co-Workers,3,10330,114,2021-07-01 18:00:03,2021-07-01 18:34:37.169430
7013,101583,4,101583,45,10330,45,13,1,13,General Satisfaction,3,10330,114,2021-07-01 18:00:03,2021-07-01 18:34:37.169430
7014,101584,4,101584,50,10330,50,14,1,14,Relationship with Supervisor,3,10330,114,2021-07-01 18:00:03,2021-07-01 18:34:37.169430
7015,101585,5,101585,55,10330,55,15,1,15,Company Administration,3,10330,114,2021-07-01 18:00:03,2021-07-01 18:34:37.169430
7016,101581,4,101581,36,10330,36,26,1,26,Direct Questions,3,10330,114,2021-07-01 18:00:03,2021-07-01 18:34:37.169430
7017,101632,1,101632,40,10340,40,12,1,12,Relationship with Co-Workers,3,10340,112,2021-07-06 18:00:03,2021-07-07 03:53:30.598583
7018,101633,1,101633,46,10340,46,13,1,13,General Satisfaction,3,10340,112,2021-07-06 18:00:03,2021-07-07 03:53:30.598583
7019,101635,6,101635,55,10340,55,15,1,15,Company Administration,3,10340,112,2021-07-06 18:00:03,2021-07-07 03:53:30.598583
7020,101634,1,101634,51,10340,51,15,1,15,Company Administration,3,10340,112,2021-07-06 18:00:03,2021-07-07 03:53:30.598583
7021,101631,1,101631,35,10340,35,26,1,26,Direct Questions,3,10340,112,2021-07-06 18:00:03,2021-07-07 03:53:30.598583
7022,101891,5,101891,40,10395,40,12,1,12,Relationship with Co-Workers,3,10395,113,2021-07-08 18:00:02,2021-07-08 18:33:38.279530
7023,101892,4,101892,48,10395,48,13,1,13,General Satisfaction,3,10395,113,2021-07-08 18:00:02,2021-07-08 18:33:38.279530
7024,101894,5,101894,55,10395,55,15,1,15,Company Administration,3,10395,113,2021-07-08 18:00:02,2021-07-08 18:33:38.279530
7025,101893,2,101893,51,10395,51,15,1,15,Company Administration,3,10395,113,2021-07-08 18:00:02,2021-07-08 18:33:38.279530
7026,101890,2,101890,34,10395,34,26,1,26,Direct Questions,3,10395,113,2021-07-08 18:00:02,2021-07-08 18:33:38.279530
7027,4037,4,4037,39,993,39,12,1,12,Relationship with Co-Workers,3,993,110,2021-04-20 18:00:03,2021-04-20 18:01:53.833626
7028,4039,5,4039,50,993,50,14,1,14,Relationship with Supervisor,3,993,110,2021-04-20 18:00:03,2021-04-20 18:01:53.833626
7029,4040,4,4040,57,993,57,15,1,15,Company Administration,3,993,110,2021-04-20 18:00:03,2021-04-20 18:01:53.833626
7030,4038,3,4038,44,993,44,15,1,15,Company Administration,3,993,110,2021-04-20 18:00:03,2021-04-20 18:01:53.833626
7031,4036,4,4036,35,993,35,26,1,26,Direct Questions,3,993,110,2021-04-20 18:00:03,2021-04-20 18:01:53.833626
7032,4882,4,4882,39,1162,39,12,1,12,Relationship with Co-Workers,3,1162,108,2021-04-22 18:00:02,2021-04-22 18:04:16.819695
7033,4883,4,4883,45,1162,45,13,1,13,General Satisfaction,3,1162,108,2021-04-22 18:00:02,2021-04-22 18:04:16.819695
7034,4885,4,4885,58,1162,58,15,1,15,Company Administration,3,1162,108,2021-04-22 18:00:02,2021-04-22 18:04:16.819695
7035,4884,4,4884,52,1162,52,15,1,15,Company Administration,3,1162,108,2021-04-22 18:00:02,2021-04-22 18:04:16.819695
7036,4881,5,4881,35,1162,35,26,1,26,Direct Questions,3,1162,108,2021-04-22 18:00:02,2021-04-22 18:04:16.819695
7037,4887,3,4887,39,1163,39,12,1,12,Relationship with Co-Workers,3,1163,109,2021-04-22 18:00:02,2021-04-22 18:01:11.517485
7038,4888,6,4888,49,1163,49,13,1,13,General Satisfaction,3,1163,109,2021-04-22 18:00:02,2021-04-22 18:01:11.517485
7039,4889,5,4889,53,1163,53,14,1,14,Relationship with Supervisor,3,1163,109,2021-04-22 18:00:02,2021-04-22 18:01:11.517485
7040,4890,2,4890,56,1163,56,15,1,15,Company Administration,3,1163,109,2021-04-22 18:00:02,2021-04-22 18:01:11.517485
7041,4886,4,4886,36,1163,36,26,1,26,Direct Questions,3,1163,109,2021-04-22 18:00:02,2021-04-22 18:01:11.517485
7042,4902,3,4902,39,1166,39,12,1,12,Relationship with Co-Workers,3,1166,112,2021-04-22 18:00:03,2021-04-22 18:02:58.453207
7043,4903,3,4903,47,1166,47,13,1,13,General Satisfaction,3,1166,112,2021-04-22 18:00:03,2021-04-22 18:02:58.453207
7044,4904,2,4904,53,1166,53,14,1,14,Relationship with Supervisor,3,1166,112,2021-04-22 18:00:03,2021-04-22 18:02:58.453207
7045,4905,4,4905,57,1166,57,15,1,15,Company Administration,3,1166,112,2021-04-22 18:00:03,2021-04-22 18:02:58.453207
7046,4901,2,4901,34,1166,34,26,1,26,Direct Questions,3,1166,112,2021-04-22 18:00:03,2021-04-22 18:02:58.453207
7047,4912,3,4912,39,1168,39,12,1,12,Relationship with Co-Workers,3,1168,114,2021-04-22 18:00:03,2021-04-22 18:43:28.514072
7048,4913,4,4913,45,1168,45,13,1,13,General Satisfaction,3,1168,114,2021-04-22 18:00:03,2021-04-22 18:43:28.514072
7049,4914,4,4914,53,1168,53,14,1,14,Relationship with Supervisor,3,1168,114,2021-04-22 18:00:03,2021-04-22 18:43:28.514072
7050,4915,6,4915,55,1168,55,15,1,15,Company Administration,3,1168,114,2021-04-22 18:00:03,2021-04-22 18:43:28.514072
7051,4911,4,4911,35,1168,35,26,1,26,Direct Questions,3,1168,114,2021-04-22 18:00:03,2021-04-22 18:43:28.514072
7052,4917,4,4917,39,1169,39,12,1,12,Relationship with Co-Workers,3,1169,115,2021-04-22 18:00:03,2021-04-22 18:00:51.560617
7053,4918,5,4918,46,1169,46,13,1,13,General Satisfaction,3,1169,115,2021-04-22 18:00:03,2021-04-22 18:00:51.560617
7054,4919,6,4919,53,1169,53,14,1,14,Relationship with Supervisor,3,1169,115,2021-04-22 18:00:03,2021-04-22 18:00:51.560617
7055,4920,6,4920,58,1169,58,15,1,15,Company Administration,3,1169,115,2021-04-22 18:00:03,2021-04-22 18:00:51.560617
7056,4916,5,4916,36,1169,36,26,1,26,Direct Questions,3,1169,115,2021-04-22 18:00:03,2021-04-22 18:00:51.560617
7057,20057,4,20057,39,2011,39,12,1,12,Relationship with Co-Workers,3,2011,117,2021-04-27 18:00:05,2021-04-27 18:28:33.327516
7058,20058,6,20058,45,2011,45,13,1,13,General Satisfaction,3,2011,117,2021-04-27 18:00:05,2021-04-27 18:28:33.327516
7059,20059,1,20059,54,2011,54,14,1,14,Relationship with Supervisor,3,2011,117,2021-04-27 18:00:05,2021-04-27 18:28:33.327516
7060,20060,5,20060,58,2011,58,15,1,15,Company Administration,3,2011,117,2021-04-27 18:00:05,2021-04-27 18:28:33.327516
7061,20056,5,20056,34,2011,34,26,1,26,Direct Questions,3,2011,117,2021-04-27 18:00:05,2021-04-27 18:28:33.327516
7062,20062,3,20062,39,2012,39,12,1,12,Relationship with Co-Workers,3,2012,118,2021-04-27 18:00:05,2021-04-27 18:14:08.547049
7063,20063,5,20063,49,2012,49,13,1,13,General Satisfaction,3,2012,118,2021-04-27 18:00:05,2021-04-27 18:14:08.547049
7064,20065,4,20065,58,2012,58,15,1,15,Company Administration,3,2012,118,2021-04-27 18:00:05,2021-04-27 18:14:08.547049
7065,20064,5,20064,51,2012,51,15,1,15,Company Administration,3,2012,118,2021-04-27 18:00:05,2021-04-27 18:14:08.547049
7066,20061,6,20061,34,2012,34,26,1,26,Direct Questions,3,2012,118,2021-04-27 18:00:05,2021-04-27 18:14:08.547049
7067,20926,4,20926,39,2183,39,12,1,12,Relationship with Co-Workers,3,2183,107,2021-04-29 18:00:02,2021-04-29 18:11:17.850030
7068,20927,5,20927,46,2183,46,13,1,13,General Satisfaction,3,2183,107,2021-04-29 18:00:02,2021-04-29 18:11:17.850030
7069,20929,2,20929,57,2183,57,15,1,15,Company Administration,3,2183,107,2021-04-29 18:00:02,2021-04-29 18:11:17.850030
7070,20928,1,20928,52,2183,52,15,1,15,Company Administration,3,2183,107,2021-04-29 18:00:02,2021-04-29 18:11:17.850030
7071,20925,3,20925,35,2183,35,26,1,26,Direct Questions,3,2183,107,2021-04-29 18:00:02,2021-04-29 18:11:17.850030
7072,20931,4,20931,39,2184,39,12,1,12,Relationship with Co-Workers,3,2184,108,2021-04-29 18:00:02,2021-04-29 18:09:25.584449
7073,20932,4,20932,48,2184,48,13,1,13,General Satisfaction,3,2184,108,2021-04-29 18:00:02,2021-04-29 18:09:25.584449
7074,20934,4,20934,55,2184,55,15,1,15,Company Administration,3,2184,108,2021-04-29 18:00:02,2021-04-29 18:09:25.584449
7075,20933,4,20933,51,2184,51,15,1,15,Company Administration,3,2184,108,2021-04-29 18:00:02,2021-04-29 18:09:25.584449
7076,20930,4,20930,35,2184,35,26,1,26,Direct Questions,3,2184,108,2021-04-29 18:00:02,2021-04-29 18:09:25.584449
7077,21021,3,21021,39,2202,39,12,1,12,Relationship with Co-Workers,3,2202,114,2021-05-04 18:00:04,2021-05-04 18:32:37.331044
7078,21022,2,21022,46,2202,46,13,1,13,General Satisfaction,3,2202,114,2021-05-04 18:00:04,2021-05-04 18:32:37.331044
7079,21024,4,21024,58,2202,58,15,1,15,Company Administration,3,2202,114,2021-05-04 18:00:04,2021-05-04 18:32:37.331044
7080,21023,3,21023,51,2202,51,15,1,15,Company Administration,3,2202,114,2021-05-04 18:00:04,2021-05-04 18:32:37.331044
7081,21020,4,21020,36,2202,36,26,1,26,Direct Questions,3,2202,114,2021-05-04 18:00:04,2021-05-04 18:32:37.331044
7082,21950,4,21950,39,2386,39,12,1,12,Relationship with Co-Workers,3,2386,117,2021-05-06 18:00:04,2021-05-06 18:01:08.348790
7083,21951,5,21951,49,2386,49,13,1,13,General Satisfaction,3,2386,117,2021-05-06 18:00:04,2021-05-06 18:01:08.348790
7084,21953,5,21953,57,2386,57,15,1,15,Company Administration,3,2386,117,2021-05-06 18:00:04,2021-05-06 18:01:08.348790
7085,21952,5,21952,51,2386,51,15,1,15,Company Administration,3,2386,117,2021-05-06 18:00:04,2021-05-06 18:01:08.348790
7086,21949,5,21949,35,2386,35,26,1,26,Direct Questions,3,2386,117,2021-05-06 18:00:04,2021-05-06 18:01:08.348790
7087,21985,3,21985,39,2393,39,12,1,12,Relationship with Co-Workers,3,2393,112,2021-05-11 18:00:05,2021-05-11 18:35:46.641900
7088,21986,4,21986,48,2393,48,13,1,13,General Satisfaction,3,2393,112,2021-05-11 18:00:05,2021-05-11 18:35:46.641900
7089,21988,3,21988,56,2393,56,15,1,15,Company Administration,3,2393,112,2021-05-11 18:00:05,2021-05-11 18:35:46.641900
7090,21987,5,21987,52,2393,52,15,1,15,Company Administration,3,2393,112,2021-05-11 18:00:05,2021-05-11 18:35:46.641900
7091,21984,3,21984,34,2393,34,26,1,26,Direct Questions,3,2393,112,2021-05-11 18:00:05,2021-05-11 18:35:46.641900
7092,21990,2,21990,39,2394,39,12,1,12,Relationship with Co-Workers,3,2394,113,2021-05-11 18:00:05,2021-05-11 18:42:06.116989
7093,21991,5,21991,45,2394,45,13,1,13,General Satisfaction,3,2394,113,2021-05-11 18:00:05,2021-05-11 18:42:06.116989
7094,21993,5,21993,55,2394,55,15,1,15,Company Administration,3,2394,113,2021-05-11 18:00:05,2021-05-11 18:42:06.116989
7095,21992,3,21992,51,2394,51,15,1,15,Company Administration,3,2394,113,2021-05-11 18:00:05,2021-05-11 18:42:06.116989
7096,21989,2,21989,36,2394,36,26,1,26,Direct Questions,3,2394,113,2021-05-11 18:00:05,2021-05-11 18:42:06.116989
7097,22119,4,22119,39,2418,39,12,1,12,Relationship with Co-Workers,3,2418,108,2021-05-13 18:00:02,2021-05-13 18:00:52.940431
7098,22120,4,22120,48,2418,48,13,1,13,General Satisfaction,3,2418,108,2021-05-13 18:00:02,2021-05-13 18:00:52.940431
7099,22121,2,22121,54,2418,54,14,1,14,Relationship with Supervisor,3,2418,108,2021-05-13 18:00:02,2021-05-13 18:00:52.940431
7100,22122,4,22122,57,2418,57,15,1,15,Company Administration,3,2418,108,2021-05-13 18:00:02,2021-05-13 18:00:52.940431
7101,22118,4,22118,35,2418,35,26,1,26,Direct Questions,3,2418,108,2021-05-13 18:00:02,2021-05-13 18:00:52.940431
7102,22129,3,22129,39,2420,39,12,1,12,Relationship with Co-Workers,3,2420,110,2021-05-13 18:00:02,2021-05-13 18:02:45.919551
7103,22130,1,22130,47,2420,47,13,1,13,General Satisfaction,3,2420,110,2021-05-13 18:00:02,2021-05-13 18:02:45.919551
7104,22132,5,22132,57,2420,57,15,1,15,Company Administration,3,2420,110,2021-05-13 18:00:02,2021-05-13 18:02:45.919551
7105,22131,3,22131,52,2420,52,15,1,15,Company Administration,3,2420,110,2021-05-13 18:00:02,2021-05-13 18:02:45.919551
7106,22128,5,22128,34,2420,34,26,1,26,Direct Questions,3,2420,110,2021-05-13 18:00:02,2021-05-13 18:02:45.919551
7107,22159,4,22159,39,2426,39,12,1,12,Relationship with Co-Workers,3,2426,116,2021-05-13 18:00:03,2021-05-13 18:37:22.735451
7108,22160,5,22160,47,2426,47,13,1,13,General Satisfaction,3,2426,116,2021-05-13 18:00:03,2021-05-13 18:37:22.735451
7109,22162,4,22162,56,2426,56,15,1,15,Company Administration,3,2426,116,2021-05-13 18:00:03,2021-05-13 18:37:22.735451
7110,22161,3,22161,51,2426,51,15,1,15,Company Administration,3,2426,116,2021-05-13 18:00:03,2021-05-13 18:37:22.735451
7111,22158,3,22158,35,2426,35,26,1,26,Direct Questions,3,2426,116,2021-05-13 18:00:03,2021-05-13 18:37:22.735451
7112,22194,4,22194,39,2433,39,12,1,12,Relationship with Co-Workers,3,2433,111,2021-05-18 18:00:04,2021-05-18 18:39:28.537702
7113,22195,4,22195,46,2433,46,13,1,13,General Satisfaction,3,2433,111,2021-05-18 18:00:04,2021-05-18 18:39:28.537702
7114,22196,3,22196,54,2433,54,14,1,14,Relationship with Supervisor,3,2433,111,2021-05-18 18:00:04,2021-05-18 18:39:28.537702
7115,22197,2,22197,57,2433,57,15,1,15,Company Administration,3,2433,111,2021-05-18 18:00:04,2021-05-18 18:39:28.537702
7116,22193,4,22193,36,2433,36,26,1,26,Direct Questions,3,2433,111,2021-05-18 18:00:04,2021-05-18 18:39:28.537702
7117,22209,3,22209,39,2436,39,12,1,12,Relationship with Co-Workers,3,2436,114,2021-05-18 18:00:05,2021-05-18 18:42:25.517109
7118,22212,1,22212,57,2436,57,15,1,15,Company Administration,3,2436,114,2021-05-18 18:00:05,2021-05-18 18:42:25.517109
7119,22210,5,22210,44,2436,44,15,1,15,Company Administration,3,2436,114,2021-05-18 18:00:05,2021-05-18 18:42:25.517109
7120,22211,6,22211,51,2436,51,15,1,15,Company Administration,3,2436,114,2021-05-18 18:00:05,2021-05-18 18:42:25.517109
7121,22208,3,22208,36,2436,36,26,1,26,Direct Questions,3,2436,114,2021-05-18 18:00:05,2021-05-18 18:42:25.517109
7122,22219,3,22219,39,2438,39,12,1,12,Relationship with Co-Workers,3,2438,116,2021-05-18 18:00:05,2021-05-18 20:38:36.655468
7123,22220,3,22220,45,2438,45,13,1,13,General Satisfaction,3,2438,116,2021-05-18 18:00:05,2021-05-18 20:38:36.655468
7124,22221,3,22221,50,2438,50,14,1,14,Relationship with Supervisor,3,2438,116,2021-05-18 18:00:05,2021-05-18 20:38:36.655468
7125,22222,3,22222,56,2438,56,15,1,15,Company Administration,3,2438,116,2021-05-18 18:00:05,2021-05-18 20:38:36.655468
7126,22218,3,22218,36,2438,36,26,1,26,Direct Questions,3,2438,116,2021-05-18 18:00:05,2021-05-18 20:38:36.655468
7127,22368,4,22368,39,2466,39,12,1,12,Relationship with Co-Workers,3,2466,115,2021-05-20 18:00:03,2021-05-20 18:06:26.040029
7128,22369,4,22369,46,2466,46,13,1,13,General Satisfaction,3,2466,115,2021-05-20 18:00:03,2021-05-20 18:06:26.040029
7129,22370,3,22370,54,2466,54,14,1,14,Relationship with Supervisor,3,2466,115,2021-05-20 18:00:03,2021-05-20 18:06:26.040029
7130,22371,3,22371,56,2466,56,15,1,15,Company Administration,3,2466,115,2021-05-20 18:00:03,2021-05-20 18:06:26.040029
7131,22367,4,22367,34,2466,34,26,1,26,Direct Questions,3,2466,115,2021-05-20 18:00:03,2021-05-20 18:06:26.040029
7132,22433,3,22433,39,2479,39,12,1,12,Relationship with Co-Workers,3,2479,116,2021-05-25 18:00:03,2021-05-25 18:33:47.762447
7133,22434,4,22434,48,2479,48,13,1,13,General Satisfaction,3,2479,116,2021-05-25 18:00:03,2021-05-25 18:33:47.762447
7134,22435,4,22435,50,2479,50,14,1,14,Relationship with Supervisor,3,2479,116,2021-05-25 18:00:03,2021-05-25 18:33:47.762447
7135,22436,4,22436,56,2479,56,15,1,15,Company Administration,3,2479,116,2021-05-25 18:00:03,2021-05-25 18:33:47.762447
7136,22432,4,22432,35,2479,35,26,1,26,Direct Questions,3,2479,116,2021-05-25 18:00:03,2021-05-25 18:33:47.762447
7137,22572,2,22572,39,2505,39,12,1,12,Relationship with Co-Workers,3,2505,113,2021-05-27 18:00:03,2021-05-27 18:43:19.186788
7138,22573,5,22573,49,2505,49,13,1,13,General Satisfaction,3,2505,113,2021-05-27 18:00:03,2021-05-27 18:43:19.186788
7139,22574,3,22574,50,2505,50,14,1,14,Relationship with Supervisor,3,2505,113,2021-05-27 18:00:03,2021-05-27 18:43:19.186788
7140,22575,5,22575,55,2505,55,15,1,15,Company Administration,3,2505,113,2021-05-27 18:00:03,2021-05-27 18:43:19.186788
7141,22571,3,22571,35,2505,35,26,1,26,Direct Questions,3,2505,113,2021-05-27 18:00:03,2021-05-27 18:43:19.186788
7142,100223,3,100223,39,10041,39,12,1,12,Relationship with Co-Workers,3,10041,111,2021-06-03 18:00:02,2021-06-04 00:09:44.718386
7143,100224,4,100224,47,10041,47,13,1,13,General Satisfaction,3,10041,111,2021-06-03 18:00:02,2021-06-04 00:09:44.718386
7144,100225,4,100225,53,10041,53,14,1,14,Relationship with Supervisor,3,10041,111,2021-06-03 18:00:02,2021-06-04 00:09:44.718386
7145,100226,5,100226,55,10041,55,15,1,15,Company Administration,3,10041,111,2021-06-03 18:00:02,2021-06-04 00:09:44.718386
7146,100222,4,100222,36,10041,36,26,1,26,Direct Questions,3,10041,111,2021-06-03 18:00:02,2021-06-04 00:09:44.718386
7147,100379,4,100379,39,10077,39,12,1,12,Relationship with Co-Workers,3,10077,111,2021-06-08 18:00:02,2021-06-08 18:40:45.548791
7148,100380,5,100380,47,10077,47,13,1,13,General Satisfaction,3,10077,111,2021-06-08 18:00:02,2021-06-08 18:40:45.548791
7149,100381,5,100381,53,10077,53,14,1,14,Relationship with Supervisor,3,10077,111,2021-06-08 18:00:02,2021-06-08 18:40:45.548791
7150,100382,4,100382,55,10077,55,15,1,15,Company Administration,3,10077,111,2021-06-08 18:00:02,2021-06-08 18:40:45.548791
7151,100378,5,100378,35,10077,35,26,1,26,Direct Questions,3,10077,111,2021-06-08 18:00:02,2021-06-08 18:40:45.548791
7152,100399,4,100399,39,10081,39,12,1,12,Relationship with Co-Workers,3,10081,115,2021-06-08 18:00:03,2021-06-08 18:11:30.794611
7153,100400,4,100400,45,10081,45,13,1,13,General Satisfaction,3,10081,115,2021-06-08 18:00:03,2021-06-08 18:11:30.794611
7154,100401,4,100401,53,10081,53,14,1,14,Relationship with Supervisor,3,10081,115,2021-06-08 18:00:03,2021-06-08 18:11:30.794611
7155,100402,4,100402,57,10081,57,15,1,15,Company Administration,3,10081,115,2021-06-08 18:00:03,2021-06-08 18:11:30.794611
7156,100398,4,100398,34,10081,34,26,1,26,Direct Questions,3,10081,115,2021-06-08 18:00:03,2021-06-08 18:11:30.794611
7157,100605,4,100605,39,10125,39,12,1,12,Relationship with Co-Workers,3,10125,107,2021-06-10 18:00:02,2021-06-10 23:50:26.826897
7158,100606,5,100606,46,10125,46,13,1,13,General Satisfaction,3,10125,107,2021-06-10 18:00:02,2021-06-10 23:50:26.826897
7159,100608,4,100608,57,10125,57,15,1,15,Company Administration,3,10125,107,2021-06-10 18:00:02,2021-06-10 23:50:26.826897
7160,100607,3,100607,52,10125,52,15,1,15,Company Administration,3,10125,107,2021-06-10 18:00:02,2021-06-10 23:50:26.826897
7161,100604,4,100604,35,10125,35,26,1,26,Direct Questions,3,10125,107,2021-06-10 18:00:02,2021-06-10 23:50:26.826897
7162,100615,4,100615,39,10127,39,12,1,12,Relationship with Co-Workers,3,10127,109,2021-06-10 18:00:02,2021-06-10 18:36:02.648482
7163,100617,3,100617,53,10127,53,14,1,14,Relationship with Supervisor,3,10127,109,2021-06-10 18:00:02,2021-06-10 18:36:02.648482
7164,100618,3,100618,58,10127,58,15,1,15,Company Administration,3,10127,109,2021-06-10 18:00:02,2021-06-10 18:36:02.648482
7165,100616,3,100616,44,10127,44,15,1,15,Company Administration,3,10127,109,2021-06-10 18:00:02,2021-06-10 18:36:02.648482
7166,100614,2,100614,34,10127,34,26,1,26,Direct Questions,3,10127,109,2021-06-10 18:00:02,2021-06-10 18:36:02.648482
7167,100640,3,100640,39,10132,39,12,1,12,Relationship with Co-Workers,3,10132,114,2021-06-10 18:00:03,2021-06-10 18:35:11.421338
7168,100641,1,100641,46,10132,46,13,1,13,General Satisfaction,3,10132,114,2021-06-10 18:00:03,2021-06-10 18:35:11.421338
7169,100643,5,100643,58,10132,58,15,1,15,Company Administration,3,10132,114,2021-06-10 18:00:03,2021-06-10 18:35:11.421338
7170,100642,4,100642,51,10132,51,15,1,15,Company Administration,3,10132,114,2021-06-10 18:00:03,2021-06-10 18:35:11.421338
7171,100639,4,100639,34,10132,34,26,1,26,Direct Questions,3,10132,114,2021-06-10 18:00:03,2021-06-10 18:35:11.421338
7172,100685,5,100685,39,10141,39,12,1,12,Relationship with Co-Workers,3,10141,111,2021-06-15 18:00:04,2021-06-15 18:04:48.214516
7173,100686,4,100686,47,10141,47,13,1,13,General Satisfaction,3,10141,111,2021-06-15 18:00:04,2021-06-15 18:04:48.214516
7174,100688,2,100688,57,10141,57,15,1,15,Company Administration,3,10141,111,2021-06-15 18:00:04,2021-06-15 18:04:48.214516
7175,100687,4,100687,51,10141,51,15,1,15,Company Administration,3,10141,111,2021-06-15 18:00:04,2021-06-15 18:04:48.214516
7176,100684,4,100684,35,10141,35,26,1,26,Direct Questions,3,10141,111,2021-06-15 18:00:04,2021-06-15 18:04:48.214516
7177,100710,3,100710,39,10146,39,12,1,12,Relationship with Co-Workers,3,10146,116,2021-06-15 18:00:05,2021-06-15 18:36:02.152557
7178,100711,3,100711,48,10146,48,13,1,13,General Satisfaction,3,10146,116,2021-06-15 18:00:05,2021-06-15 18:36:02.152557
7179,100713,4,100713,57,10146,57,15,1,15,Company Administration,3,10146,116,2021-06-15 18:00:05,2021-06-15 18:36:02.152557
7180,100712,3,100712,52,10146,52,15,1,15,Company Administration,3,10146,116,2021-06-15 18:00:05,2021-06-15 18:36:02.152557
7181,100709,3,100709,35,10146,35,26,1,26,Direct Questions,3,10146,116,2021-06-15 18:00:05,2021-06-15 18:36:02.152557
7182,100720,3,100720,39,10148,39,12,1,12,Relationship with Co-Workers,3,10148,118,2021-06-15 18:00:05,2021-06-15 19:30:13.012921
7183,100721,4,100721,46,10148,46,13,1,13,General Satisfaction,3,10148,118,2021-06-15 18:00:05,2021-06-15 19:30:13.012921
7184,100722,4,100722,50,10148,50,14,1,14,Relationship with Supervisor,3,10148,118,2021-06-15 18:00:05,2021-06-15 19:30:13.012921
7185,100723,4,100723,56,10148,56,15,1,15,Company Administration,3,10148,118,2021-06-15 18:00:05,2021-06-15 19:30:13.012921
7186,100719,5,100719,36,10148,36,26,1,26,Direct Questions,3,10148,118,2021-06-15 18:00:05,2021-06-15 19:30:13.012921
7187,100929,5,100929,39,10193,39,12,1,12,Relationship with Co-Workers,3,10193,109,2021-06-17 18:00:02,2021-06-17 18:05:03.771934
7188,100930,3,100930,45,10193,45,13,1,13,General Satisfaction,3,10193,109,2021-06-17 18:00:02,2021-06-17 18:05:03.771934
7189,100931,3,100931,54,10193,54,14,1,14,Relationship with Supervisor,3,10193,109,2021-06-17 18:00:02,2021-06-17 18:05:03.771934
7190,100932,4,100932,58,10193,58,15,1,15,Company Administration,3,10193,109,2021-06-17 18:00:02,2021-06-17 18:05:03.771934
7191,100928,3,100928,35,10193,35,26,1,26,Direct Questions,3,10193,109,2021-06-17 18:00:02,2021-06-17 18:05:03.771934
7192,100954,3,100954,39,10198,39,12,1,12,Relationship with Co-Workers,3,10198,114,2021-06-17 18:00:03,2021-06-17 18:06:29.050254
7193,100955,4,100955,45,10198,45,13,1,13,General Satisfaction,3,10198,114,2021-06-17 18:00:03,2021-06-17 18:06:29.050254
7194,100956,6,100956,50,10198,50,14,1,14,Relationship with Supervisor,3,10198,114,2021-06-17 18:00:03,2021-06-17 18:06:29.050254
7195,100957,4,100957,55,10198,55,15,1,15,Company Administration,3,10198,114,2021-06-17 18:00:03,2021-06-17 18:06:29.050254
7196,100953,4,100953,35,10198,35,26,1,26,Direct Questions,3,10198,114,2021-06-17 18:00:03,2021-06-17 18:06:29.050254
7197,100959,4,100959,39,10199,39,12,1,12,Relationship with Co-Workers,3,10199,115,2021-06-17 18:00:03,2021-06-17 18:01:38.659773
7198,100960,4,100960,46,10199,46,13,1,13,General Satisfaction,3,10199,115,2021-06-17 18:00:03,2021-06-17 18:01:38.659773
7199,100961,3,100961,54,10199,54,14,1,14,Relationship with Supervisor,3,10199,115,2021-06-17 18:00:03,2021-06-17 18:01:38.659773
7200,100962,3,100962,56,10199,56,15,1,15,Company Administration,3,10199,115,2021-06-17 18:00:03,2021-06-17 18:01:38.659773
7201,100958,4,100958,34,10199,34,26,1,26,Direct Questions,3,10199,115,2021-06-17 18:00:03,2021-06-17 18:01:38.659773
7202,101024,3,101024,39,10212,39,12,1,12,Relationship with Co-Workers,3,10212,116,2021-06-22 18:00:04,2021-06-22 21:20:56.372620
7203,101025,4,101025,46,10212,46,13,1,13,General Satisfaction,3,10212,116,2021-06-22 18:00:04,2021-06-22 21:20:56.372620
7204,101026,3,101026,53,10212,53,14,1,14,Relationship with Supervisor,3,10212,116,2021-06-22 18:00:04,2021-06-22 21:20:56.372620
7205,101027,3,101027,58,10212,58,15,1,15,Company Administration,3,10212,116,2021-06-22 18:00:04,2021-06-22 21:20:56.372620
7206,101023,3,101023,34,10212,34,26,1,26,Direct Questions,3,10212,116,2021-06-22 18:00:04,2021-06-22 21:20:56.372620
7207,101313,4,101313,39,10273,39,12,1,12,Relationship with Co-Workers,3,10273,111,2021-06-29 18:00:03,2021-06-29 18:34:05.025070
7208,101315,5,101315,54,10273,54,14,1,14,Relationship with Supervisor,3,10273,111,2021-06-29 18:00:03,2021-06-29 18:34:05.025070
7209,101316,2,101316,58,10273,58,15,1,15,Company Administration,3,10273,111,2021-06-29 18:00:03,2021-06-29 18:34:05.025070
7210,101314,3,101314,44,10273,44,15,1,15,Company Administration,3,10273,111,2021-06-29 18:00:03,2021-06-29 18:34:05.025070
7211,101312,4,101312,35,10273,35,26,1,26,Direct Questions,3,10273,111,2021-06-29 18:00:03,2021-06-29 18:34:05.025070
7212,101547,4,101547,39,10323,39,12,1,12,Relationship with Co-Workers,3,10323,107,2021-07-01 18:00:02,2021-07-01 18:57:12.323010
7213,101548,5,101548,46,10323,46,13,1,13,General Satisfaction,3,10323,107,2021-07-01 18:00:02,2021-07-01 18:57:12.323010
7214,101549,4,101549,50,10323,50,14,1,14,Relationship with Supervisor,3,10323,107,2021-07-01 18:00:02,2021-07-01 18:57:12.323010
7215,101550,4,101550,57,10323,57,15,1,15,Company Administration,3,10323,107,2021-07-01 18:00:02,2021-07-01 18:57:12.323010
7216,101546,4,101546,34,10323,34,26,1,26,Direct Questions,3,10323,107,2021-07-01 18:00:02,2021-07-01 18:57:12.323010
7217,101602,3,101602,39,10334,39,12,1,12,Relationship with Co-Workers,3,10334,118,2021-07-01 18:00:04,2021-07-01 18:47:12.727620
7218,101603,3,101603,46,10334,46,13,1,13,General Satisfaction,3,10334,118,2021-07-01 18:00:04,2021-07-01 18:47:12.727620
7219,101605,3,101605,58,10334,58,15,1,15,Company Administration,3,10334,118,2021-07-01 18:00:04,2021-07-01 18:47:12.727620
7220,101604,4,101604,52,10334,52,15,1,15,Company Administration,3,10334,118,2021-07-01 18:00:04,2021-07-01 18:47:12.727620
7221,101601,4,101601,34,10334,34,26,1,26,Direct Questions,3,10334,118,2021-07-01 18:00:04,2021-07-01 18:47:12.727620
7222,101627,4,101627,39,10339,39,12,1,12,Relationship with Co-Workers,3,10339,111,2021-07-06 18:00:03,2021-07-06 18:40:23.973168
7223,101628,5,101628,49,10339,49,13,1,13,General Satisfaction,3,10339,111,2021-07-06 18:00:03,2021-07-06 18:40:23.973168
7224,101630,4,101630,57,10339,57,15,1,15,Company Administration,3,10339,111,2021-07-06 18:00:03,2021-07-06 18:40:23.973168
7225,101629,4,101629,51,10339,51,15,1,15,Company Administration,3,10339,111,2021-07-06 18:00:03,2021-07-06 18:40:23.973168
7226,101626,4,101626,36,10339,36,26,1,26,Direct Questions,3,10339,111,2021-07-06 18:00:03,2021-07-06 18:40:23.973168
7227,101866,3,101866,39,10390,39,12,1,12,Relationship with Co-Workers,3,10390,108,2021-07-08 18:00:01,2021-07-08 18:47:31.474133
7228,101867,4,101867,47,10390,47,13,1,13,General Satisfaction,3,10390,108,2021-07-08 18:00:01,2021-07-08 18:47:31.474133
7229,101868,3,101868,54,10390,54,14,1,14,Relationship with Supervisor,3,10390,108,2021-07-08 18:00:01,2021-07-08 18:47:31.474133
7230,101869,4,101869,57,10390,57,15,1,15,Company Administration,3,10390,108,2021-07-08 18:00:01,2021-07-08 18:47:31.474133
7231,101865,4,101865,35,10390,35,26,1,26,Direct Questions,3,10390,108,2021-07-08 18:00:01,2021-07-08 18:47:31.474133
7232,101901,6,101901,39,10397,39,12,1,12,Relationship with Co-Workers,3,10397,115,2021-07-08 18:00:03,2021-07-08 18:00:45.977150
7233,101904,6,101904,58,10397,58,15,1,15,Company Administration,3,10397,115,2021-07-08 18:00:03,2021-07-08 18:00:45.977150
7234,101902,1,101902,44,10397,44,15,1,15,Company Administration,3,10397,115,2021-07-08 18:00:03,2021-07-08 18:00:45.977150
7235,101903,6,101903,51,10397,51,15,1,15,Company Administration,3,10397,115,2021-07-08 18:00:03,2021-07-08 18:00:45.977150
7236,101900,6,101900,35,10397,35,26,1,26,Direct Questions,3,10397,115,2021-07-08 18:00:03,2021-07-08 18:00:45.977150
7237,101906,2,101906,39,10398,39,12,1,12,Relationship with Co-Workers,3,10398,116,2021-07-08 18:00:03,2021-07-08 18:35:26.049694
7238,101907,3,101907,46,10398,46,13,1,13,General Satisfaction,3,10398,116,2021-07-08 18:00:03,2021-07-08 18:35:26.049694
7239,101909,2,101909,57,10398,57,15,1,15,Company Administration,3,10398,116,2021-07-08 18:00:03,2021-07-08 18:35:26.049694
7240,101908,2,101908,51,10398,51,15,1,15,Company Administration,3,10398,116,2021-07-08 18:00:03,2021-07-08 18:35:26.049694
7241,101905,3,101905,35,10398,35,26,1,26,Direct Questions,3,10398,116,2021-07-08 18:00:03,2021-07-08 18:35:26.049694
7242,20461,5,20461,82,2092,82,16,1,16,Company Administration,4,2092,119,2021-04-28 21:18:53,2021-04-28 21:20:25.779022
7243,20462,5,20462,76,2092,76,17,1,17,Relationship with Lead,4,2092,119,2021-04-28 21:18:53,2021-04-28 21:20:25.779022
7244,20463,5,20463,70,2092,70,18,1,18,General Satisfaction,4,2092,119,2021-04-28 21:18:53,2021-04-28 21:20:25.779022
7245,20464,2,20464,67,2092,67,19,0,19,Relationship with Co-workers,4,2092,119,2021-04-28 21:18:53,2021-04-28 21:20:25.779022
7246,20465,5,20465,61,2092,61,20,1,20,Compensation and Benefits,4,2092,119,2021-04-28 21:18:53,2021-04-28 21:20:25.779022
7247,20466,5,20466,85,2092,85,21,1,21,Relationship with Manager,4,2092,119,2021-04-28 21:18:53,2021-04-28 21:20:25.779022
7248,20473,5,20473,82,2094,82,16,1,16,Company Administration,4,2094,121,2021-04-28 21:18:53,2021-04-29 19:28:05.761541
7249,20474,3,20474,77,2094,77,17,0,17,Relationship with Lead,4,2094,121,2021-04-28 21:18:53,2021-04-29 19:28:05.761541
7250,20475,5,20475,72,2094,72,18,1,18,General Satisfaction,4,2094,121,2021-04-28 21:18:53,2021-04-29 19:28:05.761541
7251,20476,3,20476,67,2094,67,19,0,19,Relationship with Co-workers,4,2094,121,2021-04-28 21:18:53,2021-04-29 19:28:05.761541
7252,20477,5,20477,59,2094,59,20,1,20,Compensation and Benefits,4,2094,121,2021-04-28 21:18:53,2021-04-29 19:28:05.761541
7253,20478,2,20478,88,2094,88,21,0,21,Relationship with Manager,4,2094,121,2021-04-28 21:18:53,2021-04-29 19:28:05.761541
7254,20485,6,20485,82,2096,82,16,1,16,Company Administration,4,2096,123,2021-04-28 21:18:54,2021-04-29 15:28:51.849622
7255,20486,1,20486,77,2096,77,17,0,17,Relationship with Lead,4,2096,123,2021-04-28 21:18:54,2021-04-29 15:28:51.849622
7256,20487,1,20487,70,2096,70,18,1,18,General Satisfaction,4,2096,123,2021-04-28 21:18:54,2021-04-29 15:28:51.849622
7257,20488,6,20488,67,2096,67,19,0,19,Relationship with Co-workers,4,2096,123,2021-04-28 21:18:54,2021-04-29 15:28:51.849622
7258,20489,2,20489,60,2096,60,20,1,20,Compensation and Benefits,4,2096,123,2021-04-28 21:18:54,2021-04-29 15:28:51.849622
7259,20490,6,20490,87,2096,87,21,1,21,Relationship with Manager,4,2096,123,2021-04-28 21:18:54,2021-04-29 15:28:51.849622
7260,20497,6,20497,82,2098,82,16,1,16,Company Administration,4,2098,125,2021-04-28 21:18:54,2021-04-28 21:25:27.172504
7261,20498,6,20498,79,2098,79,17,0,17,Relationship with Lead,4,2098,125,2021-04-28 21:18:54,2021-04-28 21:25:27.172504
7262,20499,6,20499,70,2098,70,18,1,18,General Satisfaction,4,2098,125,2021-04-28 21:18:54,2021-04-28 21:25:27.172504
7263,20500,6,20500,67,2098,67,19,0,19,Relationship with Co-workers,4,2098,125,2021-04-28 21:18:54,2021-04-28 21:25:27.172504
7264,20501,6,20501,62,2098,62,20,1,20,Compensation and Benefits,4,2098,125,2021-04-28 21:18:54,2021-04-28 21:25:27.172504
7265,20502,6,20502,84,2098,84,21,1,21,Relationship with Manager,4,2098,125,2021-04-28 21:18:54,2021-04-28 21:25:27.172504
7266,21487,6,21487,82,2294,82,16,1,16,Company Administration,4,2294,126,2021-05-05 18:10:03,2021-05-05 19:06:05.291131
7267,21488,6,21488,79,2294,79,17,0,17,Relationship with Lead,4,2294,126,2021-05-05 18:10:03,2021-05-05 19:06:05.291131
7268,21489,5,21489,74,2294,74,18,1,18,General Satisfaction,4,2294,126,2021-05-05 18:10:03,2021-05-05 19:06:05.291131
7269,21490,3,21490,67,2294,67,19,0,19,Relationship with Co-workers,4,2294,126,2021-05-05 18:10:03,2021-05-05 19:06:05.291131
7270,21491,4,21491,59,2294,59,20,1,20,Compensation and Benefits,4,2294,126,2021-05-05 18:10:03,2021-05-05 19:06:05.291131
7271,21492,6,21492,88,2294,88,21,0,21,Relationship with Manager,4,2294,126,2021-05-05 18:10:03,2021-05-05 19:06:05.291131
7272,22253,5,22253,82,2445,82,16,1,16,Company Administration,4,2445,119,2021-05-19 18:10:02,2021-05-19 18:11:10.497677
7273,22254,6,22254,77,2445,77,17,0,17,Relationship with Lead,4,2445,119,2021-05-19 18:10:02,2021-05-19 18:11:10.497677
7274,22255,5,22255,71,2445,71,18,1,18,General Satisfaction,4,2445,119,2021-05-19 18:10:02,2021-05-19 18:11:10.497677
7275,22256,6,22256,68,2445,68,19,0,19,Relationship with Co-workers,4,2445,119,2021-05-19 18:10:02,2021-05-19 18:11:10.497677
7276,22257,5,22257,61,2445,61,20,1,20,Compensation and Benefits,4,2445,119,2021-05-19 18:10:02,2021-05-19 18:11:10.497677
7277,22258,5,22258,85,2445,85,21,1,21,Relationship with Manager,4,2445,119,2021-05-19 18:10:02,2021-05-19 18:11:10.497677
7278,22301,6,22301,82,2453,82,16,1,16,Company Administration,4,2453,127,2021-05-19 18:10:03,2021-05-19 18:56:27.878015
7279,22302,6,22302,77,2453,77,17,0,17,Relationship with Lead,4,2453,127,2021-05-19 18:10:03,2021-05-19 18:56:27.878015
7280,22303,5,22303,73,2453,73,18,1,18,General Satisfaction,4,2453,127,2021-05-19 18:10:03,2021-05-19 18:56:27.878015
7281,22304,5,22304,65,2453,65,19,1,19,Relationship with Co-workers,4,2453,127,2021-05-19 18:10:03,2021-05-19 18:56:27.878015
7282,22305,6,22305,63,2453,63,20,1,20,Compensation and Benefits,4,2453,127,2021-05-19 18:10:03,2021-05-19 18:56:27.878015
7283,22306,6,22306,86,2453,86,21,0,21,Relationship with Manager,4,2453,127,2021-05-19 18:10:03,2021-05-19 18:56:27.878015
7284,22503,6,22503,82,2492,82,16,1,16,Company Administration,4,2492,125,2021-05-26 18:10:02,2021-05-26 18:26:24.980664
7285,22504,6,22504,77,2492,77,17,0,17,Relationship with Lead,4,2492,125,2021-05-26 18:10:02,2021-05-26 18:26:24.980664
7286,22505,6,22505,69,2492,69,18,0,18,General Satisfaction,4,2492,125,2021-05-26 18:10:02,2021-05-26 18:26:24.980664
7287,22506,6,22506,68,2492,68,19,0,19,Relationship with Co-workers,4,2492,125,2021-05-26 18:10:02,2021-05-26 18:26:24.980664
7288,22507,3,22507,59,2492,59,20,1,20,Compensation and Benefits,4,2492,125,2021-05-26 18:10:02,2021-05-26 18:26:24.980664
7289,22508,6,22508,86,2492,86,21,0,21,Relationship with Manager,4,2492,125,2021-05-26 18:10:02,2021-05-26 18:26:24.980664
7290,22509,6,22509,82,2493,82,16,1,16,Company Administration,4,2493,126,2021-05-26 18:10:02,2021-05-26 18:23:00.343920
7291,22510,6,22510,79,2493,79,17,0,17,Relationship with Lead,4,2493,126,2021-05-26 18:10:02,2021-05-26 18:23:00.343920
7292,22511,5,22511,72,2493,72,18,1,18,General Satisfaction,4,2493,126,2021-05-26 18:10:02,2021-05-26 18:23:00.343920
7293,22512,5,22512,68,2493,68,19,0,19,Relationship with Co-workers,4,2493,126,2021-05-26 18:10:02,2021-05-26 18:23:00.343920
7294,22513,4,22513,60,2493,60,20,1,20,Compensation and Benefits,4,2493,126,2021-05-26 18:10:02,2021-05-26 18:23:00.343920
7295,22514,6,22514,84,2493,84,21,1,21,Relationship with Manager,4,2493,126,2021-05-26 18:10:02,2021-05-26 18:23:00.343920
7296,100127,6,100127,82,10024,82,16,1,16,Company Administration,4,10024,127,2021-06-02 18:10:02,2021-06-02 18:42:14.940558
7297,100128,6,100128,76,10024,76,17,1,17,Relationship with Lead,4,10024,127,2021-06-02 18:10:02,2021-06-02 18:42:14.940558
7298,100129,6,100129,72,10024,72,18,1,18,General Satisfaction,4,10024,127,2021-06-02 18:10:02,2021-06-02 18:42:14.940558
7299,100130,6,100130,67,10024,67,19,0,19,Relationship with Co-workers,4,10024,127,2021-06-02 18:10:02,2021-06-02 18:42:14.940558
7300,100131,5,100131,59,10024,59,20,1,20,Compensation and Benefits,4,10024,127,2021-06-02 18:10:02,2021-06-02 18:42:14.940558
7301,100132,6,100132,87,10024,87,21,1,21,Relationship with Manager,4,10024,127,2021-06-02 18:10:02,2021-06-02 18:42:14.940558
7302,100151,5,100151,82,10028,82,16,1,16,Company Administration,4,10028,122,2021-06-02 19:00:02,2021-06-02 19:08:49.125811
7303,100152,3,100152,76,10028,76,17,1,17,Relationship with Lead,4,10028,122,2021-06-02 19:00:02,2021-06-02 19:08:49.125811
7304,100153,5,100153,74,10028,74,18,1,18,General Satisfaction,4,10028,122,2021-06-02 19:00:02,2021-06-02 19:08:49.125811
7305,100154,5,100154,66,10028,66,19,1,19,Relationship with Co-workers,4,10028,122,2021-06-02 19:00:02,2021-06-02 19:08:49.125811
7306,100155,5,100155,63,10028,63,20,1,20,Compensation and Benefits,4,10028,122,2021-06-02 19:00:02,2021-06-02 19:08:49.125811
7307,100156,6,100156,84,10028,84,21,1,21,Relationship with Manager,4,10028,122,2021-06-02 19:00:02,2021-06-02 19:08:49.125811
7308,100480,6,100480,82,10096,82,16,1,16,Company Administration,4,10096,126,2021-06-09 18:10:02,2021-06-09 19:07:46.262012
7309,100481,6,100481,79,10096,79,17,0,17,Relationship with Lead,4,10096,126,2021-06-09 18:10:02,2021-06-09 19:07:46.262012
7310,100482,6,100482,71,10096,71,18,1,18,General Satisfaction,4,10096,126,2021-06-09 18:10:02,2021-06-09 19:07:46.262012
7311,100483,5,100483,68,10096,68,19,0,19,Relationship with Co-workers,4,10096,126,2021-06-09 18:10:02,2021-06-09 19:07:46.262012
7312,100484,6,100484,62,10096,62,20,1,20,Compensation and Benefits,4,10096,126,2021-06-09 18:10:02,2021-06-09 19:07:46.262012
7313,100485,6,100485,84,10096,84,21,1,21,Relationship with Manager,4,10096,126,2021-06-09 18:10:02,2021-06-09 19:07:46.262012
7314,101686,6,101686,82,10351,82,16,1,16,Company Administration,4,10351,119,2021-07-07 18:10:01,2021-07-07 19:05:31.194985
7315,101687,6,101687,76,10351,76,17,1,17,Relationship with Lead,4,10351,119,2021-07-07 18:10:01,2021-07-07 19:05:31.194985
7316,101688,6,101688,69,10351,69,18,0,18,General Satisfaction,4,10351,119,2021-07-07 18:10:01,2021-07-07 19:05:31.194985
7317,101689,5,101689,65,10351,65,19,1,19,Relationship with Co-workers,4,10351,119,2021-07-07 18:10:01,2021-07-07 19:05:31.194985
7318,101690,6,101690,60,10351,60,20,1,20,Compensation and Benefits,4,10351,119,2021-07-07 18:10:01,2021-07-07 19:05:31.194985
7319,101691,6,101691,85,10351,85,21,1,21,Relationship with Manager,4,10351,119,2021-07-07 18:10:01,2021-07-07 19:05:31.194985
7320,101716,3,101716,82,10356,82,16,1,16,Company Administration,4,10356,124,2021-07-07 18:10:02,2021-07-08 15:20:27.048575
7321,101717,5,101717,79,10356,79,17,0,17,Relationship with Lead,4,10356,124,2021-07-07 18:10:02,2021-07-08 15:20:27.048575
7322,101718,2,101718,70,10356,70,18,1,18,General Satisfaction,4,10356,124,2021-07-07 18:10:02,2021-07-08 15:20:27.048575
7323,101719,1,101719,67,10356,67,19,0,19,Relationship with Co-workers,4,10356,124,2021-07-07 18:10:02,2021-07-08 15:20:27.048575
7324,101720,1,101720,59,10356,59,20,1,20,Compensation and Benefits,4,10356,124,2021-07-07 18:10:02,2021-07-08 15:20:27.048575
7325,101721,3,101721,85,10356,85,21,1,21,Relationship with Manager,4,10356,124,2021-07-07 18:10:02,2021-07-08 15:20:27.048575
7326,101988,6,101988,82,10413,82,16,1,16,Company Administration,4,10413,127,2021-07-14 18:10:03,2021-07-14 18:23:08.046787
7327,101989,6,101989,76,10413,76,17,1,17,Relationship with Lead,4,10413,127,2021-07-14 18:10:03,2021-07-14 18:23:08.046787
7328,101990,6,101990,71,10413,71,18,1,18,General Satisfaction,4,10413,127,2021-07-14 18:10:03,2021-07-14 18:23:08.046787
7329,101991,5,101991,64,10413,64,19,1,19,Relationship with Co-workers,4,10413,127,2021-07-14 18:10:03,2021-07-14 18:23:08.046787
7330,101992,5,101992,61,10413,61,20,1,20,Compensation and Benefits,4,10413,127,2021-07-14 18:10:03,2021-07-14 18:23:08.046787
7331,101993,6,101993,85,10413,85,21,1,21,Relationship with Manager,4,10413,127,2021-07-14 18:10:03,2021-07-14 18:23:08.046787
7332,20467,5,20467,81,2093,81,16,0,16,Company Administration,4,2093,120,2021-04-28 21:18:53,2021-04-29 15:31:52.717581
7333,20468,3,20468,78,2093,78,17,1,17,Relationship with Lead,4,2093,120,2021-04-28 21:18:53,2021-04-29 15:31:52.717581
7334,20469,5,20469,74,2093,74,18,1,18,General Satisfaction,4,2093,120,2021-04-28 21:18:53,2021-04-29 15:31:52.717581
7335,20470,4,20470,67,2093,67,19,0,19,Relationship with Co-workers,4,2093,120,2021-04-28 21:18:53,2021-04-29 15:31:52.717581
7336,20471,2,20471,60,2093,60,20,1,20,Compensation and Benefits,4,2093,120,2021-04-28 21:18:53,2021-04-29 15:31:52.717581
7337,20472,6,20472,84,2093,84,21,1,21,Relationship with Manager,4,2093,120,2021-04-28 21:18:53,2021-04-29 15:31:52.717581
7338,21469,6,21469,81,2291,81,16,0,16,Company Administration,4,2291,123,2021-05-05 18:10:03,2021-05-06 17:22:12.936134
7339,21470,6,21470,78,2291,78,17,1,17,Relationship with Lead,4,2291,123,2021-05-05 18:10:03,2021-05-06 17:22:12.936134
7340,21471,6,21471,72,2291,72,18,1,18,General Satisfaction,4,2291,123,2021-05-05 18:10:03,2021-05-06 17:22:12.936134
7341,21472,1,21472,67,2291,67,19,0,19,Relationship with Co-workers,4,2291,123,2021-05-05 18:10:03,2021-05-06 17:22:12.936134
7342,21473,2,21473,60,2291,60,20,1,20,Compensation and Benefits,4,2291,123,2021-05-05 18:10:03,2021-05-06 17:22:12.936134
7343,21474,6,21474,88,2291,88,21,0,21,Relationship with Manager,4,2291,123,2021-05-05 18:10:03,2021-05-06 17:22:12.936134
7344,21493,6,21493,81,2295,81,16,0,16,Company Administration,4,2295,127,2021-05-05 18:10:03,2021-05-05 19:03:20.005852
7345,21494,6,21494,76,2295,76,17,1,17,Relationship with Lead,4,2295,127,2021-05-05 18:10:03,2021-05-05 19:03:20.005852
7346,21495,6,21495,71,2295,71,18,1,18,General Satisfaction,4,2295,127,2021-05-05 18:10:03,2021-05-05 19:03:20.005852
7347,21496,6,21496,64,2295,64,19,1,19,Relationship with Co-workers,4,2295,127,2021-05-05 18:10:03,2021-05-05 19:03:20.005852
7348,21497,5,21497,60,2295,60,20,1,20,Compensation and Benefits,4,2295,127,2021-05-05 18:10:03,2021-05-05 19:03:20.005852
7349,21498,6,21498,88,2295,88,21,0,21,Relationship with Manager,4,2295,127,2021-05-05 18:10:03,2021-05-05 19:03:20.005852
7350,22063,6,22063,81,2408,81,16,0,16,Company Administration,4,2408,123,2021-05-12 18:10:02,2021-05-13 02:31:44.171981
7351,22064,4,22064,79,2408,79,17,0,17,Relationship with Lead,4,2408,123,2021-05-12 18:10:02,2021-05-13 02:31:44.171981
7352,22065,4,22065,74,2408,74,18,1,18,General Satisfaction,4,2408,123,2021-05-12 18:10:02,2021-05-13 02:31:44.171981
7353,22066,4,22066,64,2408,64,19,1,19,Relationship with Co-workers,4,2408,123,2021-05-12 18:10:02,2021-05-13 02:31:44.171981
7354,22067,3,22067,62,2408,62,20,1,20,Compensation and Benefits,4,2408,123,2021-05-12 18:10:02,2021-05-13 02:31:44.171981
7355,22068,6,22068,84,2408,84,21,1,21,Relationship with Manager,4,2408,123,2021-05-12 18:10:02,2021-05-13 02:31:44.171981
7356,22081,6,22081,81,2411,81,16,0,16,Company Administration,4,2411,126,2021-05-12 18:10:02,2021-05-12 19:03:38.506586
7357,22082,5,22082,76,2411,76,17,1,17,Relationship with Lead,4,2411,126,2021-05-12 18:10:02,2021-05-12 19:03:38.506586
7358,22083,6,22083,71,2411,71,18,1,18,General Satisfaction,4,2411,126,2021-05-12 18:10:02,2021-05-12 19:03:38.506586
7359,22084,5,22084,67,2411,67,19,0,19,Relationship with Co-workers,4,2411,126,2021-05-12 18:10:02,2021-05-12 19:03:38.506586
7360,22085,4,22085,60,2411,60,20,1,20,Compensation and Benefits,4,2411,126,2021-05-12 18:10:02,2021-05-12 19:03:38.506586
7361,22086,6,22086,87,2411,87,21,1,21,Relationship with Manager,4,2411,126,2021-05-12 18:10:02,2021-05-12 19:03:38.506586
7362,22271,5,22271,81,2448,81,16,0,16,Company Administration,4,2448,122,2021-05-19 18:10:02,2021-05-19 19:03:48.891412
7363,22272,3,22272,78,2448,78,17,1,17,Relationship with Lead,4,2448,122,2021-05-19 18:10:02,2021-05-19 19:03:48.891412
7364,22273,6,22273,72,2448,72,18,1,18,General Satisfaction,4,2448,122,2021-05-19 18:10:02,2021-05-19 19:03:48.891412
7365,22274,4,22274,64,2448,64,19,1,19,Relationship with Co-workers,4,2448,122,2021-05-19 18:10:02,2021-05-19 19:03:48.891412
7366,22275,6,22275,59,2448,59,20,1,20,Compensation and Benefits,4,2448,122,2021-05-19 18:10:02,2021-05-19 19:03:48.891412
7367,22276,6,22276,85,2448,85,21,1,21,Relationship with Manager,4,2448,122,2021-05-19 18:10:02,2021-05-19 19:03:48.891412
7368,22467,6,22467,81,2486,81,16,0,16,Company Administration,4,2486,119,2021-05-26 18:10:01,2021-05-26 19:06:31.411976
7369,22468,5,22468,76,2486,76,17,1,17,Relationship with Lead,4,2486,119,2021-05-26 18:10:01,2021-05-26 19:06:31.411976
7370,22469,5,22469,70,2486,70,18,1,18,General Satisfaction,4,2486,119,2021-05-26 18:10:01,2021-05-26 19:06:31.411976
7371,22470,5,22470,66,2486,66,19,1,19,Relationship with Co-workers,4,2486,119,2021-05-26 18:10:01,2021-05-26 19:06:31.411976
7372,22471,4,22471,62,2486,62,20,1,20,Compensation and Benefits,4,2486,119,2021-05-26 18:10:01,2021-05-26 19:06:31.411976
7373,22472,6,22472,88,2486,88,21,0,21,Relationship with Manager,4,2486,119,2021-05-26 18:10:01,2021-05-26 19:06:31.411976
7374,22485,5,22485,81,2489,81,16,0,16,Company Administration,4,2489,122,2021-05-26 18:10:02,2021-05-26 19:03:38.052669
7375,22486,3,22486,79,2489,79,17,0,17,Relationship with Lead,4,2489,122,2021-05-26 18:10:02,2021-05-26 19:03:38.052669
7376,22487,6,22487,74,2489,74,18,1,18,General Satisfaction,4,2489,122,2021-05-26 18:10:02,2021-05-26 19:03:38.052669
7377,22488,5,22488,68,2489,68,19,0,19,Relationship with Co-workers,4,2489,122,2021-05-26 18:10:02,2021-05-26 19:03:38.052669
7378,22489,5,22489,60,2489,60,20,1,20,Compensation and Benefits,4,2489,122,2021-05-26 18:10:02,2021-05-26 19:03:38.052669
7379,22490,6,22490,85,2489,85,21,1,21,Relationship with Manager,4,2489,122,2021-05-26 18:10:02,2021-05-26 19:03:38.052669
7380,100181,6,100181,81,10033,81,16,0,16,Company Administration,4,10033,127,2021-06-02 19:00:02,2021-06-02 19:05:13.835887
7381,100182,6,100182,79,10033,79,17,0,17,Relationship with Lead,4,10033,127,2021-06-02 19:00:02,2021-06-02 19:05:13.835887
7382,100183,6,100183,69,10033,69,18,0,18,General Satisfaction,4,10033,127,2021-06-02 19:00:02,2021-06-02 19:05:13.835887
7383,100184,6,100184,68,10033,68,19,0,19,Relationship with Co-workers,4,10033,127,2021-06-02 19:00:02,2021-06-02 19:05:13.835887
7384,100185,5,100185,63,10033,63,20,1,20,Compensation and Benefits,4,10033,127,2021-06-02 19:00:02,2021-06-02 19:05:13.835887
7385,100186,6,100186,85,10033,85,21,1,21,Relationship with Manager,4,10033,127,2021-06-02 19:00:02,2021-06-02 19:05:13.835887
7386,100474,6,100474,81,10095,81,16,0,16,Company Administration,4,10095,125,2021-06-09 18:10:02,2021-06-09 19:40:04.646462
7387,100475,6,100475,78,10095,78,17,1,17,Relationship with Lead,4,10095,125,2021-06-09 18:10:02,2021-06-09 19:40:04.646462
7388,100476,6,100476,71,10095,71,18,1,18,General Satisfaction,4,10095,125,2021-06-09 18:10:02,2021-06-09 19:40:04.646462
7389,100477,6,100477,67,10095,67,19,0,19,Relationship with Co-workers,4,10095,125,2021-06-09 18:10:02,2021-06-09 19:40:04.646462
7390,100478,5,100478,62,10095,62,20,1,20,Compensation and Benefits,4,10095,125,2021-06-09 18:10:02,2021-06-09 19:40:04.646462
7391,100479,6,100479,86,10095,86,21,0,21,Relationship with Manager,4,10095,125,2021-06-09 18:10:02,2021-06-09 19:40:04.646462
7392,100762,5,100762,81,10156,81,16,0,16,Company Administration,4,10156,122,2021-06-16 18:10:02,2021-06-16 21:56:57.700691
7393,100763,4,100763,77,10156,77,17,0,17,Relationship with Lead,4,10156,122,2021-06-16 18:10:02,2021-06-16 21:56:57.700691
7394,100764,5,100764,72,10156,72,18,1,18,General Satisfaction,4,10156,122,2021-06-16 18:10:02,2021-06-16 21:56:57.700691
7395,100765,4,100765,64,10156,64,19,1,19,Relationship with Co-workers,4,10156,122,2021-06-16 18:10:02,2021-06-16 21:56:57.700691
7396,100766,5,100766,61,10156,61,20,1,20,Compensation and Benefits,4,10156,122,2021-06-16 18:10:02,2021-06-16 21:56:57.700691
7397,100767,6,100767,88,10156,88,21,0,21,Relationship with Manager,4,10156,122,2021-06-16 18:10:02,2021-06-16 21:56:57.700691
7398,100786,1,100786,81,10160,81,16,0,16,Company Administration,4,10160,126,2021-06-16 18:10:03,2021-06-16 19:03:48.256247
7399,100787,5,100787,77,10160,77,17,0,17,Relationship with Lead,4,10160,126,2021-06-16 18:10:03,2021-06-16 19:03:48.256247
7400,100788,5,100788,70,10160,70,18,1,18,General Satisfaction,4,10160,126,2021-06-16 18:10:03,2021-06-16 19:03:48.256247
7401,100789,5,100789,65,10160,65,19,1,19,Relationship with Co-workers,4,10160,126,2021-06-16 18:10:03,2021-06-16 19:03:48.256247
7402,100790,5,100790,59,10160,59,20,1,20,Compensation and Benefits,4,10160,126,2021-06-16 18:10:03,2021-06-16 19:03:48.256247
7403,100791,6,100791,84,10160,84,21,1,21,Relationship with Manager,4,10160,126,2021-06-16 18:10:03,2021-06-16 19:03:48.256247
7404,101058,6,101058,81,10219,81,16,0,16,Company Administration,4,10219,119,2021-06-23 18:10:01,2021-06-23 19:04:55.659663
7405,101059,6,101059,78,10219,78,17,1,17,Relationship with Lead,4,10219,119,2021-06-23 18:10:01,2021-06-23 19:04:55.659663
7406,101060,6,101060,69,10219,69,18,0,18,General Satisfaction,4,10219,119,2021-06-23 18:10:01,2021-06-23 19:04:55.659663
7407,101061,5,101061,65,10219,65,19,1,19,Relationship with Co-workers,4,10219,119,2021-06-23 18:10:01,2021-06-23 19:04:55.659663
7408,101062,5,101062,60,10219,60,20,1,20,Compensation and Benefits,4,10219,119,2021-06-23 18:10:01,2021-06-23 19:04:55.659663
7409,101063,6,101063,85,10219,85,21,1,21,Relationship with Manager,4,10219,119,2021-06-23 18:10:01,2021-06-23 19:04:55.659663
7410,101094,1,101094,81,10225,81,16,0,16,Company Administration,4,10225,125,2021-06-23 18:10:03,2021-06-24 01:26:57.903736
7411,101095,6,101095,75,10225,75,17,1,17,Relationship with Lead,4,10225,125,2021-06-23 18:10:03,2021-06-24 01:26:57.903736
7412,101096,1,101096,73,10225,73,18,1,18,General Satisfaction,4,10225,125,2021-06-23 18:10:03,2021-06-24 01:26:57.903736
7413,101097,6,101097,68,10225,68,19,0,19,Relationship with Co-workers,4,10225,125,2021-06-23 18:10:03,2021-06-24 01:26:57.903736
7414,101098,3,101098,59,10225,59,20,1,20,Compensation and Benefits,4,10225,125,2021-06-23 18:10:03,2021-06-24 01:26:57.903736
7415,101099,6,101099,86,10225,86,21,0,21,Relationship with Manager,4,10225,125,2021-06-23 18:10:03,2021-06-24 01:26:57.903736
7416,101100,1,101100,81,10226,81,16,0,16,Company Administration,4,10226,126,2021-06-23 18:10:03,2021-06-23 18:27:02.103836
7417,101101,4,101101,77,10226,77,17,0,17,Relationship with Lead,4,10226,126,2021-06-23 18:10:03,2021-06-23 18:27:02.103836
7418,101102,4,101102,72,10226,72,18,1,18,General Satisfaction,4,10226,126,2021-06-23 18:10:03,2021-06-23 18:27:02.103836
7419,101103,4,101103,68,10226,68,19,0,19,Relationship with Co-workers,4,10226,126,2021-06-23 18:10:03,2021-06-23 18:27:02.103836
7420,101104,5,101104,59,10226,59,20,1,20,Compensation and Benefits,4,10226,126,2021-06-23 18:10:03,2021-06-23 18:27:02.103836
7421,101105,6,101105,87,10226,87,21,1,21,Relationship with Manager,4,10226,126,2021-06-23 18:10:03,2021-06-23 18:27:02.103836
7422,101414,6,101414,81,10292,81,16,0,16,Company Administration,4,10292,126,2021-06-30 18:10:03,2021-06-30 18:10:36.525447
7423,101415,2,101415,77,10292,77,17,0,17,Relationship with Lead,4,10292,126,2021-06-30 18:10:03,2021-06-30 18:10:36.525447
7424,101416,6,101416,72,10292,72,18,1,18,General Satisfaction,4,10292,126,2021-06-30 18:10:03,2021-06-30 18:10:36.525447
7425,101417,5,101417,65,10292,65,19,1,19,Relationship with Co-workers,4,10292,126,2021-06-30 18:10:03,2021-06-30 18:10:36.525447
7426,101418,4,101418,60,10292,60,20,1,20,Compensation and Benefits,4,10292,126,2021-06-30 18:10:03,2021-06-30 18:10:36.525447
7427,101419,6,101419,85,10292,85,21,1,21,Relationship with Manager,4,10292,126,2021-06-30 18:10:03,2021-06-30 18:10:36.525447
7428,101420,6,101420,81,10293,81,16,0,16,Company Administration,4,10293,127,2021-06-30 18:10:03,2021-06-30 18:12:34.405393
7429,101421,6,101421,79,10293,79,17,0,17,Relationship with Lead,4,10293,127,2021-06-30 18:10:03,2021-06-30 18:12:34.405393
7430,101422,6,101422,69,10293,69,18,0,18,General Satisfaction,4,10293,127,2021-06-30 18:10:03,2021-06-30 18:12:34.405393
7431,101423,5,101423,65,10293,65,19,1,19,Relationship with Co-workers,4,10293,127,2021-06-30 18:10:03,2021-06-30 18:12:34.405393
7432,101424,5,101424,59,10293,59,20,1,20,Compensation and Benefits,4,10293,127,2021-06-30 18:10:03,2021-06-30 18:12:34.405393
7433,101425,6,101425,88,10293,88,21,0,21,Relationship with Manager,4,10293,127,2021-06-30 18:10:03,2021-06-30 18:12:34.405393
7434,101722,6,101722,81,10357,81,16,0,16,Company Administration,4,10357,125,2021-07-07 18:10:02,2021-07-07 18:48:16.129943
7435,101723,6,101723,75,10357,75,17,1,17,Relationship with Lead,4,10357,125,2021-07-07 18:10:02,2021-07-07 18:48:16.129943
7436,101724,6,101724,73,10357,73,18,1,18,General Satisfaction,4,10357,125,2021-07-07 18:10:02,2021-07-07 18:48:16.129943
7437,101725,6,101725,68,10357,68,19,0,19,Relationship with Co-workers,4,10357,125,2021-07-07 18:10:02,2021-07-07 18:48:16.129943
7438,101726,5,101726,61,10357,61,20,1,20,Compensation and Benefits,4,10357,125,2021-07-07 18:10:02,2021-07-07 18:48:16.129943
7439,101727,6,101727,87,10357,87,21,1,21,Relationship with Manager,4,10357,125,2021-07-07 18:10:02,2021-07-07 18:48:16.129943
7440,20479,1,20479,80,2095,80,16,0,16,Company Administration,4,2095,122,2021-04-28 21:18:54,2021-04-28 22:14:50.476148
7441,20480,3,20480,78,2095,78,17,1,17,Relationship with Lead,4,2095,122,2021-04-28 21:18:54,2021-04-28 22:14:50.476148
7442,20481,6,20481,73,2095,73,18,1,18,General Satisfaction,4,2095,122,2021-04-28 21:18:54,2021-04-28 22:14:50.476148
7443,20482,5,20482,68,2095,68,19,0,19,Relationship with Co-workers,4,2095,122,2021-04-28 21:18:54,2021-04-28 22:14:50.476148
7444,20483,6,20483,61,2095,61,20,1,20,Compensation and Benefits,4,2095,122,2021-04-28 21:18:54,2021-04-28 22:14:50.476148
7445,20484,6,20484,84,2095,84,21,1,21,Relationship with Manager,4,2095,122,2021-04-28 21:18:54,2021-04-28 22:14:50.476148
7446,21445,6,21445,80,2287,80,16,0,16,Company Administration,4,2287,119,2021-05-05 18:10:02,2021-05-06 17:35:14.731029
7447,21446,5,21446,75,2287,75,17,1,17,Relationship with Lead,4,2287,119,2021-05-05 18:10:02,2021-05-06 17:35:14.731029
7448,21447,5,21447,70,2287,70,18,1,18,General Satisfaction,4,2287,119,2021-05-05 18:10:02,2021-05-06 17:35:14.731029
7449,21448,5,21448,65,2287,65,19,1,19,Relationship with Co-workers,4,2287,119,2021-05-05 18:10:02,2021-05-06 17:35:14.731029
7450,21449,5,21449,60,2287,60,20,1,20,Compensation and Benefits,4,2287,119,2021-05-05 18:10:02,2021-05-06 17:35:14.731029
7451,21450,5,21450,85,2287,85,21,1,21,Relationship with Manager,4,2287,119,2021-05-05 18:10:02,2021-05-06 17:35:14.731029
7452,21451,5,21451,80,2288,80,16,0,16,Company Administration,4,2288,120,2021-05-05 18:10:02,2021-05-06 17:33:26.440588
7453,21452,4,21452,79,2288,79,17,0,17,Relationship with Lead,4,2288,120,2021-05-05 18:10:02,2021-05-06 17:33:26.440588
7454,21453,2,21453,70,2288,70,18,1,18,General Satisfaction,4,2288,120,2021-05-05 18:10:02,2021-05-06 17:33:26.440588
7455,21454,5,21454,68,2288,68,19,0,19,Relationship with Co-workers,4,2288,120,2021-05-05 18:10:02,2021-05-06 17:33:26.440588
7456,21455,2,21455,60,2288,60,20,1,20,Compensation and Benefits,4,2288,120,2021-05-05 18:10:02,2021-05-06 17:33:26.440588
7457,21456,6,21456,88,2288,88,21,0,21,Relationship with Manager,4,2288,120,2021-05-05 18:10:02,2021-05-06 17:33:26.440588
7458,22051,4,22051,80,2406,80,16,0,16,Company Administration,4,2406,121,2021-05-12 18:10:01,2021-05-13 03:49:33.142591
7459,22052,6,22052,76,2406,76,17,1,17,Relationship with Lead,4,2406,121,2021-05-12 18:10:01,2021-05-13 03:49:33.142591
7460,22053,1,22053,69,2406,69,18,0,18,General Satisfaction,4,2406,121,2021-05-12 18:10:01,2021-05-13 03:49:33.142591
7461,22054,6,22054,67,2406,67,19,0,19,Relationship with Co-workers,4,2406,121,2021-05-12 18:10:01,2021-05-13 03:49:33.142591
7462,22055,3,22055,61,2406,61,20,1,20,Compensation and Benefits,4,2406,121,2021-05-12 18:10:01,2021-05-13 03:49:33.142591
7463,22056,6,22056,86,2406,86,21,0,21,Relationship with Manager,4,2406,121,2021-05-12 18:10:01,2021-05-13 03:49:33.142591
7464,22075,6,22075,80,2410,80,16,0,16,Company Administration,4,2410,125,2021-05-12 18:10:02,2021-05-12 18:11:42.288547
7465,22076,6,22076,76,2410,76,17,1,17,Relationship with Lead,4,2410,125,2021-05-12 18:10:02,2021-05-12 18:11:42.288547
7466,22077,1,22077,70,2410,70,18,1,18,General Satisfaction,4,2410,125,2021-05-12 18:10:02,2021-05-12 18:11:42.288547
7467,22078,6,22078,64,2410,64,19,1,19,Relationship with Co-workers,4,2410,125,2021-05-12 18:10:02,2021-05-12 18:11:42.288547
7468,22079,3,22079,60,2410,60,20,1,20,Compensation and Benefits,4,2410,125,2021-05-12 18:10:02,2021-05-12 18:11:42.288547
7469,22080,6,22080,85,2410,85,21,1,21,Relationship with Manager,4,2410,125,2021-05-12 18:10:02,2021-05-12 18:11:42.288547
7470,100115,6,100115,80,10022,80,16,0,16,Company Administration,4,10022,125,2021-06-02 18:10:02,2021-06-02 19:08:16.744470
7471,100116,6,100116,79,10022,79,17,0,17,Relationship with Lead,4,10022,125,2021-06-02 18:10:02,2021-06-02 19:08:16.744470
7472,100117,6,100117,73,10022,73,18,1,18,General Satisfaction,4,10022,125,2021-06-02 18:10:02,2021-06-02 19:08:16.744470
7473,100118,6,100118,64,10022,64,19,1,19,Relationship with Co-workers,4,10022,125,2021-06-02 18:10:02,2021-06-02 19:08:16.744470
7474,100119,4,100119,59,10022,59,20,1,20,Compensation and Benefits,4,10022,125,2021-06-02 18:10:02,2021-06-02 19:08:16.744470
7475,100120,6,100120,88,10022,88,21,0,21,Relationship with Manager,4,10022,125,2021-06-02 18:10:02,2021-06-02 19:08:16.744470
7476,100438,6,100438,80,10089,80,16,0,16,Company Administration,4,10089,119,2021-06-09 18:10:01,2021-06-09 18:39:15.591103
7477,100439,6,100439,77,10089,77,17,0,17,Relationship with Lead,4,10089,119,2021-06-09 18:10:01,2021-06-09 18:39:15.591103
7478,100440,6,100440,69,10089,69,18,0,18,General Satisfaction,4,10089,119,2021-06-09 18:10:01,2021-06-09 18:39:15.591103
7479,100441,6,100441,66,10089,66,19,1,19,Relationship with Co-workers,4,10089,119,2021-06-09 18:10:01,2021-06-09 18:39:15.591103
7480,100442,6,100442,61,10089,61,20,1,20,Compensation and Benefits,4,10089,119,2021-06-09 18:10:01,2021-06-09 18:39:15.591103
7481,100443,6,100443,85,10089,85,21,1,21,Relationship with Manager,4,10089,119,2021-06-09 18:10:01,2021-06-09 18:39:15.591103
7482,100744,6,100744,80,10153,80,16,0,16,Company Administration,4,10153,119,2021-06-16 18:10:01,2021-06-16 19:06:18.221246
7483,100745,6,100745,77,10153,77,17,0,17,Relationship with Lead,4,10153,119,2021-06-16 18:10:01,2021-06-16 19:06:18.221246
7484,100746,5,100746,71,10153,71,18,1,18,General Satisfaction,4,10153,119,2021-06-16 18:10:01,2021-06-16 19:06:18.221246
7485,100747,6,100747,65,10153,65,19,1,19,Relationship with Co-workers,4,10153,119,2021-06-16 18:10:01,2021-06-16 19:06:18.221246
7486,100748,6,100748,60,10153,60,20,1,20,Compensation and Benefits,4,10153,119,2021-06-16 18:10:01,2021-06-16 19:06:18.221246
7487,100749,6,100749,85,10153,85,21,1,21,Relationship with Manager,4,10153,119,2021-06-16 18:10:01,2021-06-16 19:06:18.221246
7488,100780,6,100780,80,10159,80,16,0,16,Company Administration,4,10159,125,2021-06-16 18:10:03,2021-06-17 01:03:45.895016
7489,100781,6,100781,75,10159,75,17,1,17,Relationship with Lead,4,10159,125,2021-06-16 18:10:03,2021-06-17 01:03:45.895016
7490,100782,6,100782,69,10159,69,18,0,18,General Satisfaction,4,10159,125,2021-06-16 18:10:03,2021-06-17 01:03:45.895016
7491,100783,6,100783,68,10159,68,19,0,19,Relationship with Co-workers,4,10159,125,2021-06-16 18:10:03,2021-06-17 01:03:45.895016
7492,100784,5,100784,63,10159,63,20,1,20,Compensation and Benefits,4,10159,125,2021-06-16 18:10:03,2021-06-17 01:03:45.895016
7493,100785,6,100785,86,10159,86,21,0,21,Relationship with Manager,4,10159,125,2021-06-16 18:10:03,2021-06-17 01:03:45.895016
7494,100792,6,100792,80,10161,80,16,0,16,Company Administration,4,10161,127,2021-06-16 18:10:03,2021-06-16 19:08:44.743364
7495,100793,6,100793,79,10161,79,17,0,17,Relationship with Lead,4,10161,127,2021-06-16 18:10:03,2021-06-16 19:08:44.743364
7496,100794,6,100794,71,10161,71,18,1,18,General Satisfaction,4,10161,127,2021-06-16 18:10:03,2021-06-16 19:08:44.743364
7497,100795,5,100795,65,10161,65,19,1,19,Relationship with Co-workers,4,10161,127,2021-06-16 18:10:03,2021-06-16 19:08:44.743364
7498,100796,5,100796,59,10161,59,20,1,20,Compensation and Benefits,4,10161,127,2021-06-16 18:10:03,2021-06-16 19:08:44.743364
7499,100797,6,100797,86,10161,86,21,0,21,Relationship with Manager,4,10161,127,2021-06-16 18:10:03,2021-06-16 19:08:44.743364
7500,101106,6,101106,80,10227,80,16,0,16,Company Administration,4,10227,127,2021-06-23 18:10:03,2021-06-23 19:05:08.971016
7501,101107,6,101107,79,10227,79,17,0,17,Relationship with Lead,4,10227,127,2021-06-23 18:10:03,2021-06-23 19:05:08.971016
7502,101108,5,101108,74,10227,74,18,1,18,General Satisfaction,4,10227,127,2021-06-23 18:10:03,2021-06-23 19:05:08.971016
7503,101109,5,101109,64,10227,64,19,1,19,Relationship with Co-workers,4,10227,127,2021-06-23 18:10:03,2021-06-23 19:05:08.971016
7504,101110,4,101110,60,10227,60,20,1,20,Compensation and Benefits,4,10227,127,2021-06-23 18:10:03,2021-06-23 19:05:08.971016
7505,101111,6,101111,87,10227,87,21,1,21,Relationship with Manager,4,10227,127,2021-06-23 18:10:03,2021-06-23 19:05:08.971016
7506,101390,6,101390,80,10288,80,16,0,16,Company Administration,4,10288,122,2021-06-30 18:10:02,2021-06-30 19:07:59.172159
7507,101391,4,101391,75,10288,75,17,1,17,Relationship with Lead,4,10288,122,2021-06-30 18:10:02,2021-06-30 19:07:59.172159
7508,101392,1,101392,70,10288,70,18,1,18,General Satisfaction,4,10288,122,2021-06-30 18:10:02,2021-06-30 19:07:59.172159
7509,101393,4,101393,65,10288,65,19,1,19,Relationship with Co-workers,4,10288,122,2021-06-30 18:10:02,2021-06-30 19:07:59.172159
7510,101394,5,101394,59,10288,59,20,1,20,Compensation and Benefits,4,10288,122,2021-06-30 18:10:02,2021-06-30 19:07:59.172159
7511,101395,6,101395,85,10288,85,21,1,21,Relationship with Manager,4,10288,122,2021-06-30 18:10:02,2021-06-30 19:07:59.172159
7512,101402,1,101402,80,10290,80,16,0,16,Company Administration,4,10290,124,2021-06-30 18:10:02,2021-06-30 18:55:28.824772
7513,101403,3,101403,78,10290,78,17,1,17,Relationship with Lead,4,10290,124,2021-06-30 18:10:02,2021-06-30 18:55:28.824772
7514,101404,1,101404,69,10290,69,18,0,18,General Satisfaction,4,10290,124,2021-06-30 18:10:02,2021-06-30 18:55:28.824772
7515,101405,1,101405,67,10290,67,19,0,19,Relationship with Co-workers,4,10290,124,2021-06-30 18:10:02,2021-06-30 18:55:28.824772
7516,101406,1,101406,59,10290,59,20,1,20,Compensation and Benefits,4,10290,124,2021-06-30 18:10:02,2021-06-30 18:55:28.824772
7517,101407,2,101407,85,10290,85,21,1,21,Relationship with Manager,4,10290,124,2021-06-30 18:10:02,2021-06-30 18:55:28.824772
7518,101408,6,101408,80,10291,80,16,0,16,Company Administration,4,10291,125,2021-06-30 18:10:03,2021-07-01 01:30:01.269835
7519,101409,6,101409,77,10291,77,17,0,17,Relationship with Lead,4,10291,125,2021-06-30 18:10:03,2021-07-01 01:30:01.269835
7520,101410,6,101410,72,10291,72,18,1,18,General Satisfaction,4,10291,125,2021-06-30 18:10:03,2021-07-01 01:30:01.269835
7521,101411,6,101411,67,10291,67,19,0,19,Relationship with Co-workers,4,10291,125,2021-06-30 18:10:03,2021-07-01 01:30:01.269835
7522,101412,5,101412,59,10291,59,20,1,20,Compensation and Benefits,4,10291,125,2021-06-30 18:10:03,2021-07-01 01:30:01.269835
7523,101413,2,101413,86,10291,86,21,0,21,Relationship with Manager,4,10291,125,2021-06-30 18:10:03,2021-07-01 01:30:01.269835
7524,101704,5,101704,80,10354,80,16,0,16,Company Administration,4,10354,122,2021-07-07 18:10:02,2021-07-07 21:53:41.547871
7525,101705,4,101705,76,10354,76,17,1,17,Relationship with Lead,4,10354,122,2021-07-07 18:10:02,2021-07-07 21:53:41.547871
7526,101706,1,101706,70,10354,70,18,1,18,General Satisfaction,4,10354,122,2021-07-07 18:10:02,2021-07-07 21:53:41.547871
7527,101707,5,101707,66,10354,66,19,1,19,Relationship with Co-workers,4,10354,122,2021-07-07 18:10:02,2021-07-07 21:53:41.547871
7528,101708,4,101708,62,10354,62,20,1,20,Compensation and Benefits,4,10354,122,2021-07-07 18:10:02,2021-07-07 21:53:41.547871
7529,101709,6,101709,87,10354,87,21,1,21,Relationship with Manager,4,10354,122,2021-07-07 18:10:02,2021-07-07 21:53:41.547871
7530,101710,1,101710,80,10355,80,16,0,16,Company Administration,4,10355,123,2021-07-07 18:10:02,2021-07-07 19:39:44.227272
7531,101711,4,101711,79,10355,79,17,0,17,Relationship with Lead,4,10355,123,2021-07-07 18:10:02,2021-07-07 19:39:44.227272
7532,101712,4,101712,72,10355,72,18,1,18,General Satisfaction,4,10355,123,2021-07-07 18:10:02,2021-07-07 19:39:44.227272
7533,101713,3,101713,68,10355,68,19,0,19,Relationship with Co-workers,4,10355,123,2021-07-07 18:10:02,2021-07-07 19:39:44.227272
7534,101714,3,101714,59,10355,59,20,1,20,Compensation and Benefits,4,10355,123,2021-07-07 18:10:02,2021-07-07 19:39:44.227272
7535,101715,1,101715,88,10355,88,21,0,21,Relationship with Manager,4,10355,123,2021-07-07 18:10:02,2021-07-07 19:39:44.227272
7536,101728,6,101728,80,10358,80,16,0,16,Company Administration,4,10358,126,2021-07-07 18:10:02,2021-07-07 19:06:27.745538
7537,101729,4,101729,76,10358,76,17,1,17,Relationship with Lead,4,10358,126,2021-07-07 18:10:02,2021-07-07 19:06:27.745538
7538,101730,5,101730,74,10358,74,18,1,18,General Satisfaction,4,10358,126,2021-07-07 18:10:02,2021-07-07 19:06:27.745538
7539,101731,5,101731,67,10358,67,19,0,19,Relationship with Co-workers,4,10358,126,2021-07-07 18:10:02,2021-07-07 19:06:27.745538
7540,101732,5,101732,62,10358,62,20,1,20,Compensation and Benefits,4,10358,126,2021-07-07 18:10:02,2021-07-07 19:06:27.745538
7541,101733,6,101733,87,10358,87,21,1,21,Relationship with Manager,4,10358,126,2021-07-07 18:10:02,2021-07-07 19:06:27.745538
7542,101734,6,101734,80,10359,80,16,0,16,Company Administration,4,10359,127,2021-07-07 18:10:03,2021-07-07 18:16:02.490857
7543,101735,6,101735,78,10359,78,17,1,17,Relationship with Lead,4,10359,127,2021-07-07 18:10:03,2021-07-07 18:16:02.490857
7544,101736,6,101736,72,10359,72,18,1,18,General Satisfaction,4,10359,127,2021-07-07 18:10:03,2021-07-07 18:16:02.490857
7545,101737,5,101737,66,10359,66,19,1,19,Relationship with Co-workers,4,10359,127,2021-07-07 18:10:03,2021-07-07 18:16:02.490857
7546,101738,5,101738,63,10359,63,20,1,20,Compensation and Benefits,4,10359,127,2021-07-07 18:10:03,2021-07-07 18:16:02.490857
7547,101739,6,101739,88,10359,88,21,0,21,Relationship with Manager,4,10359,127,2021-07-07 18:10:03,2021-07-07 18:16:02.490857
7548,101940,6,101940,80,10405,80,16,0,16,Company Administration,4,10405,119,2021-07-14 18:10:02,2021-07-14 18:15:53.219765
7549,101941,6,101941,77,10405,77,17,0,17,Relationship with Lead,4,10405,119,2021-07-14 18:10:02,2021-07-14 18:15:53.219765
7550,101942,6,101942,69,10405,69,18,0,18,General Satisfaction,4,10405,119,2021-07-14 18:10:02,2021-07-14 18:15:53.219765
7551,101943,6,101943,68,10405,68,19,0,19,Relationship with Co-workers,4,10405,119,2021-07-14 18:10:02,2021-07-14 18:15:53.219765
7552,101944,5,101944,62,10405,62,20,1,20,Compensation and Benefits,4,10405,119,2021-07-14 18:10:02,2021-07-14 18:15:53.219765
7553,101945,6,101945,87,10405,87,21,1,21,Relationship with Manager,4,10405,119,2021-07-14 18:10:02,2021-07-14 18:15:53.219765
7554,101958,6,101958,80,10408,80,16,0,16,Company Administration,4,10408,122,2021-07-14 18:10:03,2021-07-14 20:17:37.139449
7555,101959,4,101959,77,10408,77,17,0,17,Relationship with Lead,4,10408,122,2021-07-14 18:10:03,2021-07-14 20:17:37.139449
7556,101960,5,101960,74,10408,74,18,1,18,General Satisfaction,4,10408,122,2021-07-14 18:10:03,2021-07-14 20:17:37.139449
7557,101961,4,101961,65,10408,65,19,1,19,Relationship with Co-workers,4,10408,122,2021-07-14 18:10:03,2021-07-14 20:17:37.139449
7558,101962,4,101962,59,10408,59,20,1,20,Compensation and Benefits,4,10408,122,2021-07-14 18:10:03,2021-07-14 20:17:37.139449
7559,101963,6,101963,87,10408,87,21,1,21,Relationship with Manager,4,10408,122,2021-07-14 18:10:03,2021-07-14 20:17:37.139449
7560,20491,2,20491,83,2097,83,16,1,16,Company Administration,4,2097,124,2021-04-28 21:18:54,2021-04-29 15:35:21.935591
7561,20492,2,20492,77,2097,77,17,0,17,Relationship with Lead,4,2097,124,2021-04-28 21:18:54,2021-04-29 15:35:21.935591
7562,20493,6,20493,73,2097,73,18,1,18,General Satisfaction,4,2097,124,2021-04-28 21:18:54,2021-04-29 15:35:21.935591
7563,20494,6,20494,64,2097,64,19,1,19,Relationship with Co-workers,4,2097,124,2021-04-28 21:18:54,2021-04-29 15:35:21.935591
7564,20495,1,20495,59,2097,59,20,1,20,Compensation and Benefits,4,2097,124,2021-04-28 21:18:54,2021-04-29 15:35:21.935591
7565,20496,2,20496,84,2097,84,21,1,21,Relationship with Manager,4,2097,124,2021-04-28 21:18:54,2021-04-29 15:35:21.935591
7566,20503,6,20503,83,2099,83,16,1,16,Company Administration,4,2099,126,2021-04-28 21:18:54,2021-04-28 21:19:57.667288
7567,20504,5,20504,75,2099,75,17,1,17,Relationship with Lead,4,2099,126,2021-04-28 21:18:54,2021-04-28 21:19:57.667288
7568,20505,5,20505,69,2099,69,18,0,18,General Satisfaction,4,2099,126,2021-04-28 21:18:54,2021-04-28 21:19:57.667288
7569,20506,5,20506,64,2099,64,19,1,19,Relationship with Co-workers,4,2099,126,2021-04-28 21:18:54,2021-04-28 21:19:57.667288
7570,20507,3,20507,59,2099,59,20,1,20,Compensation and Benefits,4,2099,126,2021-04-28 21:18:54,2021-04-28 21:19:57.667288
7571,20508,6,20508,84,2099,84,21,1,21,Relationship with Manager,4,2099,126,2021-04-28 21:18:54,2021-04-28 21:19:57.667288
7572,20509,6,20509,83,2100,83,16,1,16,Company Administration,4,2100,127,2021-04-28 21:18:54,2021-04-28 21:20:43.660538
7573,20510,6,20510,77,2100,77,17,0,17,Relationship with Lead,4,2100,127,2021-04-28 21:18:54,2021-04-28 21:20:43.660538
7574,20511,5,20511,72,2100,72,18,1,18,General Satisfaction,4,2100,127,2021-04-28 21:18:54,2021-04-28 21:20:43.660538
7575,20512,5,20512,65,2100,65,19,1,19,Relationship with Co-workers,4,2100,127,2021-04-28 21:18:54,2021-04-28 21:20:43.660538
7576,20513,5,20513,59,2100,59,20,1,20,Compensation and Benefits,4,2100,127,2021-04-28 21:18:54,2021-04-28 21:20:43.660538
7577,20514,6,20514,88,2100,88,21,0,21,Relationship with Manager,4,2100,127,2021-04-28 21:18:54,2021-04-28 21:20:43.660538
7578,21463,5,21463,83,2290,83,16,1,16,Company Administration,4,2290,122,2021-05-05 18:10:03,2021-05-05 19:04:19.917146
7579,21464,4,21464,75,2290,75,17,1,17,Relationship with Lead,4,2290,122,2021-05-05 18:10:03,2021-05-05 19:04:19.917146
7580,21465,5,21465,72,2290,72,18,1,18,General Satisfaction,4,2290,122,2021-05-05 18:10:03,2021-05-05 19:04:19.917146
7581,21466,5,21466,68,2290,68,19,0,19,Relationship with Co-workers,4,2290,122,2021-05-05 18:10:03,2021-05-05 19:04:19.917146
7582,21467,6,21467,59,2290,59,20,1,20,Compensation and Benefits,4,2290,122,2021-05-05 18:10:03,2021-05-05 19:04:19.917146
7583,21468,6,21468,87,2290,87,21,1,21,Relationship with Manager,4,2290,122,2021-05-05 18:10:03,2021-05-05 19:04:19.917146
7584,21475,3,21475,83,2292,83,16,1,16,Company Administration,4,2292,124,2021-05-05 18:10:03,2021-05-06 01:58:38.173864
7585,21476,3,21476,75,2292,75,17,1,17,Relationship with Lead,4,2292,124,2021-05-05 18:10:03,2021-05-06 01:58:38.173864
7586,21477,4,21477,74,2292,74,18,1,18,General Satisfaction,4,2292,124,2021-05-05 18:10:03,2021-05-06 01:58:38.173864
7587,21478,6,21478,64,2292,64,19,1,19,Relationship with Co-workers,4,2292,124,2021-05-05 18:10:03,2021-05-06 01:58:38.173864
7588,21479,2,21479,63,2292,63,20,1,20,Compensation and Benefits,4,2292,124,2021-05-05 18:10:03,2021-05-06 01:58:38.173864
7589,21480,3,21480,84,2292,84,21,1,21,Relationship with Manager,4,2292,124,2021-05-05 18:10:03,2021-05-06 01:58:38.173864
7590,21481,6,21481,83,2293,83,16,1,16,Company Administration,4,2293,125,2021-05-05 18:10:03,2021-05-05 18:19:21.212921
7591,21482,6,21482,77,2293,77,17,0,17,Relationship with Lead,4,2293,125,2021-05-05 18:10:03,2021-05-05 18:19:21.212921
7592,21483,6,21483,69,2293,69,18,0,18,General Satisfaction,4,2293,125,2021-05-05 18:10:03,2021-05-05 18:19:21.212921
7593,21484,6,21484,64,2293,64,19,1,19,Relationship with Co-workers,4,2293,125,2021-05-05 18:10:03,2021-05-05 18:19:21.212921
7594,21485,4,21485,60,2293,60,20,1,20,Compensation and Benefits,4,2293,125,2021-05-05 18:10:03,2021-05-05 18:19:21.212921
7595,21486,6,21486,85,2293,85,21,1,21,Relationship with Manager,4,2293,125,2021-05-05 18:10:03,2021-05-05 18:19:21.212921
7596,22039,5,22039,83,2404,83,16,1,16,Company Administration,4,2404,119,2021-05-12 18:10:01,2021-05-12 19:04:02.254168
7597,22040,5,22040,78,2404,78,17,1,17,Relationship with Lead,4,2404,119,2021-05-12 18:10:01,2021-05-12 19:04:02.254168
7598,22041,5,22041,70,2404,70,18,1,18,General Satisfaction,4,2404,119,2021-05-12 18:10:01,2021-05-12 19:04:02.254168
7599,22042,5,22042,65,2404,65,19,1,19,Relationship with Co-workers,4,2404,119,2021-05-12 18:10:01,2021-05-12 19:04:02.254168
7600,22043,5,22043,59,2404,59,20,1,20,Compensation and Benefits,4,2404,119,2021-05-12 18:10:01,2021-05-12 19:04:02.254168
7601,22044,6,22044,88,2404,88,21,0,21,Relationship with Manager,4,2404,119,2021-05-12 18:10:01,2021-05-12 19:04:02.254168
7602,22057,6,22057,83,2407,83,16,1,16,Company Administration,4,2407,122,2021-05-12 18:10:02,2021-05-12 21:21:18.038035
7603,22058,4,22058,76,2407,76,17,1,17,Relationship with Lead,4,2407,122,2021-05-12 18:10:02,2021-05-12 21:21:18.038035
7604,22059,6,22059,72,2407,72,18,1,18,General Satisfaction,4,2407,122,2021-05-12 18:10:02,2021-05-12 21:21:18.038035
7605,22060,5,22060,64,2407,64,19,1,19,Relationship with Co-workers,4,2407,122,2021-05-12 18:10:02,2021-05-12 21:21:18.038035
7606,22061,5,22061,60,2407,60,20,1,20,Compensation and Benefits,4,2407,122,2021-05-12 18:10:02,2021-05-12 21:21:18.038035
7607,22062,6,22062,85,2407,85,21,1,21,Relationship with Manager,4,2407,122,2021-05-12 18:10:02,2021-05-12 21:21:18.038035
7608,22069,2,22069,83,2409,83,16,1,16,Company Administration,4,2409,124,2021-05-12 18:10:02,2021-05-13 12:51:31.235700
7609,22070,3,22070,75,2409,75,17,1,17,Relationship with Lead,4,2409,124,2021-05-12 18:10:02,2021-05-13 12:51:31.235700
7610,22071,2,22071,70,2409,70,18,1,18,General Satisfaction,4,2409,124,2021-05-12 18:10:02,2021-05-13 12:51:31.235700
7611,22072,5,22072,67,2409,67,19,0,19,Relationship with Co-workers,4,2409,124,2021-05-12 18:10:02,2021-05-13 12:51:31.235700
7612,22073,1,22073,60,2409,60,20,1,20,Compensation and Benefits,4,2409,124,2021-05-12 18:10:02,2021-05-13 12:51:31.235700
7613,22074,4,22074,85,2409,85,21,1,21,Relationship with Manager,4,2409,124,2021-05-12 18:10:02,2021-05-13 12:51:31.235700
7614,22087,6,22087,83,2412,83,16,1,16,Company Administration,4,2412,127,2021-05-12 18:10:02,2021-05-12 18:52:31.213489
7615,22088,6,22088,76,2412,76,17,1,17,Relationship with Lead,4,2412,127,2021-05-12 18:10:02,2021-05-12 18:52:31.213489
7616,22089,6,22089,71,2412,71,18,1,18,General Satisfaction,4,2412,127,2021-05-12 18:10:02,2021-05-12 18:52:31.213489
7617,22090,5,22090,68,2412,68,19,0,19,Relationship with Co-workers,4,2412,127,2021-05-12 18:10:02,2021-05-12 18:52:31.213489
7618,22091,6,22091,61,2412,61,20,1,20,Compensation and Benefits,4,2412,127,2021-05-12 18:10:02,2021-05-12 18:52:31.213489
7619,22092,6,22092,87,2412,87,21,1,21,Relationship with Manager,4,2412,127,2021-05-12 18:10:02,2021-05-12 18:52:31.213489
7620,22289,6,22289,83,2451,83,16,1,16,Company Administration,4,2451,125,2021-05-19 18:10:03,2021-05-19 18:45:03.966125
7621,22290,6,22290,77,2451,77,17,0,17,Relationship with Lead,4,2451,125,2021-05-19 18:10:03,2021-05-19 18:45:03.966125
7622,22291,1,22291,70,2451,70,18,1,18,General Satisfaction,4,2451,125,2021-05-19 18:10:03,2021-05-19 18:45:03.966125
7623,22292,6,22292,66,2451,66,19,1,19,Relationship with Co-workers,4,2451,125,2021-05-19 18:10:03,2021-05-19 18:45:03.966125
7624,22293,4,22293,59,2451,59,20,1,20,Compensation and Benefits,4,2451,125,2021-05-19 18:10:03,2021-05-19 18:45:03.966125
7625,22294,2,22294,88,2451,88,21,0,21,Relationship with Manager,4,2451,125,2021-05-19 18:10:03,2021-05-19 18:45:03.966125
7626,22295,6,22295,83,2452,83,16,1,16,Company Administration,4,2452,126,2021-05-19 18:10:03,2021-05-19 19:05:44.722297
7627,22296,5,22296,77,2452,77,17,0,17,Relationship with Lead,4,2452,126,2021-05-19 18:10:03,2021-05-19 19:05:44.722297
7628,22297,6,22297,71,2452,71,18,1,18,General Satisfaction,4,2452,126,2021-05-19 18:10:03,2021-05-19 19:05:44.722297
7629,22298,5,22298,68,2452,68,19,0,19,Relationship with Co-workers,4,2452,126,2021-05-19 18:10:03,2021-05-19 19:05:44.722297
7630,22299,4,22299,59,2452,59,20,1,20,Compensation and Benefits,4,2452,126,2021-05-19 18:10:03,2021-05-19 19:05:44.722297
7631,22300,6,22300,86,2452,86,21,0,21,Relationship with Manager,4,2452,126,2021-05-19 18:10:03,2021-05-19 19:05:44.722297
7632,22515,6,22515,83,2494,83,16,1,16,Company Administration,4,2494,127,2021-05-26 18:10:03,2021-05-26 19:05:21.118562
7633,22516,6,22516,79,2494,79,17,0,17,Relationship with Lead,4,2494,127,2021-05-26 18:10:03,2021-05-26 19:05:21.118562
7634,22517,5,22517,74,2494,74,18,1,18,General Satisfaction,4,2494,127,2021-05-26 18:10:03,2021-05-26 19:05:21.118562
7635,22518,5,22518,65,2494,65,19,1,19,Relationship with Co-workers,4,2494,127,2021-05-26 18:10:03,2021-05-26 19:05:21.118562
7636,22519,6,22519,61,2494,61,20,1,20,Compensation and Benefits,4,2494,127,2021-05-26 18:10:03,2021-05-26 19:05:21.118562
7637,22520,6,22520,87,2494,87,21,1,21,Relationship with Manager,4,2494,127,2021-05-26 18:10:03,2021-05-26 19:05:21.118562
7638,100079,6,100079,83,10016,83,16,1,16,Company Administration,4,10016,119,2021-06-02 18:10:01,2021-06-02 18:28:55.397223
7639,100080,6,100080,77,10016,77,17,0,17,Relationship with Lead,4,10016,119,2021-06-02 18:10:01,2021-06-02 18:28:55.397223
7640,100081,5,100081,71,10016,71,18,1,18,General Satisfaction,4,10016,119,2021-06-02 18:10:01,2021-06-02 18:28:55.397223
7641,100082,5,100082,65,10016,65,19,1,19,Relationship with Co-workers,4,10016,119,2021-06-02 18:10:01,2021-06-02 18:28:55.397223
7642,100083,2,100083,60,10016,60,20,1,20,Compensation and Benefits,4,10016,119,2021-06-02 18:10:01,2021-06-02 18:28:55.397223
7643,100084,6,100084,87,10016,87,21,1,21,Relationship with Manager,4,10016,119,2021-06-02 18:10:01,2021-06-02 18:28:55.397223
7644,100097,5,100097,83,10019,83,16,1,16,Company Administration,4,10019,122,2021-06-02 18:10:02,2021-06-02 19:08:03.678931
7645,100098,3,100098,78,10019,78,17,1,17,Relationship with Lead,4,10019,122,2021-06-02 18:10:02,2021-06-02 19:08:03.678931
7646,100099,5,100099,69,10019,69,18,0,18,General Satisfaction,4,10019,122,2021-06-02 18:10:02,2021-06-02 19:08:03.678931
7647,100100,4,100100,64,10019,64,19,1,19,Relationship with Co-workers,4,10019,122,2021-06-02 18:10:02,2021-06-02 19:08:03.678931
7648,100101,4,100101,60,10019,60,20,1,20,Compensation and Benefits,4,10019,122,2021-06-02 18:10:02,2021-06-02 19:08:03.678931
7649,100102,6,100102,87,10019,87,21,1,21,Relationship with Manager,4,10019,122,2021-06-02 18:10:02,2021-06-02 19:08:03.678931
7650,100133,6,100133,83,10025,83,16,1,16,Company Administration,4,10025,119,2021-06-02 19:00:01,2021-06-02 19:02:13.507251
7651,100134,6,100134,79,10025,79,17,0,17,Relationship with Lead,4,10025,119,2021-06-02 19:00:01,2021-06-02 19:02:13.507251
7652,100135,6,100135,72,10025,72,18,1,18,General Satisfaction,4,10025,119,2021-06-02 19:00:01,2021-06-02 19:02:13.507251
7653,100136,1,100136,65,10025,65,19,1,19,Relationship with Co-workers,4,10025,119,2021-06-02 19:00:01,2021-06-02 19:02:13.507251
7654,100137,5,100137,63,10025,63,20,1,20,Compensation and Benefits,4,10025,119,2021-06-02 19:00:01,2021-06-02 19:02:13.507251
7655,100138,2,100138,85,10025,85,21,1,21,Relationship with Manager,4,10025,119,2021-06-02 19:00:01,2021-06-02 19:02:13.507251
7656,100456,6,100456,83,10092,83,16,1,16,Company Administration,4,10092,122,2021-06-09 18:10:02,2021-06-09 21:55:01.532071
7657,100457,4,100457,75,10092,75,17,1,17,Relationship with Lead,4,10092,122,2021-06-09 18:10:02,2021-06-09 21:55:01.532071
7658,100458,1,100458,70,10092,70,18,1,18,General Satisfaction,4,10092,122,2021-06-09 18:10:02,2021-06-09 21:55:01.532071
7659,100459,4,100459,66,10092,66,19,1,19,Relationship with Co-workers,4,10092,122,2021-06-09 18:10:02,2021-06-09 21:55:01.532071
7660,100460,6,100460,61,10092,61,20,1,20,Compensation and Benefits,4,10092,122,2021-06-09 18:10:02,2021-06-09 21:55:01.532071
7661,100461,6,100461,85,10092,85,21,1,21,Relationship with Manager,4,10092,122,2021-06-09 18:10:02,2021-06-09 21:55:01.532071
7662,100462,6,100462,83,10093,83,16,1,16,Company Administration,4,10093,123,2021-06-09 18:10:02,2021-06-10 14:57:37.284327
7663,100463,3,100463,76,10093,76,17,1,17,Relationship with Lead,4,10093,123,2021-06-09 18:10:02,2021-06-10 14:57:37.284327
7664,100464,6,100464,69,10093,69,18,0,18,General Satisfaction,4,10093,123,2021-06-09 18:10:02,2021-06-10 14:57:37.284327
7665,100465,6,100465,65,10093,65,19,1,19,Relationship with Co-workers,4,10093,123,2021-06-09 18:10:02,2021-06-10 14:57:37.284327
7666,100466,3,100466,59,10093,59,20,1,20,Compensation and Benefits,4,10093,123,2021-06-09 18:10:02,2021-06-10 14:57:37.284327
7667,100467,6,100467,85,10093,85,21,1,21,Relationship with Manager,4,10093,123,2021-06-09 18:10:02,2021-06-10 14:57:37.284327
7668,100486,6,100486,83,10097,83,16,1,16,Company Administration,4,10097,127,2021-06-09 18:10:02,2021-06-09 19:06:44.641652
7669,100487,6,100487,75,10097,75,17,1,17,Relationship with Lead,4,10097,127,2021-06-09 18:10:02,2021-06-09 19:06:44.641652
7670,100488,6,100488,69,10097,69,18,0,18,General Satisfaction,4,10097,127,2021-06-09 18:10:02,2021-06-09 19:06:44.641652
7671,100489,5,100489,65,10097,65,19,1,19,Relationship with Co-workers,4,10097,127,2021-06-09 18:10:02,2021-06-09 19:06:44.641652
7672,100490,5,100490,63,10097,63,20,1,20,Compensation and Benefits,4,10097,127,2021-06-09 18:10:02,2021-06-09 19:06:44.641652
7673,100491,6,100491,85,10097,85,21,1,21,Relationship with Manager,4,10097,127,2021-06-09 18:10:02,2021-06-09 19:06:44.641652
7674,100768,6,100768,83,10157,83,16,1,16,Company Administration,4,10157,123,2021-06-16 18:10:02,2021-06-17 11:57:01.516693
7675,100769,2,100769,75,10157,75,17,1,17,Relationship with Lead,4,10157,123,2021-06-16 18:10:02,2021-06-17 11:57:01.516693
7676,100770,1,100770,70,10157,70,18,1,18,General Satisfaction,4,10157,123,2021-06-16 18:10:02,2021-06-17 11:57:01.516693
7677,100771,6,100771,67,10157,67,19,0,19,Relationship with Co-workers,4,10157,123,2021-06-16 18:10:02,2021-06-17 11:57:01.516693
7678,100772,5,100772,63,10157,63,20,1,20,Compensation and Benefits,4,10157,123,2021-06-16 18:10:02,2021-06-17 11:57:01.516693
7679,100773,6,100773,86,10157,86,21,0,21,Relationship with Manager,4,10157,123,2021-06-16 18:10:02,2021-06-17 11:57:01.516693
7680,100774,1,100774,83,10158,83,16,1,16,Company Administration,4,10158,124,2021-06-16 18:10:02,2021-06-17 00:22:05.891197
7681,100775,2,100775,78,10158,78,17,1,17,Relationship with Lead,4,10158,124,2021-06-16 18:10:02,2021-06-17 00:22:05.891197
7682,100776,1,100776,71,10158,71,18,1,18,General Satisfaction,4,10158,124,2021-06-16 18:10:02,2021-06-17 00:22:05.891197
7683,100777,6,100777,65,10158,65,19,1,19,Relationship with Co-workers,4,10158,124,2021-06-16 18:10:02,2021-06-17 00:22:05.891197
7684,100778,1,100778,61,10158,61,20,1,20,Compensation and Benefits,4,10158,124,2021-06-16 18:10:02,2021-06-17 00:22:05.891197
7685,100779,3,100779,86,10158,86,21,0,21,Relationship with Manager,4,10158,124,2021-06-16 18:10:02,2021-06-17 00:22:05.891197
7686,101076,6,101076,83,10222,83,16,1,16,Company Administration,4,10222,122,2021-06-23 18:10:02,2021-06-23 21:58:31.269622
7687,101077,3,101077,79,10222,79,17,0,17,Relationship with Lead,4,10222,122,2021-06-23 18:10:02,2021-06-23 21:58:31.269622
7688,101078,6,101078,71,10222,71,18,1,18,General Satisfaction,4,10222,122,2021-06-23 18:10:02,2021-06-23 21:58:31.269622
7689,101079,5,101079,67,10222,67,19,0,19,Relationship with Co-workers,4,10222,122,2021-06-23 18:10:02,2021-06-23 21:58:31.269622
7690,101080,5,101080,61,10222,61,20,1,20,Compensation and Benefits,4,10222,122,2021-06-23 18:10:02,2021-06-23 21:58:31.269622
7691,101081,6,101081,86,10222,86,21,0,21,Relationship with Manager,4,10222,122,2021-06-23 18:10:02,2021-06-23 21:58:31.269622
7692,101082,1,101082,83,10223,83,16,1,16,Company Administration,4,10223,123,2021-06-23 18:10:02,2021-06-23 18:12:32.370018
7693,101083,6,101083,79,10223,79,17,0,17,Relationship with Lead,4,10223,123,2021-06-23 18:10:02,2021-06-23 18:12:32.370018
7694,101084,5,101084,74,10223,74,18,1,18,General Satisfaction,4,10223,123,2021-06-23 18:10:02,2021-06-23 18:12:32.370018
7695,101085,4,101085,64,10223,64,19,1,19,Relationship with Co-workers,4,10223,123,2021-06-23 18:10:02,2021-06-23 18:12:32.370018
7696,101086,4,101086,61,10223,61,20,1,20,Compensation and Benefits,4,10223,123,2021-06-23 18:10:02,2021-06-23 18:12:32.370018
7697,101087,3,101087,86,10223,86,21,0,21,Relationship with Manager,4,10223,123,2021-06-23 18:10:02,2021-06-23 18:12:32.370018
7698,101372,6,101372,83,10285,83,16,1,16,Company Administration,4,10285,119,2021-06-30 18:10:01,2021-06-30 18:11:48.391151
7699,101373,6,101373,75,10285,75,17,1,17,Relationship with Lead,4,10285,119,2021-06-30 18:10:01,2021-06-30 18:11:48.391151
7700,101374,6,101374,74,10285,74,18,1,18,General Satisfaction,4,10285,119,2021-06-30 18:10:01,2021-06-30 18:11:48.391151
7701,101375,5,101375,64,10285,64,19,1,19,Relationship with Co-workers,4,10285,119,2021-06-30 18:10:01,2021-06-30 18:11:48.391151
7702,101376,5,101376,60,10285,60,20,1,20,Compensation and Benefits,4,10285,119,2021-06-30 18:10:01,2021-06-30 18:11:48.391151
7703,101377,6,101377,88,10285,88,21,0,21,Relationship with Manager,4,10285,119,2021-06-30 18:10:01,2021-06-30 18:11:48.391151
7704,100498,5,100498,105,10099,105,24,0,24,Company Administration,5,10099,131,2021-06-09 19:00:01,2021-06-09 19:06:18.602696
7705,100497,6,100497,95,10099,95,23,1,23,Relationship with Co-workers,5,10099,131,2021-06-09 19:00:01,2021-06-09 19:06:18.602696
7706,100496,4,100496,91,10099,91,22,1,22,Benefits and Compensation,5,10099,131,2021-06-09 19:00:01,2021-06-09 19:06:18.602696
7707,100499,5,100499,103,10099,103,25,1,25,General Satisfaction,5,10099,131,2021-06-09 19:00:01,2021-06-09 19:06:18.602696
7708,100506,3,100506,105,10101,105,24,0,24,Company Administration,5,10101,133,2021-06-09 19:00:02,2021-06-09 20:27:46.025645
7709,100505,3,100505,94,10101,94,23,1,23,Relationship with Co-workers,5,10101,133,2021-06-09 19:00:02,2021-06-09 20:27:46.025645
7710,100504,3,100504,91,10101,91,22,1,22,Benefits and Compensation,5,10101,133,2021-06-09 19:00:02,2021-06-09 20:27:46.025645
7711,100507,1,100507,100,10101,100,25,1,25,General Satisfaction,5,10101,133,2021-06-09 19:00:02,2021-06-09 20:27:46.025645
7712,100518,6,100518,105,10104,105,24,0,24,Company Administration,5,10104,136,2021-06-09 19:00:02,2021-06-09 19:01:33.146442
7713,100517,4,100517,94,10104,94,23,1,23,Relationship with Co-workers,5,10104,136,2021-06-09 19:00:02,2021-06-09 19:01:33.146442
7714,100516,5,100516,89,10104,89,22,1,22,Benefits and Compensation,5,10104,136,2021-06-09 19:00:02,2021-06-09 19:01:33.146442
7715,100519,5,100519,100,10104,100,25,1,25,General Satisfaction,5,10104,136,2021-06-09 19:00:02,2021-06-09 19:01:33.146442
7716,100570,5,100570,105,10117,105,24,0,24,Company Administration,5,10117,149,2021-06-09 19:00:05,2021-06-09 19:12:45.234258
7717,100569,4,100569,95,10117,95,23,1,23,Relationship with Co-workers,5,10117,149,2021-06-09 19:00:05,2021-06-09 19:12:45.234258
7718,100568,6,100568,92,10117,92,22,1,22,Benefits and Compensation,5,10117,149,2021-06-09 19:00:05,2021-06-09 19:12:45.234258
7719,100571,5,100571,104,10117,104,25,1,25,General Satisfaction,5,10117,149,2021-06-09 19:00:05,2021-06-09 19:12:45.234258
7720,100884,2,100884,105,10183,105,24,0,24,Company Administration,5,10183,151,2021-06-16 19:00:07,2021-06-16 19:39:46.007200
7721,100883,5,100883,97,10183,97,23,0,23,Relationship with Co-workers,5,10183,151,2021-06-16 19:00:07,2021-06-16 19:39:46.007200
7722,100882,2,100882,89,10183,89,22,1,22,Benefits and Compensation,5,10183,151,2021-06-16 19:00:07,2021-06-16 19:39:46.007200
7723,100885,6,100885,104,10183,104,25,1,25,General Satisfaction,5,10183,151,2021-06-16 19:00:07,2021-06-16 19:39:46.007200
7724,100896,5,100896,105,10186,105,24,0,24,Company Administration,5,10186,154,2021-06-16 19:00:07,2021-06-16 19:09:02.824687
7725,100895,3,100895,97,10186,97,23,0,23,Relationship with Co-workers,5,10186,154,2021-06-16 19:00:07,2021-06-16 19:09:02.824687
7726,100894,6,100894,90,10186,90,22,1,22,Benefits and Compensation,5,10186,154,2021-06-16 19:00:07,2021-06-16 19:09:02.824687
7727,100897,6,100897,101,10186,101,25,1,25,General Satisfaction,5,10186,154,2021-06-16 19:00:07,2021-06-16 19:09:02.824687
7728,101114,6,101114,105,10228,105,24,0,24,Company Administration,5,10228,130,2021-06-23 19:00:01,2021-06-23 19:10:04.062008
7729,101113,5,101113,98,10228,98,23,0,23,Relationship with Co-workers,5,10228,130,2021-06-23 19:00:01,2021-06-23 19:10:04.062008
7730,101112,5,101112,91,10228,91,22,1,22,Benefits and Compensation,5,10228,130,2021-06-23 19:00:01,2021-06-23 19:10:04.062008
7731,101115,5,101115,101,10228,101,25,1,25,General Satisfaction,5,10228,130,2021-06-23 19:00:01,2021-06-23 19:10:04.062008
7732,101126,4,101126,105,10231,105,24,0,24,Company Administration,5,10231,133,2021-06-23 19:00:02,2021-06-23 19:39:49.927946
7733,101125,5,101125,98,10231,98,23,0,23,Relationship with Co-workers,5,10231,133,2021-06-23 19:00:02,2021-06-23 19:39:49.927946
7734,101124,6,101124,92,10231,92,22,1,22,Benefits and Compensation,5,10231,133,2021-06-23 19:00:02,2021-06-23 19:39:49.927946
7735,101127,1,101127,99,10231,99,25,0,25,General Satisfaction,5,10231,133,2021-06-23 19:00:02,2021-06-23 19:39:49.927946
7736,101170,4,101170,105,10242,105,24,0,24,Company Administration,5,10242,144,2021-06-23 19:00:04,2021-06-23 19:07:41.965299
7737,101169,5,101169,94,10242,94,23,1,23,Relationship with Co-workers,5,10242,144,2021-06-23 19:00:04,2021-06-23 19:07:41.965299
7738,101168,5,101168,91,10242,91,22,1,22,Benefits and Compensation,5,10242,144,2021-06-23 19:00:04,2021-06-23 19:07:41.965299
7739,101171,2,101171,99,10242,99,25,0,25,General Satisfaction,5,10242,144,2021-06-23 19:00:04,2021-06-23 19:07:41.965299
7740,101178,4,101178,105,10244,105,24,0,24,Company Administration,5,10244,146,2021-06-23 19:00:04,2021-06-23 19:03:00.436776
7741,101177,4,101177,96,10244,96,23,1,23,Relationship with Co-workers,5,10244,146,2021-06-23 19:00:04,2021-06-23 19:03:00.436776
7742,101176,3,101176,90,10244,90,22,1,22,Benefits and Compensation,5,10244,146,2021-06-23 19:00:04,2021-06-23 19:03:00.436776
7743,101179,4,101179,101,10244,101,25,1,25,General Satisfaction,5,10244,146,2021-06-23 19:00:04,2021-06-23 19:03:00.436776
7744,101186,5,101186,105,10246,105,24,0,24,Company Administration,5,10246,148,2021-06-23 19:00:05,2021-06-23 19:04:24.128291
7745,101185,3,101185,98,10246,98,23,0,23,Relationship with Co-workers,5,10246,148,2021-06-23 19:00:05,2021-06-23 19:04:24.128291
7746,101184,5,101184,92,10246,92,22,1,22,Benefits and Compensation,5,10246,148,2021-06-23 19:00:05,2021-06-23 19:04:24.128291
7747,101187,5,101187,101,10246,101,25,1,25,General Satisfaction,5,10246,148,2021-06-23 19:00:05,2021-06-23 19:04:24.128291
7748,101194,2,101194,105,10248,105,24,0,24,Company Administration,5,10248,150,2021-06-23 19:00:05,2021-06-23 19:10:29.633730
7749,101193,2,101193,97,10248,97,23,0,23,Relationship with Co-workers,5,10248,150,2021-06-23 19:00:05,2021-06-23 19:10:29.633730
7750,101192,5,101192,92,10248,92,22,1,22,Benefits and Compensation,5,10248,150,2021-06-23 19:00:05,2021-06-23 19:10:29.633730
7751,101195,4,101195,100,10248,100,25,1,25,General Satisfaction,5,10248,150,2021-06-23 19:00:05,2021-06-23 19:10:29.633730
7752,101440,3,101440,105,10297,105,24,0,24,Company Administration,5,10297,133,2021-06-30 19:00:02,2021-06-30 19:02:56.492125
7753,101439,2,101439,97,10297,97,23,0,23,Relationship with Co-workers,5,10297,133,2021-06-30 19:00:02,2021-06-30 19:02:56.492125
7754,101438,5,101438,92,10297,92,22,1,22,Benefits and Compensation,5,10297,133,2021-06-30 19:00:02,2021-06-30 19:02:56.492125
7755,101441,4,101441,104,10297,104,25,1,25,General Satisfaction,5,10297,133,2021-06-30 19:00:02,2021-06-30 19:02:56.492125
7756,101456,5,101456,105,10301,105,24,0,24,Company Administration,5,10301,137,2021-06-30 19:00:03,2021-06-30 19:02:42.212557
7757,101455,5,101455,95,10301,95,23,1,23,Relationship with Co-workers,5,10301,137,2021-06-30 19:00:03,2021-06-30 19:02:42.212557
7758,101454,5,101454,93,10301,93,22,1,22,Benefits and Compensation,5,10301,137,2021-06-30 19:00:03,2021-06-30 19:02:42.212557
7759,101457,6,101457,100,10301,100,25,1,25,General Satisfaction,5,10301,137,2021-06-30 19:00:03,2021-06-30 19:02:42.212557
7760,101500,2,101500,105,10312,105,24,0,24,Company Administration,5,10312,148,2021-06-30 19:00:05,2021-06-30 19:00:48.367564
7761,101499,3,101499,98,10312,98,23,0,23,Relationship with Co-workers,5,10312,148,2021-06-30 19:00:05,2021-06-30 19:00:48.367564
7762,101498,5,101498,90,10312,90,22,1,22,Benefits and Compensation,5,10312,148,2021-06-30 19:00:05,2021-06-30 19:00:48.367564
7763,101501,5,101501,104,10312,104,25,1,25,General Satisfaction,5,10312,148,2021-06-30 19:00:05,2021-06-30 19:00:48.367564
7764,101504,5,101504,105,10313,105,24,0,24,Company Administration,5,10313,149,2021-06-30 19:00:05,2021-06-30 19:01:41.361467
7765,101503,6,101503,94,10313,94,23,1,23,Relationship with Co-workers,5,10313,149,2021-06-30 19:00:05,2021-06-30 19:01:41.361467
7766,101502,6,101502,90,10313,90,22,1,22,Benefits and Compensation,5,10313,149,2021-06-30 19:00:05,2021-06-30 19:01:41.361467
7767,101505,5,101505,101,10313,101,25,1,25,General Satisfaction,5,10313,149,2021-06-30 19:00:05,2021-06-30 19:01:41.361467
7768,101524,5,101524,105,10318,105,24,0,24,Company Administration,5,10318,154,2021-06-30 19:00:06,2021-06-30 19:01:16.300599
7769,101523,3,101523,97,10318,97,23,0,23,Relationship with Co-workers,5,10318,154,2021-06-30 19:00:06,2021-06-30 19:01:16.300599
7770,101522,6,101522,92,10318,92,22,1,22,Benefits and Compensation,5,10318,154,2021-06-30 19:00:06,2021-06-30 19:01:16.300599
7771,101525,6,101525,102,10318,102,25,1,25,General Satisfaction,5,10318,154,2021-06-30 19:00:06,2021-06-30 19:01:16.300599
7772,102024,5,102024,105,10421,105,24,0,24,Company Administration,5,10421,137,2021-07-14 19:00:02,2021-07-14 19:01:40.880804
7773,102023,5,102023,95,10421,95,23,1,23,Relationship with Co-workers,5,10421,137,2021-07-14 19:00:02,2021-07-14 19:01:40.880804
7774,102022,5,102022,93,10421,93,22,1,22,Benefits and Compensation,5,10421,137,2021-07-14 19:00:02,2021-07-14 19:01:40.880804
7775,102025,6,102025,102,10421,102,25,1,25,General Satisfaction,5,10421,137,2021-07-14 19:00:02,2021-07-14 19:01:40.880804
7776,102028,2,102028,105,10422,105,24,0,24,Company Administration,5,10422,138,2021-07-14 19:00:02,2021-07-14 19:07:02.446458
7777,102027,5,102027,94,10422,94,23,1,23,Relationship with Co-workers,5,10422,138,2021-07-14 19:00:02,2021-07-14 19:07:02.446458
7778,102026,5,102026,90,10422,90,22,1,22,Benefits and Compensation,5,10422,138,2021-07-14 19:00:02,2021-07-14 19:07:02.446458
7779,102029,5,102029,101,10422,101,25,1,25,General Satisfaction,5,10422,138,2021-07-14 19:00:02,2021-07-14 19:07:02.446458
7780,102064,4,102064,105,10431,105,24,0,24,Company Administration,5,10431,147,2021-07-14 19:00:04,2021-07-14 19:05:07.274894
7781,102063,4,102063,95,10431,95,23,1,23,Relationship with Co-workers,5,10431,147,2021-07-14 19:00:04,2021-07-14 19:05:07.274894
7782,102062,3,102062,90,10431,90,22,1,22,Benefits and Compensation,5,10431,147,2021-07-14 19:00:04,2021-07-14 19:05:07.274894
7783,102065,3,102065,99,10431,99,25,0,25,General Satisfaction,5,10431,147,2021-07-14 19:00:04,2021-07-14 19:05:07.274894
7784,102068,4,102068,105,10432,105,24,0,24,Company Administration,5,10432,148,2021-07-14 19:00:04,2021-07-14 19:00:54.709171
7785,102067,2,102067,98,10432,98,23,0,23,Relationship with Co-workers,5,10432,148,2021-07-14 19:00:04,2021-07-14 19:00:54.709171
7786,102066,5,102066,93,10432,93,22,1,22,Benefits and Compensation,5,10432,148,2021-07-14 19:00:04,2021-07-14 19:00:54.709171
7787,102069,4,102069,102,10432,102,25,1,25,General Satisfaction,5,10432,148,2021-07-14 19:00:04,2021-07-14 19:00:54.709171
7788,102088,6,102088,105,10437,105,24,0,24,Company Administration,5,10437,153,2021-07-14 19:00:05,2021-07-14 19:04:35.895414
7789,102087,6,102087,98,10437,98,23,0,23,Relationship with Co-workers,5,10437,153,2021-07-14 19:00:05,2021-07-14 19:04:35.895414
7790,102086,6,102086,92,10437,92,22,1,22,Benefits and Compensation,5,10437,153,2021-07-14 19:00:05,2021-07-14 19:04:35.895414
7791,102089,6,102089,101,10437,101,25,1,25,General Satisfaction,5,10437,153,2021-07-14 19:00:05,2021-07-14 19:04:35.895414
7792,102136,6,102136,105,10447,105,24,0,24,Company Administration,5,10447,130,2021-07-21 19:00:01,2021-07-21 19:11:23.581189
7793,102135,5,102135,97,10447,97,23,0,23,Relationship with Co-workers,5,10447,130,2021-07-21 19:00:01,2021-07-21 19:11:23.581189
7794,102134,5,102134,91,10447,91,22,1,22,Benefits and Compensation,5,10447,130,2021-07-21 19:00:01,2021-07-21 19:11:23.581189
7795,102137,6,102137,103,10447,103,25,1,25,General Satisfaction,5,10447,130,2021-07-21 19:00:01,2021-07-21 19:11:23.581189
7796,102168,5,102168,105,10455,105,24,0,24,Company Administration,5,10455,138,2021-07-21 19:00:03,2021-07-21 19:01:47.788126
7797,102167,5,102167,95,10455,95,23,1,23,Relationship with Co-workers,5,10455,138,2021-07-21 19:00:03,2021-07-21 19:01:47.788126
7798,102166,5,102166,93,10455,93,22,1,22,Benefits and Compensation,5,10455,138,2021-07-21 19:00:03,2021-07-21 19:01:47.788126
7799,102169,5,102169,104,10455,104,25,1,25,General Satisfaction,5,10455,138,2021-07-21 19:00:03,2021-07-21 19:01:47.788126
7800,102200,3,102200,105,10463,105,24,0,24,Company Administration,5,10463,146,2021-07-21 19:00:04,2021-07-21 19:07:46.765835
7801,102199,4,102199,94,10463,94,23,1,23,Relationship with Co-workers,5,10463,146,2021-07-21 19:00:04,2021-07-21 19:07:46.765835
7802,102198,4,102198,92,10463,92,22,1,22,Benefits and Compensation,5,10463,146,2021-07-21 19:00:04,2021-07-21 19:07:46.765835
7803,102201,5,102201,100,10463,100,25,1,25,General Satisfaction,5,10463,146,2021-07-21 19:00:04,2021-07-21 19:07:46.765835
7804,102228,5,102228,105,10470,105,24,0,24,Company Administration,5,10470,153,2021-07-21 19:00:05,2021-07-21 19:13:50.833398
7805,102227,4,102227,94,10470,94,23,1,23,Relationship with Co-workers,5,10470,153,2021-07-21 19:00:05,2021-07-21 19:13:50.833398
7806,102226,6,102226,91,10470,91,22,1,22,Benefits and Compensation,5,10470,153,2021-07-21 19:00:05,2021-07-21 19:13:50.833398
7807,102229,6,102229,99,10470,99,25,0,25,General Satisfaction,5,10470,153,2021-07-21 19:00:05,2021-07-21 19:13:50.833398
7808,102232,4,102232,105,10471,105,24,0,24,Company Administration,5,10471,154,2021-07-21 19:00:06,2021-07-21 19:01:56.169370
7809,102231,5,102231,98,10471,98,23,0,23,Relationship with Co-workers,5,10471,154,2021-07-21 19:00:06,2021-07-21 19:01:56.169370
7810,102230,4,102230,89,10471,89,22,1,22,Benefits and Compensation,5,10471,154,2021-07-21 19:00:06,2021-07-21 19:01:56.169370
7811,102233,6,102233,99,10471,99,25,0,25,General Satisfaction,5,10471,154,2021-07-21 19:00:06,2021-07-21 19:01:56.169370
7812,102288,4,102288,105,10483,105,24,0,24,Company Administration,5,10483,133,2021-07-28 19:00:03,2021-07-28 19:01:00.415648
7813,102287,4,102287,98,10483,98,23,0,23,Relationship with Co-workers,5,10483,133,2021-07-28 19:00:03,2021-07-28 19:01:00.415648
7814,102286,6,102286,92,10483,92,22,1,22,Benefits and Compensation,5,10483,133,2021-07-28 19:00:03,2021-07-28 19:01:00.415648
7815,102289,6,102289,99,10483,99,25,0,25,General Satisfaction,5,10483,133,2021-07-28 19:00:03,2021-07-28 19:01:00.415648
7816,102312,6,102312,105,10489,105,24,0,24,Company Administration,5,10489,139,2021-07-28 19:00:04,2021-07-28 19:30:33.917822
7817,102311,5,102311,97,10489,97,23,0,23,Relationship with Co-workers,5,10489,139,2021-07-28 19:00:04,2021-07-28 19:30:33.917822
7818,102310,4,102310,90,10489,90,22,1,22,Benefits and Compensation,5,10489,139,2021-07-28 19:00:04,2021-07-28 19:30:33.917822
7819,102313,6,102313,104,10489,104,25,1,25,General Satisfaction,5,10489,139,2021-07-28 19:00:04,2021-07-28 19:30:33.917822
7820,102372,5,102372,105,10504,105,24,0,24,Company Administration,5,10504,154,2021-07-28 19:00:07,2021-07-28 19:01:52.302563
7821,102371,3,102371,97,10504,97,23,0,23,Relationship with Co-workers,5,10504,154,2021-07-28 19:00:07,2021-07-28 19:01:52.302563
7822,102370,6,102370,90,10504,90,22,1,22,Benefits and Compensation,5,10504,154,2021-07-28 19:00:07,2021-07-28 19:01:52.302563
7823,102373,5,102373,99,10504,99,25,0,25,General Satisfaction,5,10504,154,2021-07-28 19:00:07,2021-07-28 19:01:52.302563
7824,102444,5,102444,105,10520,105,24,0,24,Company Administration,5,10520,137,2021-08-04 19:00:03,2021-08-04 19:02:50.455992
7825,102443,5,102443,96,10520,96,23,1,23,Relationship with Co-workers,5,10520,137,2021-08-04 19:00:03,2021-08-04 19:02:50.455992
7826,102442,5,102442,91,10520,91,22,1,22,Benefits and Compensation,5,10520,137,2021-08-04 19:00:03,2021-08-04 19:02:50.455992
7827,102445,6,102445,102,10520,102,25,1,25,General Satisfaction,5,10520,137,2021-08-04 19:00:03,2021-08-04 19:02:50.455992
7828,102480,2,102480,105,10529,105,24,0,24,Company Administration,5,10529,146,2021-08-04 19:00:05,2021-08-04 19:01:09.875643
7829,102479,4,102479,96,10529,96,23,1,23,Relationship with Co-workers,5,10529,146,2021-08-04 19:00:05,2021-08-04 19:01:09.875643
7830,102478,4,102478,93,10529,93,22,1,22,Benefits and Compensation,5,10529,146,2021-08-04 19:00:05,2021-08-04 19:01:09.875643
7831,102481,5,102481,101,10529,101,25,1,25,General Satisfaction,5,10529,146,2021-08-04 19:00:05,2021-08-04 19:01:09.875643
7832,102496,2,102496,105,10533,105,24,0,24,Company Administration,5,10533,150,2021-08-04 19:00:06,2021-08-04 19:18:32.115036
7833,102495,5,102495,96,10533,96,23,1,23,Relationship with Co-workers,5,10533,150,2021-08-04 19:00:06,2021-08-04 19:18:32.115036
7834,102494,5,102494,90,10533,90,22,1,22,Benefits and Compensation,5,10533,150,2021-08-04 19:00:06,2021-08-04 19:18:32.115036
7835,102497,4,102497,100,10533,100,25,1,25,General Satisfaction,5,10533,150,2021-08-04 19:00:06,2021-08-04 19:18:32.115036
7836,102666,5,102666,105,10567,105,24,0,24,Company Administration,5,10567,138,2021-08-11 19:00:03,2021-08-11 19:48:47.424898
7837,102665,4,102665,96,10567,96,23,1,23,Relationship with Co-workers,5,10567,138,2021-08-11 19:00:03,2021-08-11 19:48:47.424898
7838,102664,5,102664,92,10567,92,22,1,22,Benefits and Compensation,5,10567,138,2021-08-11 19:00:03,2021-08-11 19:48:47.424898
7839,102667,6,102667,102,10567,102,25,1,25,General Satisfaction,5,10567,138,2021-08-11 19:00:03,2021-08-11 19:48:47.424898
7840,102942,5,102942,105,10621,105,24,0,24,Company Administration,5,10621,133,2021-08-18 19:00:02,2021-08-18 19:01:07.765182
7841,102941,3,102941,97,10621,97,23,0,23,Relationship with Co-workers,5,10621,133,2021-08-18 19:00:02,2021-08-18 19:01:07.765182
7842,102940,5,102940,92,10621,92,22,1,22,Benefits and Compensation,5,10621,133,2021-08-18 19:00:02,2021-08-18 19:01:07.765182
7843,102943,2,102943,99,10621,99,25,0,25,General Satisfaction,5,10621,133,2021-08-18 19:00:02,2021-08-18 19:01:07.765182
7844,102966,6,102966,105,10627,105,24,0,24,Company Administration,5,10627,139,2021-08-18 19:00:03,2021-08-18 19:07:31.924545
7845,102965,5,102965,95,10627,95,23,1,23,Relationship with Co-workers,5,10627,139,2021-08-18 19:00:03,2021-08-18 19:07:31.924545
7846,102964,5,102964,93,10627,93,22,1,22,Benefits and Compensation,5,10627,139,2021-08-18 19:00:03,2021-08-18 19:07:31.924545
7847,102967,6,102967,99,10627,99,25,0,25,General Satisfaction,5,10627,139,2021-08-18 19:00:03,2021-08-18 19:07:31.924545
7848,102994,3,102994,105,10634,105,24,0,24,Company Administration,5,10634,146,2021-08-18 19:00:04,2021-08-18 19:25:46.549383
7849,102993,3,102993,95,10634,95,23,1,23,Relationship with Co-workers,5,10634,146,2021-08-18 19:00:04,2021-08-18 19:25:46.549383
7850,102992,4,102992,89,10634,89,22,1,22,Benefits and Compensation,5,10634,146,2021-08-18 19:00:04,2021-08-18 19:25:46.549383
7851,102995,4,102995,101,10634,101,25,1,25,General Satisfaction,5,10634,146,2021-08-18 19:00:04,2021-08-18 19:25:46.549383
7852,102998,2,102998,105,10635,105,24,0,24,Company Administration,5,10635,147,2021-08-18 19:00:04,2021-08-18 19:02:30.209477
7853,102997,4,102997,98,10635,98,23,0,23,Relationship with Co-workers,5,10635,147,2021-08-18 19:00:04,2021-08-18 19:02:30.209477
7854,102996,4,102996,92,10635,92,22,1,22,Benefits and Compensation,5,10635,147,2021-08-18 19:00:04,2021-08-18 19:02:30.209477
7855,102999,6,102999,104,10635,104,25,1,25,General Satisfaction,5,10635,147,2021-08-18 19:00:04,2021-08-18 19:02:30.209477
7856,103002,4,103002,105,10636,105,24,0,24,Company Administration,5,10636,148,2021-08-18 19:00:04,2021-08-18 19:11:06.926274
7857,103001,2,103001,97,10636,97,23,0,23,Relationship with Co-workers,5,10636,148,2021-08-18 19:00:04,2021-08-18 19:11:06.926274
7858,103000,4,103000,90,10636,90,22,1,22,Benefits and Compensation,5,10636,148,2021-08-18 19:00:04,2021-08-18 19:11:06.926274
7859,103003,4,103003,99,10636,99,25,0,25,General Satisfaction,5,10636,148,2021-08-18 19:00:04,2021-08-18 19:11:06.926274
7860,103010,3,103010,105,10638,105,24,0,24,Company Administration,5,10638,150,2021-08-18 19:00:05,2021-08-18 19:03:20.520816
7861,103009,5,103009,96,10638,96,23,1,23,Relationship with Co-workers,5,10638,150,2021-08-18 19:00:05,2021-08-18 19:03:20.520816
7862,103008,5,103008,91,10638,91,22,1,22,Benefits and Compensation,5,10638,150,2021-08-18 19:00:05,2021-08-18 19:03:20.520816
7863,103011,4,103011,100,10638,100,25,1,25,General Satisfaction,5,10638,150,2021-08-18 19:00:05,2021-08-18 19:03:20.520816
7864,100268,6,100268,108,10050,108,24,1,24,Company Administration,5,10050,130,2021-06-03 18:14:01,2021-06-03 18:17:33.860451
7865,100267,5,100267,95,10050,95,23,1,23,Relationship with Co-workers,5,10050,130,2021-06-03 18:14:01,2021-06-03 18:17:33.860451
7866,100266,6,100266,90,10050,90,22,1,22,Benefits and Compensation,5,10050,130,2021-06-03 18:14:01,2021-06-03 18:17:33.860451
7867,100269,5,100269,101,10050,101,25,1,25,General Satisfaction,5,10050,130,2021-06-03 18:14:01,2021-06-03 18:17:33.860451
7868,100340,4,100340,108,10068,108,24,1,24,Company Administration,5,10068,148,2021-06-03 18:14:04,2021-06-04 01:18:06.825551
7869,100339,4,100339,96,10068,96,23,1,23,Relationship with Co-workers,5,10068,148,2021-06-03 18:14:04,2021-06-04 01:18:06.825551
7870,100338,4,100338,89,10068,89,22,1,22,Benefits and Compensation,5,10068,148,2021-06-03 18:14:04,2021-06-04 01:18:06.825551
7871,100341,5,100341,102,10068,102,25,1,25,General Satisfaction,5,10068,148,2021-06-03 18:14:04,2021-06-04 01:18:06.825551
7872,100348,4,100348,108,10070,108,24,1,24,Company Administration,5,10070,150,2021-06-03 18:14:04,2021-06-03 22:19:45.700258
7873,100347,4,100347,96,10070,96,23,1,23,Relationship with Co-workers,5,10070,150,2021-06-03 18:14:04,2021-06-03 22:19:45.700258
7874,100346,4,100346,91,10070,91,22,1,22,Benefits and Compensation,5,10070,150,2021-06-03 18:14:04,2021-06-03 22:19:45.700258
7875,100349,4,100349,100,10070,100,25,1,25,General Satisfaction,5,10070,150,2021-06-03 18:14:04,2021-06-03 22:19:45.700258
7876,100558,3,100558,108,10114,108,24,1,24,Company Administration,5,10114,146,2021-06-09 19:00:04,2021-06-09 21:45:59.429838
7877,100557,2,100557,95,10114,95,23,1,23,Relationship with Co-workers,5,10114,146,2021-06-09 19:00:04,2021-06-09 21:45:59.429838
7878,100556,2,100556,89,10114,89,22,1,22,Benefits and Compensation,5,10114,146,2021-06-09 19:00:04,2021-06-09 21:45:59.429838
7879,100559,6,100559,103,10114,103,25,1,25,General Satisfaction,5,10114,146,2021-06-09 19:00:04,2021-06-09 21:45:59.429838
7880,100562,4,100562,108,10115,108,24,1,24,Company Administration,5,10115,147,2021-06-09 19:00:05,2021-06-09 19:02:35.798139
7881,100561,5,100561,96,10115,96,23,1,23,Relationship with Co-workers,5,10115,147,2021-06-09 19:00:05,2021-06-09 19:02:35.798139
7882,100560,4,100560,89,10115,89,22,1,22,Benefits and Compensation,5,10115,147,2021-06-09 19:00:05,2021-06-09 19:02:35.798139
7883,100563,4,100563,102,10115,102,25,1,25,General Satisfaction,5,10115,147,2021-06-09 19:00:05,2021-06-09 19:02:35.798139
7884,100566,5,100566,108,10116,108,24,1,24,Company Administration,5,10116,148,2021-06-09 19:00:05,2021-06-09 19:00:46.411105
7885,100565,4,100565,96,10116,96,23,1,23,Relationship with Co-workers,5,10116,148,2021-06-09 19:00:05,2021-06-09 19:00:46.411105
7886,100564,5,100564,92,10116,92,22,1,22,Benefits and Compensation,5,10116,148,2021-06-09 19:00:05,2021-06-09 19:00:46.411105
7887,100567,4,100567,102,10116,102,25,1,25,General Satisfaction,5,10116,148,2021-06-09 19:00:05,2021-06-09 19:00:46.411105
7888,100872,4,100872,108,10180,108,24,1,24,Company Administration,5,10180,148,2021-06-16 19:00:06,2021-06-16 19:01:06.334210
7889,100871,4,100871,95,10180,95,23,1,23,Relationship with Co-workers,5,10180,148,2021-06-16 19:00:06,2021-06-16 19:01:06.334210
7890,100870,5,100870,89,10180,89,22,1,22,Benefits and Compensation,5,10180,148,2021-06-16 19:00:06,2021-06-16 19:01:06.334210
7891,100873,5,100873,102,10180,102,25,1,25,General Satisfaction,5,10180,148,2021-06-16 19:00:06,2021-06-16 19:01:06.334210
7892,100880,4,100880,108,10182,108,24,1,24,Company Administration,5,10182,150,2021-06-16 19:00:06,2021-06-16 19:06:08.992014
7893,100879,5,100879,97,10182,97,23,0,23,Relationship with Co-workers,5,10182,150,2021-06-16 19:00:06,2021-06-16 19:06:08.992014
7894,100878,5,100878,90,10182,90,22,1,22,Benefits and Compensation,5,10182,150,2021-06-16 19:00:06,2021-06-16 19:06:08.992014
7895,100881,3,100881,99,10182,99,25,0,25,General Satisfaction,5,10182,150,2021-06-16 19:00:06,2021-06-16 19:06:08.992014
7896,101190,5,101190,108,10247,108,24,1,24,Company Administration,5,10247,149,2021-06-23 19:00:05,2021-06-23 19:41:31.401201
7897,101189,6,101189,94,10247,94,23,1,23,Relationship with Co-workers,5,10247,149,2021-06-23 19:00:05,2021-06-23 19:41:31.401201
7898,101188,5,101188,92,10247,92,22,1,22,Benefits and Compensation,5,10247,149,2021-06-23 19:00:05,2021-06-23 19:41:31.401201
7899,101191,5,101191,101,10247,101,25,1,25,General Satisfaction,5,10247,149,2021-06-23 19:00:05,2021-06-23 19:41:31.401201
7900,101484,4,101484,108,10308,108,24,1,24,Company Administration,5,10308,144,2021-06-30 19:00:04,2021-06-30 19:33:55.541526
7901,101483,6,101483,95,10308,95,23,1,23,Relationship with Co-workers,5,10308,144,2021-06-30 19:00:04,2021-06-30 19:33:55.541526
7902,101482,6,101482,90,10308,90,22,1,22,Benefits and Compensation,5,10308,144,2021-06-30 19:00:04,2021-06-30 19:33:55.541526
7903,101485,6,101485,103,10308,103,25,1,25,General Satisfaction,5,10308,144,2021-06-30 19:00:04,2021-06-30 19:33:55.541526
7904,101508,4,101508,108,10314,108,24,1,24,Company Administration,5,10314,150,2021-06-30 19:00:05,2021-06-30 19:23:00.139514
7905,101507,3,101507,95,10314,95,23,1,23,Relationship with Co-workers,5,10314,150,2021-06-30 19:00:05,2021-06-30 19:23:00.139514
7906,101506,5,101506,89,10314,89,22,1,22,Benefits and Compensation,5,10314,150,2021-06-30 19:00:05,2021-06-30 19:23:00.139514
7907,101509,2,101509,101,10314,101,25,1,25,General Satisfaction,5,10314,150,2021-06-30 19:00:05,2021-06-30 19:23:00.139514
7908,101742,5,101742,108,10360,108,24,1,24,Company Administration,5,10360,130,2021-07-07 19:00:01,2021-07-07 19:03:37.988048
7909,101741,3,101741,97,10360,97,23,0,23,Relationship with Co-workers,5,10360,130,2021-07-07 19:00:01,2021-07-07 19:03:37.988048
7910,101740,6,101740,92,10360,92,22,1,22,Benefits and Compensation,5,10360,130,2021-07-07 19:00:01,2021-07-07 19:03:37.988048
7911,101743,6,101743,103,10360,103,25,1,25,General Satisfaction,5,10360,130,2021-07-07 19:00:01,2021-07-07 19:03:37.988048
7912,101754,3,101754,108,10363,108,24,1,24,Company Administration,5,10363,133,2021-07-07 19:00:02,2021-07-07 19:14:24.469019
7913,101753,3,101753,94,10363,94,23,1,23,Relationship with Co-workers,5,10363,133,2021-07-07 19:00:02,2021-07-07 19:14:24.469019
7914,101752,6,101752,93,10363,93,22,1,22,Benefits and Compensation,5,10363,133,2021-07-07 19:00:02,2021-07-07 19:14:24.469019
7915,101755,4,101755,103,10363,103,25,1,25,General Satisfaction,5,10363,133,2021-07-07 19:00:02,2021-07-07 19:14:24.469019
7916,101806,4,101806,108,10376,108,24,1,24,Company Administration,5,10376,146,2021-07-07 19:00:04,2021-07-07 19:01:30.824050
7917,101805,3,101805,95,10376,95,23,1,23,Relationship with Co-workers,5,10376,146,2021-07-07 19:00:04,2021-07-07 19:01:30.824050
7918,101804,3,101804,93,10376,93,22,1,22,Benefits and Compensation,5,10376,146,2021-07-07 19:00:04,2021-07-07 19:01:30.824050
7919,101807,4,101807,101,10376,101,25,1,25,General Satisfaction,5,10376,146,2021-07-07 19:00:04,2021-07-07 19:01:30.824050
7920,101810,4,101810,108,10377,108,24,1,24,Company Administration,5,10377,147,2021-07-07 19:00:04,2021-07-07 19:11:26.032622
7921,101809,5,101809,94,10377,94,23,1,23,Relationship with Co-workers,5,10377,147,2021-07-07 19:00:04,2021-07-07 19:11:26.032622
7922,101808,4,101808,93,10377,93,22,1,22,Benefits and Compensation,5,10377,147,2021-07-07 19:00:04,2021-07-07 19:11:26.032622
7923,101811,6,101811,103,10377,103,25,1,25,General Satisfaction,5,10377,147,2021-07-07 19:00:04,2021-07-07 19:11:26.032622
7924,101814,5,101814,108,10378,108,24,1,24,Company Administration,5,10378,148,2021-07-07 19:00:04,2021-07-07 19:00:48.562395
7925,101813,4,101813,94,10378,94,23,1,23,Relationship with Co-workers,5,10378,148,2021-07-07 19:00:04,2021-07-07 19:00:48.562395
7926,101812,5,101812,91,10378,91,22,1,22,Benefits and Compensation,5,10378,148,2021-07-07 19:00:04,2021-07-07 19:00:48.562395
7927,101815,5,101815,99,10378,99,25,0,25,General Satisfaction,5,10378,148,2021-07-07 19:00:04,2021-07-07 19:00:48.562395
7928,101822,4,101822,108,10380,108,24,1,24,Company Administration,5,10380,150,2021-07-07 19:00:05,2021-07-07 19:01:14.751292
7929,101821,3,101821,95,10380,95,23,1,23,Relationship with Co-workers,5,10380,150,2021-07-07 19:00:05,2021-07-07 19:01:14.751292
7930,101820,5,101820,92,10380,92,22,1,22,Benefits and Compensation,5,10380,150,2021-07-07 19:00:05,2021-07-07 19:01:14.751292
7931,101823,4,101823,99,10380,99,25,0,25,General Satisfaction,5,10380,150,2021-07-07 19:00:05,2021-07-07 19:01:14.751292
7932,101838,5,101838,108,10384,108,24,1,24,Company Administration,5,10384,154,2021-07-07 19:00:05,2021-07-07 21:02:31.229716
7933,101837,5,101837,96,10384,96,23,1,23,Relationship with Co-workers,5,10384,154,2021-07-07 19:00:05,2021-07-07 21:02:31.229716
7934,101836,6,101836,91,10384,91,22,1,22,Benefits and Compensation,5,10384,154,2021-07-07 19:00:05,2021-07-07 21:02:31.229716
7935,101839,5,101839,104,10384,104,25,1,25,General Satisfaction,5,10384,154,2021-07-07 19:00:05,2021-07-07 21:02:31.229716
7936,102000,5,102000,108,10415,108,24,1,24,Company Administration,5,10415,131,2021-07-14 19:00:01,2021-07-14 19:04:43.526458
7937,101999,3,101999,97,10415,97,23,0,23,Relationship with Co-workers,5,10415,131,2021-07-14 19:00:01,2021-07-14 19:04:43.526458
7938,101998,2,101998,92,10415,92,22,1,22,Benefits and Compensation,5,10415,131,2021-07-14 19:00:01,2021-07-14 19:04:43.526458
7939,102001,4,102001,104,10415,104,25,1,25,General Satisfaction,5,10415,131,2021-07-14 19:00:01,2021-07-14 19:04:43.526458
7940,102076,4,102076,108,10434,108,24,1,24,Company Administration,5,10434,150,2021-07-14 19:00:04,2021-07-14 19:01:35.337798
7941,102075,4,102075,94,10434,94,23,1,23,Relationship with Co-workers,5,10434,150,2021-07-14 19:00:04,2021-07-14 19:01:35.337798
7942,102074,5,102074,93,10434,93,22,1,22,Benefits and Compensation,5,10434,150,2021-07-14 19:00:04,2021-07-14 19:01:35.337798
7943,102077,4,102077,100,10434,100,25,1,25,General Satisfaction,5,10434,150,2021-07-14 19:00:04,2021-07-14 19:01:35.337798
7944,102080,2,102080,108,10435,108,24,1,24,Company Administration,5,10435,151,2021-07-14 19:00:04,2021-07-15 17:16:40.906545
7945,102079,6,102079,95,10435,95,23,1,23,Relationship with Co-workers,5,10435,151,2021-07-14 19:00:04,2021-07-15 17:16:40.906545
7946,102078,5,102078,89,10435,89,22,1,22,Benefits and Compensation,5,10435,151,2021-07-14 19:00:04,2021-07-15 17:16:40.906545
7947,102081,4,102081,99,10435,99,25,0,25,General Satisfaction,5,10435,151,2021-07-14 19:00:04,2021-07-15 17:16:40.906545
7948,102092,5,102092,108,10438,108,24,1,24,Company Administration,5,10438,154,2021-07-14 19:00:05,2021-07-14 19:00:56.633061
7949,102091,5,102091,94,10438,94,23,1,23,Relationship with Co-workers,5,10438,154,2021-07-14 19:00:05,2021-07-14 19:00:56.633061
7950,102090,5,102090,89,10438,89,22,1,22,Benefits and Compensation,5,10438,154,2021-07-14 19:00:05,2021-07-14 19:00:56.633061
7951,102093,6,102093,103,10438,103,25,1,25,General Satisfaction,5,10438,154,2021-07-14 19:00:05,2021-07-14 19:00:56.633061
7952,102212,5,102212,108,10466,108,24,1,24,Company Administration,5,10466,149,2021-07-21 19:00:05,2021-07-21 19:02:24.544241
7953,102211,5,102211,94,10466,94,23,1,23,Relationship with Co-workers,5,10466,149,2021-07-21 19:00:05,2021-07-21 19:02:24.544241
7954,102210,6,102210,89,10466,89,22,1,22,Benefits and Compensation,5,10466,149,2021-07-21 19:00:05,2021-07-21 19:02:24.544241
7955,102213,5,102213,103,10466,103,25,1,25,General Satisfaction,5,10466,149,2021-07-21 19:00:05,2021-07-21 19:02:24.544241
7956,102344,4,102344,108,10497,108,24,1,24,Company Administration,5,10497,147,2021-07-28 19:00:05,2021-07-28 19:31:35.401586
7957,102343,4,102343,98,10497,98,23,0,23,Relationship with Co-workers,5,10497,147,2021-07-28 19:00:05,2021-07-28 19:31:35.401586
7958,102342,4,102342,93,10497,93,22,1,22,Benefits and Compensation,5,10497,147,2021-07-28 19:00:05,2021-07-28 19:31:35.401586
7959,102345,4,102345,99,10497,99,25,0,25,General Satisfaction,5,10497,147,2021-07-28 19:00:05,2021-07-28 19:31:35.401586
7960,102352,5,102352,108,10499,108,24,1,24,Company Administration,5,10499,149,2021-07-28 19:00:06,2021-07-28 19:01:01.661896
7961,102351,5,102351,98,10499,98,23,0,23,Relationship with Co-workers,5,10499,149,2021-07-28 19:00:06,2021-07-28 19:01:01.661896
7962,102350,6,102350,92,10499,92,22,1,22,Benefits and Compensation,5,10499,149,2021-07-28 19:00:06,2021-07-28 19:01:01.661896
7963,102353,5,102353,103,10499,103,25,1,25,General Satisfaction,5,10499,149,2021-07-28 19:00:06,2021-07-28 19:01:01.661896
7964,102360,3,102360,108,10501,108,24,1,24,Company Administration,5,10501,151,2021-07-28 19:00:06,2021-07-28 19:03:16.533875
7965,102359,6,102359,94,10501,94,23,1,23,Relationship with Co-workers,5,10501,151,2021-07-28 19:00:06,2021-07-28 19:03:16.533875
7966,102358,4,102358,90,10501,90,22,1,22,Benefits and Compensation,5,10501,151,2021-07-28 19:00:06,2021-07-28 19:03:16.533875
7967,102361,5,102361,103,10501,103,25,1,25,General Satisfaction,5,10501,151,2021-07-28 19:00:06,2021-07-28 19:03:16.533875
7968,102428,4,102428,108,10516,108,24,1,24,Company Administration,5,10516,133,2021-08-04 19:00:02,2021-08-04 19:01:02.091529
7969,102427,2,102427,97,10516,97,23,0,23,Relationship with Co-workers,5,10516,133,2021-08-04 19:00:02,2021-08-04 19:01:02.091529
7970,102426,5,102426,89,10516,89,22,1,22,Benefits and Compensation,5,10516,133,2021-08-04 19:00:02,2021-08-04 19:01:02.091529
7971,102429,1,102429,101,10516,101,25,1,25,General Satisfaction,5,10516,133,2021-08-04 19:00:02,2021-08-04 19:01:02.091529
7972,102512,5,102512,108,10537,108,24,1,24,Company Administration,5,10537,154,2021-08-04 19:00:06,2021-08-04 19:02:03.820002
7973,102511,5,102511,98,10537,98,23,0,23,Relationship with Co-workers,5,10537,154,2021-08-04 19:00:06,2021-08-04 19:02:03.820002
7974,102510,6,102510,89,10537,89,22,1,22,Benefits and Compensation,5,10537,154,2021-08-04 19:00:06,2021-08-04 19:02:03.820002
7975,102513,5,102513,101,10537,101,25,1,25,General Satisfaction,5,10537,154,2021-08-04 19:00:06,2021-08-04 19:02:03.820002
7976,102638,5,102638,108,10560,108,24,1,24,Company Administration,5,10560,131,2021-08-11 19:00:02,2021-08-11 19:02:49.432167
7977,102637,5,102637,97,10560,97,23,0,23,Relationship with Co-workers,5,10560,131,2021-08-11 19:00:02,2021-08-11 19:02:49.432167
7978,102636,4,102636,90,10560,90,22,1,22,Benefits and Compensation,5,10560,131,2021-08-11 19:00:02,2021-08-11 19:02:49.432167
7979,102639,3,102639,100,10560,100,25,1,25,General Satisfaction,5,10560,131,2021-08-11 19:00:02,2021-08-11 19:02:49.432167
7980,102710,5,102710,108,10578,108,24,1,24,Company Administration,5,10578,149,2021-08-11 19:00:05,2021-08-11 19:23:19.269844
7981,102709,5,102709,94,10578,94,23,1,23,Relationship with Co-workers,5,10578,149,2021-08-11 19:00:05,2021-08-11 19:23:19.269844
7982,102708,6,102708,90,10578,90,22,1,22,Benefits and Compensation,5,10578,149,2021-08-11 19:00:05,2021-08-11 19:23:19.269844
7983,102711,6,102711,99,10578,99,25,0,25,General Satisfaction,5,10578,149,2021-08-11 19:00:05,2021-08-11 19:23:19.269844
7984,102958,5,102958,108,10625,108,24,1,24,Company Administration,5,10625,137,2021-08-18 19:00:02,2021-08-18 19:00:56.282319
7985,102957,5,102957,96,10625,96,23,1,23,Relationship with Co-workers,5,10625,137,2021-08-18 19:00:02,2021-08-18 19:00:56.282319
7986,102956,5,102956,91,10625,91,22,1,22,Benefits and Compensation,5,10625,137,2021-08-18 19:00:02,2021-08-18 19:00:56.282319
7987,102959,5,102959,104,10625,104,25,1,25,General Satisfaction,5,10625,137,2021-08-18 19:00:02,2021-08-18 19:00:56.282319
7988,103006,5,103006,108,10637,108,24,1,24,Company Administration,5,10637,149,2021-08-18 19:00:04,2021-08-18 19:01:18.473859
7989,103005,5,103005,96,10637,96,23,1,23,Relationship with Co-workers,5,10637,149,2021-08-18 19:00:04,2021-08-18 19:01:18.473859
7990,103004,5,103004,91,10637,91,22,1,22,Benefits and Compensation,5,10637,149,2021-08-18 19:00:04,2021-08-18 19:01:18.473859
7991,103007,5,103007,104,10637,104,25,1,25,General Satisfaction,5,10637,149,2021-08-18 19:00:04,2021-08-18 19:01:18.473859
7992,103014,3,103014,108,10639,108,24,1,24,Company Administration,5,10639,151,2021-08-18 19:00:05,2021-08-18 19:16:56.913740
7993,103013,5,103013,94,10639,94,23,1,23,Relationship with Co-workers,5,10639,151,2021-08-18 19:00:05,2021-08-18 19:16:56.913740
7994,103012,5,103012,91,10639,91,22,1,22,Benefits and Compensation,5,10639,151,2021-08-18 19:00:05,2021-08-18 19:16:56.913740
7995,103015,5,103015,102,10639,102,25,1,25,General Satisfaction,5,10639,151,2021-08-18 19:00:05,2021-08-18 19:16:56.913740
7996,100272,5,100272,107,10051,107,24,1,24,Company Administration,5,10051,131,2021-06-03 18:14:01,2021-06-03 18:24:17.145780
7997,100271,6,100271,95,10051,95,23,1,23,Relationship with Co-workers,5,10051,131,2021-06-03 18:14:01,2021-06-03 18:24:17.145780
7998,100270,4,100270,92,10051,92,22,1,22,Benefits and Compensation,5,10051,131,2021-06-03 18:14:01,2021-06-03 18:24:17.145780
7999,100273,6,100273,103,10051,103,25,1,25,General Satisfaction,5,10051,131,2021-06-03 18:14:01,2021-06-03 18:24:17.145780
8000,100304,6,100304,107,10059,107,24,1,24,Company Administration,5,10059,139,2021-06-03 18:14:02,2021-06-03 18:17:12.457095
8001,100303,6,100303,95,10059,95,23,1,23,Relationship with Co-workers,5,10059,139,2021-06-03 18:14:02,2021-06-03 18:17:12.457095
8002,100302,6,100302,93,10059,93,22,1,22,Benefits and Compensation,5,10059,139,2021-06-03 18:14:02,2021-06-03 18:17:12.457095
8003,100305,6,100305,100,10059,100,25,1,25,General Satisfaction,5,10059,139,2021-06-03 18:14:02,2021-06-03 18:17:12.457095
8004,100352,2,100352,107,10071,107,24,1,24,Company Administration,5,10071,151,2021-06-03 18:14:04,2021-06-03 18:16:35.093720
8005,100351,5,100351,97,10071,97,23,0,23,Relationship with Co-workers,5,10071,151,2021-06-03 18:14:04,2021-06-03 18:16:35.093720
8006,100350,5,100350,92,10071,92,22,1,22,Benefits and Compensation,5,10071,151,2021-06-03 18:14:04,2021-06-03 18:16:35.093720
8007,100353,1,100353,101,10071,101,25,1,25,General Satisfaction,5,10071,151,2021-06-03 18:14:04,2021-06-03 18:16:35.093720
8008,100526,4,100526,107,10106,107,24,1,24,Company Administration,5,10106,138,2021-06-09 19:00:03,2021-06-09 19:01:01.404121
8009,100525,4,100525,94,10106,94,23,1,23,Relationship with Co-workers,5,10106,138,2021-06-09 19:00:03,2021-06-09 19:01:01.404121
8010,100524,4,100524,90,10106,90,22,1,22,Benefits and Compensation,5,10106,138,2021-06-09 19:00:03,2021-06-09 19:01:01.404121
8011,100527,6,100527,101,10106,101,25,1,25,General Satisfaction,5,10106,138,2021-06-09 19:00:03,2021-06-09 19:01:01.404121
8012,100574,4,100574,107,10118,107,24,1,24,Company Administration,5,10118,150,2021-06-09 19:00:05,2021-06-09 19:02:20.064478
8013,100573,2,100573,97,10118,97,23,0,23,Relationship with Co-workers,5,10118,150,2021-06-09 19:00:05,2021-06-09 19:02:20.064478
8014,100572,4,100572,90,10118,90,22,1,22,Benefits and Compensation,5,10118,150,2021-06-09 19:00:05,2021-06-09 19:02:20.064478
8015,100575,4,100575,100,10118,100,25,1,25,General Satisfaction,5,10118,150,2021-06-09 19:00:05,2021-06-09 19:02:20.064478
8016,100808,4,100808,107,10164,107,24,1,24,Company Administration,5,10164,132,2021-06-16 19:00:02,2021-06-16 23:35:59.659473
8017,100807,4,100807,95,10164,95,23,1,23,Relationship with Co-workers,5,10164,132,2021-06-16 19:00:02,2021-06-16 23:35:59.659473
8018,100806,3,100806,89,10164,89,22,1,22,Benefits and Compensation,5,10164,132,2021-06-16 19:00:02,2021-06-16 23:35:59.659473
8019,100809,5,100809,103,10164,103,25,1,25,General Satisfaction,5,10164,132,2021-06-16 19:00:02,2021-06-16 23:35:59.659473
8020,100824,5,100824,107,10168,107,24,1,24,Company Administration,5,10168,136,2021-06-16 19:00:04,2021-06-16 19:01:45.021537
8021,100823,3,100823,98,10168,98,23,0,23,Relationship with Co-workers,5,10168,136,2021-06-16 19:00:04,2021-06-16 19:01:45.021537
8022,100822,4,100822,90,10168,90,22,1,22,Benefits and Compensation,5,10168,136,2021-06-16 19:00:04,2021-06-16 19:01:45.021537
8023,100825,5,100825,103,10168,103,25,1,25,General Satisfaction,5,10168,136,2021-06-16 19:00:04,2021-06-16 19:01:45.021537
8024,100828,6,100828,107,10169,107,24,1,24,Company Administration,5,10169,137,2021-06-16 19:00:04,2021-06-16 19:07:12.928532
8025,100827,6,100827,94,10169,94,23,1,23,Relationship with Co-workers,5,10169,137,2021-06-16 19:00:04,2021-06-16 19:07:12.928532
8026,100826,5,100826,91,10169,91,22,1,22,Benefits and Compensation,5,10169,137,2021-06-16 19:00:04,2021-06-16 19:07:12.928532
8027,100829,6,100829,102,10169,102,25,1,25,General Satisfaction,5,10169,137,2021-06-16 19:00:04,2021-06-16 19:07:12.928532
8028,100864,4,100864,107,10178,107,24,1,24,Company Administration,5,10178,146,2021-06-16 19:00:06,2021-06-16 19:13:47.161637
8029,100863,4,100863,95,10178,95,23,1,23,Relationship with Co-workers,5,10178,146,2021-06-16 19:00:06,2021-06-16 19:13:47.161637
8030,100862,5,100862,93,10178,93,22,1,22,Benefits and Compensation,5,10178,146,2021-06-16 19:00:06,2021-06-16 19:13:47.161637
8031,100865,2,100865,99,10178,99,25,0,25,General Satisfaction,5,10178,146,2021-06-16 19:00:06,2021-06-16 19:13:47.161637
8032,101118,5,101118,107,10229,107,24,1,24,Company Administration,5,10229,131,2021-06-23 19:00:02,2021-06-23 19:06:21.738155
8033,101117,5,101117,98,10229,98,23,0,23,Relationship with Co-workers,5,10229,131,2021-06-23 19:00:02,2021-06-23 19:06:21.738155
8034,101116,4,101116,90,10229,90,22,1,22,Benefits and Compensation,5,10229,131,2021-06-23 19:00:02,2021-06-23 19:06:21.738155
8035,101119,5,101119,100,10229,100,25,1,25,General Satisfaction,5,10229,131,2021-06-23 19:00:02,2021-06-23 19:06:21.738155
8036,101142,4,101142,107,10235,107,24,1,24,Company Administration,5,10235,137,2021-06-23 19:00:03,2021-06-23 19:41:00.050777
8037,101141,5,101141,95,10235,95,23,1,23,Relationship with Co-workers,5,10235,137,2021-06-23 19:00:03,2021-06-23 19:41:00.050777
8038,101140,5,101140,90,10235,90,22,1,22,Benefits and Compensation,5,10235,137,2021-06-23 19:00:03,2021-06-23 19:41:00.050777
8039,101143,5,101143,104,10235,104,25,1,25,General Satisfaction,5,10235,137,2021-06-23 19:00:03,2021-06-23 19:41:00.050777
8040,101428,6,101428,107,10294,107,24,1,24,Company Administration,5,10294,130,2021-06-30 19:00:01,2021-06-30 19:00:47.771719
8041,101427,5,101427,98,10294,98,23,0,23,Relationship with Co-workers,5,10294,130,2021-06-30 19:00:01,2021-06-30 19:00:47.771719
8042,101426,5,101426,91,10294,91,22,1,22,Benefits and Compensation,5,10294,130,2021-06-30 19:00:01,2021-06-30 19:00:47.771719
8043,101429,5,101429,101,10294,101,25,1,25,General Satisfaction,5,10294,130,2021-06-30 19:00:01,2021-06-30 19:00:47.771719
8044,101432,4,101432,107,10295,107,24,1,24,Company Administration,5,10295,131,2021-06-30 19:00:02,2021-06-30 19:07:38.009735
8045,101431,5,101431,94,10295,94,23,1,23,Relationship with Co-workers,5,10295,131,2021-06-30 19:00:02,2021-06-30 19:07:38.009735
8046,101430,4,101430,93,10295,93,22,1,22,Benefits and Compensation,5,10295,131,2021-06-30 19:00:02,2021-06-30 19:07:38.009735
8047,101433,6,101433,103,10295,103,25,1,25,General Satisfaction,5,10295,131,2021-06-30 19:00:02,2021-06-30 19:07:38.009735
8048,101452,4,101452,107,10300,107,24,1,24,Company Administration,5,10300,136,2021-06-30 19:00:03,2021-06-30 19:13:25.945336
8049,101451,4,101451,94,10300,94,23,1,23,Relationship with Co-workers,5,10300,136,2021-06-30 19:00:03,2021-06-30 19:13:25.945336
8050,101450,4,101450,91,10300,91,22,1,22,Benefits and Compensation,5,10300,136,2021-06-30 19:00:03,2021-06-30 19:13:25.945336
8051,101453,5,101453,100,10300,100,25,1,25,General Satisfaction,5,10300,136,2021-06-30 19:00:03,2021-06-30 19:13:25.945336
8052,101460,5,101460,107,10302,107,24,1,24,Company Administration,5,10302,138,2021-06-30 19:00:03,2021-06-30 19:01:11.159085
8053,101459,5,101459,94,10302,94,23,1,23,Relationship with Co-workers,5,10302,138,2021-06-30 19:00:03,2021-06-30 19:01:11.159085
8054,101458,5,101458,90,10302,90,22,1,22,Benefits and Compensation,5,10302,138,2021-06-30 19:00:03,2021-06-30 19:01:11.159085
8055,101461,5,101461,102,10302,102,25,1,25,General Satisfaction,5,10302,138,2021-06-30 19:00:03,2021-06-30 19:01:11.159085
8056,101492,3,101492,107,10310,107,24,1,24,Company Administration,5,10310,146,2021-06-30 19:00:05,2021-06-30 20:36:29.898933
8057,101491,3,101491,95,10310,95,23,1,23,Relationship with Co-workers,5,10310,146,2021-06-30 19:00:05,2021-06-30 20:36:29.898933
8058,101490,3,101490,93,10310,93,22,1,22,Benefits and Compensation,5,10310,146,2021-06-30 19:00:05,2021-06-30 20:36:29.898933
8059,101493,4,101493,101,10310,101,25,1,25,General Satisfaction,5,10310,146,2021-06-30 19:00:05,2021-06-30 20:36:29.898933
8060,101746,4,101746,107,10361,107,24,1,24,Company Administration,5,10361,131,2021-07-07 19:00:01,2021-07-07 19:35:46.940482
8061,101745,5,101745,94,10361,94,23,1,23,Relationship with Co-workers,5,10361,131,2021-07-07 19:00:01,2021-07-07 19:35:46.940482
8062,101744,3,101744,92,10361,92,22,1,22,Benefits and Compensation,5,10361,131,2021-07-07 19:00:01,2021-07-07 19:35:46.940482
8063,101747,5,101747,104,10361,104,25,1,25,General Satisfaction,5,10361,131,2021-07-07 19:00:01,2021-07-07 19:35:46.940482
8064,101774,5,101774,107,10368,107,24,1,24,Company Administration,5,10368,138,2021-07-07 19:00:02,2021-07-07 19:01:13.245906
8065,101773,5,101773,95,10368,95,23,1,23,Relationship with Co-workers,5,10368,138,2021-07-07 19:00:02,2021-07-07 19:01:13.245906
8066,101772,5,101772,93,10368,93,22,1,22,Benefits and Compensation,5,10368,138,2021-07-07 19:00:02,2021-07-07 19:01:13.245906
8067,101775,5,101775,99,10368,99,25,0,25,General Satisfaction,5,10368,138,2021-07-07 19:00:02,2021-07-07 19:01:13.245906
8068,101826,1,101826,107,10381,107,24,1,24,Company Administration,5,10381,151,2021-07-07 19:00:05,2021-07-07 20:55:29.703133
8069,101825,5,101825,97,10381,97,23,0,23,Relationship with Co-workers,5,10381,151,2021-07-07 19:00:05,2021-07-07 20:55:29.703133
8070,101824,5,101824,92,10381,92,22,1,22,Benefits and Compensation,5,10381,151,2021-07-07 19:00:05,2021-07-07 20:55:29.703133
8071,101827,5,101827,102,10381,102,25,1,25,General Satisfaction,5,10381,151,2021-07-07 19:00:05,2021-07-07 20:55:29.703133
8072,101996,5,101996,107,10414,107,24,1,24,Company Administration,5,10414,130,2021-07-14 19:00:01,2021-07-14 19:02:45.888139
8073,101995,5,101995,98,10414,98,23,0,23,Relationship with Co-workers,5,10414,130,2021-07-14 19:00:01,2021-07-14 19:02:45.888139
8074,101994,5,101994,89,10414,89,22,1,22,Benefits and Compensation,5,10414,130,2021-07-14 19:00:01,2021-07-14 19:02:45.888139
8075,101997,5,101997,101,10414,101,25,1,25,General Satisfaction,5,10414,130,2021-07-14 19:00:01,2021-07-14 19:02:45.888139
8076,102052,5,102052,107,10428,107,24,1,24,Company Administration,5,10428,144,2021-07-14 19:00:03,2021-07-14 19:07:55.827408
8077,102051,5,102051,94,10428,94,23,1,23,Relationship with Co-workers,5,10428,144,2021-07-14 19:00:03,2021-07-14 19:07:55.827408
8078,102050,5,102050,93,10428,93,22,1,22,Benefits and Compensation,5,10428,144,2021-07-14 19:00:03,2021-07-14 19:07:55.827408
8079,102053,5,102053,101,10428,101,25,1,25,General Satisfaction,5,10428,144,2021-07-14 19:00:03,2021-07-14 19:07:55.827408
8080,102172,6,102172,107,10456,107,24,1,24,Company Administration,5,10456,139,2021-07-21 19:00:03,2021-07-21 19:12:40.755247
8081,102171,6,102171,96,10456,96,23,1,23,Relationship with Co-workers,5,10456,139,2021-07-21 19:00:03,2021-07-21 19:12:40.755247
8082,102170,4,102170,92,10456,92,22,1,22,Benefits and Compensation,5,10456,139,2021-07-21 19:00:03,2021-07-21 19:12:40.755247
8083,102173,6,102173,104,10456,104,25,1,25,General Satisfaction,5,10456,139,2021-07-21 19:00:03,2021-07-21 19:12:40.755247
8084,102208,5,102208,107,10465,107,24,1,24,Company Administration,5,10465,148,2021-07-21 19:00:05,2021-07-21 19:03:41.197699
8085,102207,3,102207,95,10465,95,23,1,23,Relationship with Co-workers,5,10465,148,2021-07-21 19:00:05,2021-07-21 19:03:41.197699
8086,102206,5,102206,89,10465,89,22,1,22,Benefits and Compensation,5,10465,148,2021-07-21 19:00:05,2021-07-21 19:03:41.197699
8087,102209,5,102209,99,10465,99,25,0,25,General Satisfaction,5,10465,148,2021-07-21 19:00:05,2021-07-21 19:03:41.197699
8088,102348,4,102348,107,10498,107,24,1,24,Company Administration,5,10498,148,2021-07-28 19:00:05,2021-07-28 19:00:53.339478
8089,102347,3,102347,98,10498,98,23,0,23,Relationship with Co-workers,5,10498,148,2021-07-28 19:00:05,2021-07-28 19:00:53.339478
8090,102346,4,102346,93,10498,93,22,1,22,Benefits and Compensation,5,10498,148,2021-07-28 19:00:05,2021-07-28 19:00:53.339478
8091,102349,5,102349,103,10498,103,25,1,25,General Satisfaction,5,10498,148,2021-07-28 19:00:05,2021-07-28 19:00:53.339478
8092,102416,6,102416,107,10513,107,24,1,24,Company Administration,5,10513,130,2021-08-04 19:00:01,2021-08-04 19:02:26.619154
8093,102415,5,102415,95,10513,95,23,1,23,Relationship with Co-workers,5,10513,130,2021-08-04 19:00:01,2021-08-04 19:02:26.619154
8094,102414,4,102414,91,10513,91,22,1,22,Benefits and Compensation,5,10513,130,2021-08-04 19:00:01,2021-08-04 19:02:26.619154
8095,102417,5,102417,101,10513,101,25,1,25,General Satisfaction,5,10513,130,2021-08-04 19:00:01,2021-08-04 19:02:26.619154
8096,102488,4,102488,107,10531,107,24,1,24,Company Administration,5,10531,148,2021-08-04 19:00:05,2021-08-04 19:00:42.358861
8097,102487,3,102487,95,10531,95,23,1,23,Relationship with Co-workers,5,10531,148,2021-08-04 19:00:05,2021-08-04 19:00:42.358861
8098,102486,5,102486,92,10531,92,22,1,22,Benefits and Compensation,5,10531,148,2021-08-04 19:00:05,2021-08-04 19:00:42.358861
8099,102489,5,102489,104,10531,104,25,1,25,General Satisfaction,5,10531,148,2021-08-04 19:00:05,2021-08-04 19:00:42.358861
8100,102662,5,102662,107,10566,107,24,1,24,Company Administration,5,10566,137,2021-08-11 19:00:03,2021-08-11 19:23:42.606311
8101,102661,5,102661,95,10566,95,23,1,23,Relationship with Co-workers,5,10566,137,2021-08-11 19:00:03,2021-08-11 19:23:42.606311
8102,102660,6,102660,91,10566,91,22,1,22,Benefits and Compensation,5,10566,137,2021-08-11 19:00:03,2021-08-11 19:23:42.606311
8103,102663,5,102663,103,10566,103,25,1,25,General Satisfaction,5,10566,137,2021-08-11 19:00:03,2021-08-11 19:23:42.606311
8104,102670,6,102670,107,10568,107,24,1,24,Company Administration,5,10568,139,2021-08-11 19:00:03,2021-08-11 19:43:42.147316
8105,102669,4,102669,97,10568,97,23,0,23,Relationship with Co-workers,5,10568,139,2021-08-11 19:00:03,2021-08-11 19:43:42.147316
8106,102668,6,102668,92,10568,92,22,1,22,Benefits and Compensation,5,10568,139,2021-08-11 19:00:03,2021-08-11 19:43:42.147316
8107,102671,6,102671,103,10568,103,25,1,25,General Satisfaction,5,10568,139,2021-08-11 19:00:03,2021-08-11 19:43:42.147316
8108,102930,6,102930,107,10618,107,24,1,24,Company Administration,5,10618,130,2021-08-18 19:00:01,2021-08-18 19:00:49.091032
8109,102929,3,102929,97,10618,97,23,0,23,Relationship with Co-workers,5,10618,130,2021-08-18 19:00:01,2021-08-18 19:00:49.091032
8110,102928,5,102928,91,10618,91,22,1,22,Benefits and Compensation,5,10618,130,2021-08-18 19:00:01,2021-08-18 19:00:49.091032
8111,102931,5,102931,101,10618,101,25,1,25,General Satisfaction,5,10618,130,2021-08-18 19:00:01,2021-08-18 19:00:49.091032
8112,103026,5,103026,107,10642,107,24,1,24,Company Administration,5,10642,154,2021-08-18 19:00:05,2021-08-18 19:01:45.749179
8113,103025,5,103025,94,10642,94,23,1,23,Relationship with Co-workers,5,10642,154,2021-08-18 19:00:05,2021-08-18 19:01:45.749179
8114,103024,6,103024,92,10642,92,22,1,22,Benefits and Compensation,5,10642,154,2021-08-18 19:00:05,2021-08-18 19:01:45.749179
8115,103027,5,103027,102,10642,102,25,1,25,General Satisfaction,5,10642,154,2021-08-18 19:00:05,2021-08-18 19:01:45.749179
8116,100280,2,100280,106,10053,106,24,0,24,Company Administration,5,10053,133,2021-06-03 18:14:01,2021-06-03 18:47:34.995469
8117,100279,4,100279,96,10053,96,23,1,23,Relationship with Co-workers,5,10053,133,2021-06-03 18:14:01,2021-06-03 18:47:34.995469
8118,100278,3,100278,91,10053,91,22,1,22,Benefits and Compensation,5,10053,133,2021-06-03 18:14:01,2021-06-03 18:47:34.995469
8119,100281,1,100281,99,10053,99,25,0,25,General Satisfaction,5,10053,133,2021-06-03 18:14:01,2021-06-03 18:47:34.995469
8120,100300,5,100300,106,10058,106,24,0,24,Company Administration,5,10058,138,2021-06-03 18:14:02,2021-06-03 18:21:48.164941
8121,100299,5,100299,97,10058,97,23,0,23,Relationship with Co-workers,5,10058,138,2021-06-03 18:14:02,2021-06-03 18:21:48.164941
8122,100298,4,100298,90,10058,90,22,1,22,Benefits and Compensation,5,10058,138,2021-06-03 18:14:02,2021-06-03 18:21:48.164941
8123,100301,5,100301,101,10058,101,25,1,25,General Satisfaction,5,10058,138,2021-06-03 18:14:02,2021-06-03 18:21:48.164941
8124,100494,6,100494,106,10098,106,24,0,24,Company Administration,5,10098,130,2021-06-09 19:00:01,2021-06-09 19:01:48.642070
8125,100493,4,100493,98,10098,98,23,0,23,Relationship with Co-workers,5,10098,130,2021-06-09 19:00:01,2021-06-09 19:01:48.642070
8126,100492,5,100492,91,10098,91,22,1,22,Benefits and Compensation,5,10098,130,2021-06-09 19:00:01,2021-06-09 19:01:48.642070
8127,100495,5,100495,101,10098,101,25,1,25,General Satisfaction,5,10098,130,2021-06-09 19:00:01,2021-06-09 19:01:48.642070
8128,100530,1,100530,106,10107,106,24,0,24,Company Administration,5,10107,139,2021-06-09 19:00:03,2021-06-09 23:19:03.306158
8129,100529,4,100529,94,10107,94,23,1,23,Relationship with Co-workers,5,10107,139,2021-06-09 19:00:03,2021-06-09 23:19:03.306158
8130,100528,6,100528,92,10107,92,22,1,22,Benefits and Compensation,5,10107,139,2021-06-09 19:00:03,2021-06-09 23:19:03.306158
8131,100531,6,100531,102,10107,102,25,1,25,General Satisfaction,5,10107,139,2021-06-09 19:00:03,2021-06-09 23:19:03.306158
8132,100578,5,100578,106,10119,106,24,0,24,Company Administration,5,10119,151,2021-06-09 19:00:05,2021-06-10 17:13:03.451661
8133,100577,6,100577,98,10119,98,23,0,23,Relationship with Co-workers,5,10119,151,2021-06-09 19:00:05,2021-06-10 17:13:03.451661
8134,100576,5,100576,91,10119,91,22,1,22,Benefits and Compensation,5,10119,151,2021-06-09 19:00:05,2021-06-10 17:13:03.451661
8135,100579,3,100579,99,10119,99,25,0,25,General Satisfaction,5,10119,151,2021-06-09 19:00:05,2021-06-10 17:13:03.451661
8136,100800,6,100800,106,10162,106,24,0,24,Company Administration,5,10162,130,2021-06-16 19:00:01,2021-06-16 21:26:05.826482
8137,100799,5,100799,95,10162,95,23,1,23,Relationship with Co-workers,5,10162,130,2021-06-16 19:00:01,2021-06-16 21:26:05.826482
8138,100798,5,100798,91,10162,91,22,1,22,Benefits and Compensation,5,10162,130,2021-06-16 19:00:01,2021-06-16 21:26:05.826482
8139,100801,6,100801,100,10162,100,25,1,25,General Satisfaction,5,10162,130,2021-06-16 19:00:01,2021-06-16 21:26:05.826482
8140,100804,4,100804,106,10163,106,24,0,24,Company Administration,5,10163,131,2021-06-16 19:00:02,2021-06-16 19:18:36.269804
8141,100803,5,100803,98,10163,98,23,0,23,Relationship with Co-workers,5,10163,131,2021-06-16 19:00:02,2021-06-16 19:18:36.269804
8142,100802,4,100802,91,10163,91,22,1,22,Benefits and Compensation,5,10163,131,2021-06-16 19:00:02,2021-06-16 19:18:36.269804
8143,100805,5,100805,99,10163,99,25,0,25,General Satisfaction,5,10163,131,2021-06-16 19:00:02,2021-06-16 19:18:36.269804
8144,100832,5,100832,106,10170,106,24,0,24,Company Administration,5,10170,138,2021-06-16 19:00:04,2021-06-16 20:04:26.073581
8145,100831,5,100831,95,10170,95,23,1,23,Relationship with Co-workers,5,10170,138,2021-06-16 19:00:04,2021-06-16 20:04:26.073581
8146,100830,5,100830,89,10170,89,22,1,22,Benefits and Compensation,5,10170,138,2021-06-16 19:00:04,2021-06-16 20:04:26.073581
8147,100833,5,100833,103,10170,103,25,1,25,General Satisfaction,5,10170,138,2021-06-16 19:00:04,2021-06-16 20:04:26.073581
8148,100836,2,100836,106,10171,106,24,0,24,Company Administration,5,10171,139,2021-06-16 19:00:04,2021-06-17 16:34:06.953673
8149,100835,5,100835,96,10171,96,23,1,23,Relationship with Co-workers,5,10171,139,2021-06-16 19:00:04,2021-06-17 16:34:06.953673
8150,100834,6,100834,92,10171,92,22,1,22,Benefits and Compensation,5,10171,139,2021-06-16 19:00:04,2021-06-17 16:34:06.953673
8151,100837,6,100837,103,10171,103,25,1,25,General Satisfaction,5,10171,139,2021-06-16 19:00:04,2021-06-17 16:34:06.953673
8152,100868,3,100868,106,10179,106,24,0,24,Company Administration,5,10179,147,2021-06-16 19:00:06,2021-06-16 19:05:43.069191
8153,100867,5,100867,94,10179,94,23,1,23,Relationship with Co-workers,5,10179,147,2021-06-16 19:00:06,2021-06-16 19:05:43.069191
8154,100866,4,100866,89,10179,89,22,1,22,Benefits and Compensation,5,10179,147,2021-06-16 19:00:06,2021-06-16 19:05:43.069191
8155,100869,4,100869,101,10179,101,25,1,25,General Satisfaction,5,10179,147,2021-06-16 19:00:06,2021-06-16 19:05:43.069191
8156,100876,5,100876,106,10181,106,24,0,24,Company Administration,5,10181,149,2021-06-16 19:00:06,2021-06-16 19:10:37.278111
8157,100875,5,100875,98,10181,98,23,0,23,Relationship with Co-workers,5,10181,149,2021-06-16 19:00:06,2021-06-16 19:10:37.278111
8158,100874,5,100874,92,10181,92,22,1,22,Benefits and Compensation,5,10181,149,2021-06-16 19:00:06,2021-06-16 19:10:37.278111
8159,100877,5,100877,104,10181,104,25,1,25,General Satisfaction,5,10181,149,2021-06-16 19:00:06,2021-06-16 19:10:37.278111
8160,101138,2,101138,106,10234,106,24,0,24,Company Administration,5,10234,136,2021-06-23 19:00:03,2021-06-23 19:01:01.852086
8161,101137,4,101137,94,10234,94,23,1,23,Relationship with Co-workers,5,10234,136,2021-06-23 19:00:03,2021-06-23 19:01:01.852086
8162,101136,6,101136,89,10234,89,22,1,22,Benefits and Compensation,5,10234,136,2021-06-23 19:00:03,2021-06-23 19:01:01.852086
8163,101139,5,101139,102,10234,102,25,1,25,General Satisfaction,5,10234,136,2021-06-23 19:00:03,2021-06-23 19:01:01.852086
8164,101146,5,101146,106,10236,106,24,0,24,Company Administration,5,10236,138,2021-06-23 19:00:03,2021-06-23 19:15:21.236064
8165,101145,5,101145,95,10236,95,23,1,23,Relationship with Co-workers,5,10236,138,2021-06-23 19:00:03,2021-06-23 19:15:21.236064
8166,101144,5,101144,91,10236,91,22,1,22,Benefits and Compensation,5,10236,138,2021-06-23 19:00:03,2021-06-23 19:15:21.236064
8167,101147,5,101147,104,10236,104,25,1,25,General Satisfaction,5,10236,138,2021-06-23 19:00:03,2021-06-23 19:15:21.236064
8168,101150,6,101150,106,10237,106,24,0,24,Company Administration,5,10237,139,2021-06-23 19:00:03,2021-06-23 21:42:29.958956
8169,101149,5,101149,96,10237,96,23,1,23,Relationship with Co-workers,5,10237,139,2021-06-23 19:00:03,2021-06-23 21:42:29.958956
8170,101148,5,101148,89,10237,89,22,1,22,Benefits and Compensation,5,10237,139,2021-06-23 19:00:03,2021-06-23 21:42:29.958956
8171,101151,6,101151,99,10237,99,25,0,25,General Satisfaction,5,10237,139,2021-06-23 19:00:03,2021-06-23 21:42:29.958956
8172,101182,3,101182,106,10245,106,24,0,24,Company Administration,5,10245,147,2021-06-23 19:00:05,2021-06-23 19:09:56.021365
8173,101181,4,101181,96,10245,96,23,1,23,Relationship with Co-workers,5,10245,147,2021-06-23 19:00:05,2021-06-23 19:09:56.021365
8174,101180,5,101180,92,10245,92,22,1,22,Benefits and Compensation,5,10245,147,2021-06-23 19:00:05,2021-06-23 19:09:56.021365
8175,101183,3,101183,99,10245,99,25,0,25,General Satisfaction,5,10245,147,2021-06-23 19:00:05,2021-06-23 19:09:56.021365
8176,101210,5,101210,106,10252,106,24,0,24,Company Administration,5,10252,154,2021-06-23 19:00:06,2021-06-23 19:41:58.048084
8177,101209,5,101209,94,10252,94,23,1,23,Relationship with Co-workers,5,10252,154,2021-06-23 19:00:06,2021-06-23 19:41:58.048084
8178,101208,5,101208,91,10252,91,22,1,22,Benefits and Compensation,5,10252,154,2021-06-23 19:00:06,2021-06-23 19:41:58.048084
8179,101211,6,101211,100,10252,100,25,1,25,General Satisfaction,5,10252,154,2021-06-23 19:00:06,2021-06-23 19:41:58.048084
8180,101464,6,101464,106,10303,106,24,0,24,Company Administration,5,10303,139,2021-06-30 19:00:03,2021-06-30 19:14:04.721014
8181,101463,5,101463,94,10303,94,23,1,23,Relationship with Co-workers,5,10303,139,2021-06-30 19:00:03,2021-06-30 19:14:04.721014
8182,101462,6,101462,92,10303,92,22,1,22,Benefits and Compensation,5,10303,139,2021-06-30 19:00:03,2021-06-30 19:14:04.721014
8183,101465,6,101465,104,10303,104,25,1,25,General Satisfaction,5,10303,139,2021-06-30 19:00:03,2021-06-30 19:14:04.721014
8184,101496,3,101496,106,10311,106,24,0,24,Company Administration,5,10311,147,2021-06-30 19:00:05,2021-06-30 19:48:04.070809
8185,101495,4,101495,94,10311,94,23,1,23,Relationship with Co-workers,5,10311,147,2021-06-30 19:00:05,2021-06-30 19:48:04.070809
8186,101494,4,101494,93,10311,93,22,1,22,Benefits and Compensation,5,10311,147,2021-06-30 19:00:05,2021-06-30 19:48:04.070809
8187,101497,4,101497,104,10311,104,25,1,25,General Satisfaction,5,10311,147,2021-06-30 19:00:05,2021-06-30 19:48:04.070809
8188,101778,6,101778,106,10369,106,24,0,24,Company Administration,5,10369,139,2021-07-07 19:00:03,2021-07-07 19:02:12.337035
8189,101777,5,101777,94,10369,94,23,1,23,Relationship with Co-workers,5,10369,139,2021-07-07 19:00:03,2021-07-07 19:02:12.337035
8190,101776,6,101776,92,10369,92,22,1,22,Benefits and Compensation,5,10369,139,2021-07-07 19:00:03,2021-07-07 19:02:12.337035
8191,101779,6,101779,99,10369,99,25,0,25,General Satisfaction,5,10369,139,2021-07-07 19:00:03,2021-07-07 19:02:12.337035
8192,101798,2,101798,106,10374,106,24,0,24,Company Administration,5,10374,144,2021-07-07 19:00:04,2021-07-07 19:40:34.023360
8193,101797,5,101797,97,10374,97,23,0,23,Relationship with Co-workers,5,10374,144,2021-07-07 19:00:04,2021-07-07 19:40:34.023360
8194,101796,5,101796,91,10374,91,22,1,22,Benefits and Compensation,5,10374,144,2021-07-07 19:00:04,2021-07-07 19:40:34.023360
8195,101799,5,101799,104,10374,104,25,1,25,General Satisfaction,5,10374,144,2021-07-07 19:00:04,2021-07-07 19:40:34.023360
8196,102008,2,102008,106,10417,106,24,0,24,Company Administration,5,10417,133,2021-07-14 19:00:02,2021-07-14 19:01:05.332414
8197,102007,1,102007,97,10417,97,23,0,23,Relationship with Co-workers,5,10417,133,2021-07-14 19:00:02,2021-07-14 19:01:05.332414
8198,102006,6,102006,92,10417,92,22,1,22,Benefits and Compensation,5,10417,133,2021-07-14 19:00:02,2021-07-14 19:01:05.332414
8199,102009,2,102009,100,10417,100,25,1,25,General Satisfaction,5,10417,133,2021-07-14 19:00:02,2021-07-14 19:01:05.332414
8200,102032,6,102032,106,10423,106,24,0,24,Company Administration,5,10423,139,2021-07-14 19:00:03,2021-07-14 20:57:07.476457
8201,102031,6,102031,94,10423,94,23,1,23,Relationship with Co-workers,5,10423,139,2021-07-14 19:00:03,2021-07-14 20:57:07.476457
8202,102030,4,102030,90,10423,90,22,1,22,Benefits and Compensation,5,10423,139,2021-07-14 19:00:03,2021-07-14 20:57:07.476457
8203,102033,5,102033,101,10423,101,25,1,25,General Satisfaction,5,10423,139,2021-07-14 19:00:03,2021-07-14 20:57:07.476457
8204,102060,1,102060,106,10430,106,24,0,24,Company Administration,5,10430,146,2021-07-14 19:00:04,2021-07-14 19:28:38.102276
8205,102059,1,102059,98,10430,98,23,0,23,Relationship with Co-workers,5,10430,146,2021-07-14 19:00:04,2021-07-14 19:28:38.102276
8206,102058,2,102058,89,10430,89,22,1,22,Benefits and Compensation,5,10430,146,2021-07-14 19:00:04,2021-07-14 19:28:38.102276
8207,102061,6,102061,104,10430,104,25,1,25,General Satisfaction,5,10430,146,2021-07-14 19:00:04,2021-07-14 19:28:38.102276
8208,102072,5,102072,106,10433,106,24,0,24,Company Administration,5,10433,149,2021-07-14 19:00:04,2021-07-14 19:01:19.101035
8209,102071,5,102071,96,10433,96,23,1,23,Relationship with Co-workers,5,10433,149,2021-07-14 19:00:04,2021-07-14 19:01:19.101035
8210,102070,6,102070,91,10433,91,22,1,22,Benefits and Compensation,5,10433,149,2021-07-14 19:00:04,2021-07-14 19:01:19.101035
8211,102073,6,102073,102,10433,102,25,1,25,General Satisfaction,5,10433,149,2021-07-14 19:00:04,2021-07-14 19:01:19.101035
8212,102140,5,102140,106,10448,106,24,0,24,Company Administration,5,10448,131,2021-07-21 19:00:02,2021-07-21 19:10:05.470153
8213,102139,6,102139,96,10448,96,23,1,23,Relationship with Co-workers,5,10448,131,2021-07-21 19:00:02,2021-07-21 19:10:05.470153
8214,102138,4,102138,93,10448,93,22,1,22,Benefits and Compensation,5,10448,131,2021-07-21 19:00:02,2021-07-21 19:10:05.470153
8215,102141,4,102141,103,10448,103,25,1,25,General Satisfaction,5,10448,131,2021-07-21 19:00:02,2021-07-21 19:10:05.470153
8216,102148,2,102148,106,10450,106,24,0,24,Company Administration,5,10450,133,2021-07-21 19:00:02,2021-07-21 19:53:02.905344
8217,102147,1,102147,97,10450,97,23,0,23,Relationship with Co-workers,5,10450,133,2021-07-21 19:00:02,2021-07-21 19:53:02.905344
8218,102146,5,102146,93,10450,93,22,1,22,Benefits and Compensation,5,10450,133,2021-07-21 19:00:02,2021-07-21 19:53:02.905344
8219,102149,4,102149,103,10450,103,25,1,25,General Satisfaction,5,10450,133,2021-07-21 19:00:02,2021-07-21 19:53:02.905344
8220,102204,3,102204,106,10464,106,24,0,24,Company Administration,5,10464,147,2021-07-21 19:00:04,2021-07-21 19:15:24.431514
8221,102203,5,102203,96,10464,96,23,1,23,Relationship with Co-workers,5,10464,147,2021-07-21 19:00:04,2021-07-21 19:15:24.431514
8222,102202,4,102202,90,10464,90,22,1,22,Benefits and Compensation,5,10464,147,2021-07-21 19:00:04,2021-07-21 19:15:24.431514
8223,102205,5,102205,104,10464,104,25,1,25,General Satisfaction,5,10464,147,2021-07-21 19:00:04,2021-07-21 19:15:24.431514
8224,102216,2,102216,106,10467,106,24,0,24,Company Administration,5,10467,150,2021-07-21 19:00:05,2021-07-21 19:10:20.373275
8225,102215,4,102215,95,10467,95,23,1,23,Relationship with Co-workers,5,10467,150,2021-07-21 19:00:05,2021-07-21 19:10:20.373275
8226,102214,4,102214,90,10467,90,22,1,22,Benefits and Compensation,5,10467,150,2021-07-21 19:00:05,2021-07-21 19:10:20.373275
8227,102217,4,102217,103,10467,103,25,1,25,General Satisfaction,5,10467,150,2021-07-21 19:00:05,2021-07-21 19:10:20.373275
8228,102276,6,102276,106,10480,106,24,0,24,Company Administration,5,10480,130,2021-07-28 19:00:02,2021-07-28 19:13:32.832265
8229,102275,3,102275,97,10480,97,23,0,23,Relationship with Co-workers,5,10480,130,2021-07-28 19:00:02,2021-07-28 19:13:32.832265
8230,102274,5,102274,90,10480,90,22,1,22,Benefits and Compensation,5,10480,130,2021-07-28 19:00:02,2021-07-28 19:13:32.832265
8231,102277,6,102277,102,10480,102,25,1,25,General Satisfaction,5,10480,130,2021-07-28 19:00:02,2021-07-28 19:13:32.832265
8232,102280,5,102280,106,10481,106,24,0,24,Company Administration,5,10481,131,2021-07-28 19:00:02,2021-07-28 19:01:24.529554
8233,102279,5,102279,95,10481,95,23,1,23,Relationship with Co-workers,5,10481,131,2021-07-28 19:00:02,2021-07-28 19:01:24.529554
8234,102278,4,102278,92,10481,92,22,1,22,Benefits and Compensation,5,10481,131,2021-07-28 19:00:02,2021-07-28 19:01:24.529554
8235,102281,5,102281,102,10481,102,25,1,25,General Satisfaction,5,10481,131,2021-07-28 19:00:02,2021-07-28 19:01:24.529554
8236,102308,5,102308,106,10488,106,24,0,24,Company Administration,5,10488,138,2021-07-28 19:00:04,2021-07-28 19:01:56.690048
8237,102307,5,102307,97,10488,97,23,0,23,Relationship with Co-workers,5,10488,138,2021-07-28 19:00:04,2021-07-28 19:01:56.690048
8238,102306,5,102306,93,10488,93,22,1,22,Benefits and Compensation,5,10488,138,2021-07-28 19:00:04,2021-07-28 19:01:56.690048
8239,102309,4,102309,103,10488,103,25,1,25,General Satisfaction,5,10488,138,2021-07-28 19:00:04,2021-07-28 19:01:56.690048
8240,102340,3,102340,106,10496,106,24,0,24,Company Administration,5,10496,146,2021-07-28 19:00:05,2021-07-28 19:01:33.672726
8241,102339,2,102339,94,10496,94,23,1,23,Relationship with Co-workers,5,10496,146,2021-07-28 19:00:05,2021-07-28 19:01:33.672726
8242,102338,4,102338,89,10496,89,22,1,22,Benefits and Compensation,5,10496,146,2021-07-28 19:00:05,2021-07-28 19:01:33.672726
8243,102341,4,102341,101,10496,101,25,1,25,General Satisfaction,5,10496,146,2021-07-28 19:00:05,2021-07-28 19:01:33.672726
8244,102356,2,102356,106,10500,106,24,0,24,Company Administration,5,10500,150,2021-07-28 19:00:06,2021-07-28 19:17:36.208677
8245,102355,2,102355,97,10500,97,23,0,23,Relationship with Co-workers,5,10500,150,2021-07-28 19:00:06,2021-07-28 19:17:36.208677
8246,102354,5,102354,89,10500,89,22,1,22,Benefits and Compensation,5,10500,150,2021-07-28 19:00:06,2021-07-28 19:17:36.208677
8247,102357,5,102357,102,10500,102,25,1,25,General Satisfaction,5,10500,150,2021-07-28 19:00:06,2021-07-28 19:17:36.208677
8248,102420,5,102420,106,10514,106,24,0,24,Company Administration,5,10514,131,2021-08-04 19:00:02,2021-08-04 19:03:46.116573
8249,102419,5,102419,94,10514,94,23,1,23,Relationship with Co-workers,5,10514,131,2021-08-04 19:00:02,2021-08-04 19:03:46.116573
8250,102418,4,102418,93,10514,93,22,1,22,Benefits and Compensation,5,10514,131,2021-08-04 19:00:02,2021-08-04 19:03:46.116573
8251,102421,6,102421,99,10514,99,25,0,25,General Satisfaction,5,10514,131,2021-08-04 19:00:02,2021-08-04 19:03:46.116573
8252,102448,5,102448,106,10521,106,24,0,24,Company Administration,5,10521,138,2021-08-04 19:00:03,2021-08-04 19:10:56.725682
8253,102447,5,102447,95,10521,95,23,1,23,Relationship with Co-workers,5,10521,138,2021-08-04 19:00:03,2021-08-04 19:10:56.725682
8254,102446,5,102446,92,10521,92,22,1,22,Benefits and Compensation,5,10521,138,2021-08-04 19:00:03,2021-08-04 19:10:56.725682
8255,102449,5,102449,103,10521,103,25,1,25,General Satisfaction,5,10521,138,2021-08-04 19:00:03,2021-08-04 19:10:56.725682
8256,102452,4,102452,106,10522,106,24,0,24,Company Administration,5,10522,139,2021-08-04 19:00:03,2021-08-04 19:01:50.628595
8257,102451,5,102451,95,10522,95,23,1,23,Relationship with Co-workers,5,10522,139,2021-08-04 19:00:03,2021-08-04 19:01:50.628595
8258,102450,5,102450,89,10522,89,22,1,22,Benefits and Compensation,5,10522,139,2021-08-04 19:00:03,2021-08-04 19:01:50.628595
8259,102453,5,102453,103,10522,103,25,1,25,General Satisfaction,5,10522,139,2021-08-04 19:00:03,2021-08-04 19:01:50.628595
8260,102484,3,102484,106,10530,106,24,0,24,Company Administration,5,10530,147,2021-08-04 19:00:05,2021-08-04 19:14:28.256831
8261,102483,3,102483,97,10530,97,23,0,23,Relationship with Co-workers,5,10530,147,2021-08-04 19:00:05,2021-08-04 19:14:28.256831
8262,102482,4,102482,90,10530,90,22,1,22,Benefits and Compensation,5,10530,147,2021-08-04 19:00:05,2021-08-04 19:14:28.256831
8263,102485,5,102485,100,10530,100,25,1,25,General Satisfaction,5,10530,147,2021-08-04 19:00:05,2021-08-04 19:14:28.256831
8264,102634,6,102634,106,10559,106,24,0,24,Company Administration,5,10559,130,2021-08-11 19:00:01,2021-08-11 19:01:25.023836
8265,102633,3,102633,98,10559,98,23,0,23,Relationship with Co-workers,5,10559,130,2021-08-11 19:00:01,2021-08-11 19:01:25.023836
8266,102632,5,102632,91,10559,91,22,1,22,Benefits and Compensation,5,10559,130,2021-08-11 19:00:01,2021-08-11 19:01:25.023836
8267,102635,6,102635,104,10559,104,25,1,25,General Satisfaction,5,10559,130,2021-08-11 19:00:01,2021-08-11 19:01:25.023836
8268,102646,3,102646,106,10562,106,24,0,24,Company Administration,5,10562,133,2021-08-11 19:00:02,2021-08-11 19:08:08.601482
8269,102645,4,102645,96,10562,96,23,1,23,Relationship with Co-workers,5,10562,133,2021-08-11 19:00:02,2021-08-11 19:08:08.601482
8270,102644,6,102644,92,10562,92,22,1,22,Benefits and Compensation,5,10562,133,2021-08-11 19:00:02,2021-08-11 19:08:08.601482
8271,102647,5,102647,103,10562,103,25,1,25,General Satisfaction,5,10562,133,2021-08-11 19:00:02,2021-08-11 19:08:08.601482
8272,102698,2,102698,106,10575,106,24,0,24,Company Administration,5,10575,146,2021-08-11 19:00:04,2021-08-11 19:11:43.741868
8273,102697,1,102697,97,10575,97,23,0,23,Relationship with Co-workers,5,10575,146,2021-08-11 19:00:04,2021-08-11 19:11:43.741868
8274,102696,2,102696,90,10575,90,22,1,22,Benefits and Compensation,5,10575,146,2021-08-11 19:00:04,2021-08-11 19:11:43.741868
8275,102699,2,102699,99,10575,99,25,0,25,General Satisfaction,5,10575,146,2021-08-11 19:00:04,2021-08-11 19:11:43.741868
8276,102702,3,102702,106,10576,106,24,0,24,Company Administration,5,10576,147,2021-08-11 19:00:05,2021-08-11 19:06:36.498186
8277,102701,3,102701,98,10576,98,23,0,23,Relationship with Co-workers,5,10576,147,2021-08-11 19:00:05,2021-08-11 19:06:36.498186
8278,102700,4,102700,89,10576,89,22,1,22,Benefits and Compensation,5,10576,147,2021-08-11 19:00:05,2021-08-11 19:06:36.498186
8279,102703,5,102703,100,10576,100,25,1,25,General Satisfaction,5,10576,147,2021-08-11 19:00:05,2021-08-11 19:06:36.498186
8280,102706,4,102706,106,10577,106,24,0,24,Company Administration,5,10577,148,2021-08-11 19:00:05,2021-08-11 19:00:47.117756
8281,102705,1,102705,97,10577,97,23,0,23,Relationship with Co-workers,5,10577,148,2021-08-11 19:00:05,2021-08-11 19:00:47.117756
8282,102704,5,102704,93,10577,93,22,1,22,Benefits and Compensation,5,10577,148,2021-08-11 19:00:05,2021-08-11 19:00:47.117756
8283,102707,5,102707,103,10577,103,25,1,25,General Satisfaction,5,10577,148,2021-08-11 19:00:05,2021-08-11 19:00:47.117756
8284,102714,3,102714,106,10579,106,24,0,24,Company Administration,5,10579,150,2021-08-11 19:00:05,2021-08-11 19:09:51.026816
8285,102713,3,102713,98,10579,98,23,0,23,Relationship with Co-workers,5,10579,150,2021-08-11 19:00:05,2021-08-11 19:09:51.026816
8286,102712,4,102712,90,10579,90,22,1,22,Benefits and Compensation,5,10579,150,2021-08-11 19:00:05,2021-08-11 19:09:51.026816
8287,102715,4,102715,99,10579,99,25,0,25,General Satisfaction,5,10579,150,2021-08-11 19:00:05,2021-08-11 19:09:51.026816
8288,102934,5,102934,106,10619,106,24,0,24,Company Administration,5,10619,131,2021-08-18 19:00:01,2021-08-18 19:00:56.476591
8289,102933,5,102933,98,10619,98,23,0,23,Relationship with Co-workers,5,10619,131,2021-08-18 19:00:01,2021-08-18 19:00:56.476591
8290,102932,4,102932,91,10619,91,22,1,22,Benefits and Compensation,5,10619,131,2021-08-18 19:00:01,2021-08-18 19:00:56.476591
8291,102935,4,102935,103,10619,103,25,1,25,General Satisfaction,5,10619,131,2021-08-18 19:00:01,2021-08-18 19:00:56.476591
8292,102962,5,102962,106,10626,106,24,0,24,Company Administration,5,10626,138,2021-08-18 19:00:02,2021-08-18 19:36:19.776286
8293,102961,5,102961,95,10626,95,23,1,23,Relationship with Co-workers,5,10626,138,2021-08-18 19:00:02,2021-08-18 19:36:19.776286
8294,102960,5,102960,89,10626,89,22,1,22,Benefits and Compensation,5,10626,138,2021-08-18 19:00:02,2021-08-18 19:36:19.776286
8295,102963,5,102963,100,10626,100,25,1,25,General Satisfaction,5,10626,138,2021-08-18 19:00:02,2021-08-18 19:36:19.776286
